timestamp,node_id,incoming_tx,outgoing_tx,remaining_tx,missing_tx,tx_from_client,tx_from_node,tx_from_node_detail
0,0,3225,0,3225,0,914,2311,"[0, 177, 188, 39, 574, 770, 680, 44, 581, 447, 593, 333, 23, 302, 770, 391, 444, 319, 167, 694, 443, 589, 408, 488, 753, 230, 573, 12, 283]"
1,0,4651,1775,6101,0,130,4521,"[0, 1362, 1249, 1089, 695, 1507, 1226, 1095, 1173, 1222, 1300, 1416, 673, 1190, 1507, 975, 966, 170, 1083, 273, 1108, 1267, 654, 20, 457, 188, 326, 570, 736]"
2,0,4762,1586,9277,0,4555,207,"[0, 16, 34, 22, 21, 69, 65, 39, 27, 45, 55, 50, 40, 15, 69, 15, 58, 19, 0, 50, 14, 35, 27, 48, 62, 35, 67, 12, 4]"
3,0,3627,6348,6556,0,1329,2298,"[0, 254, 613, 271, 256, 766, 426, 166, 684, 555, 742, 714, 649, 161, 766, 508, 541, 148, 191, 346, 369, 538, 276, 58, 344, 84, 183, 72, 18]"
4,0,3782,2230,8108,0,2800,982,"[0, 62, 154, 229, 42, 327, 107, 114, 32, 325, 175, 214, 75, 65, 327, 278, 160, 52, 229, 52, 248, 14, 285, 276, 82, 73, 53, 240, 279]"
5,0,4119,6982,5245,0,2181,1938,"[0, 68, 417, 556, 458, 646, 421, 562, 632, 218, 332, 443, 143, 323, 646, 15, 153, 328, 385, 108, 551, 21, 325, 606, 446, 125, 358, 493, 596]"
6,0,4535,2409,7371,0,2509,2026,"[0, 556, 435, 101, 549, 675, 608, 82, 206, 56, 149, 296, 441, 512, 675, 607, 330, 290, 606, 632, 182, 89, 157, 599, 594, 532, 654, 367, 411]"
7,0,4313,6298,5386,0,1882,2431,"[0, 231, 31, 450, 258, 810, 200, 710, 432, 293, 326, 292, 89, 171, 810, 671, 74, 682, 231, 416, 57, 718, 118, 808, 496, 373, 522, 704, 235]"
8,0,3468,1880,6974,0,3222,246,"[0, 35, 73, 44, 42, 82, 61, 6, 73, 22, 0, 82, 67, 15, 82, 39, 61, 27, 60, 1, 5, 40, 10, 58, 30, 21, 47, 49, 7]"
9,0,4604,5797,5781,0,2058,2546,"[0, 513, 284, 568, 293, 848, 122, 586, 789, 190, 624, 52, 655, 823, 848, 711, 723, 132, 407, 6, 384, 302, 430, 837, 616, 21, 390, 320, 138]"
10,0,4691,1808,8664,0,2796,1895,"[0, 458, 189, 338, 208, 631, 82, 392, 500, 7, 343, 356, 106, 91, 631, 422, 198, 246, 414, 182, 384, 90, 409, 599, 155, 618, 96, 476, 156]"
11,0,3040,5148,6556,0,2771,269,"[0, 12, 67, 52, 81, 89, 47, 12, 15, 22, 40, 34, 12, 17, 89, 15, 19, 36, 37, 71, 47, 87, 10, 6, 5, 18, 78, 76, 59]"
12,0,3269,1435,8390,0,3237,32,"[0, 7, 7, 6, 7, 10, 9, 4, 3, 0, 0, 0, 5, 9, 10, 8, 2, 10, 6, 3, 7, 9, 8, 2, 7, 4, 1, 7, 0]"
13,0,3602,6144,5848,0,1152,2450,"[0, 743, 366, 44, 2, 816, 444, 138, 155, 639, 430, 129, 189, 255, 816, 109, 649, 661, 724, 517, 790, 761, 461, 645, 412, 699, 140, 254, 560]"
14,0,3479,1205,8122,0,3045,434,"[0, 16, 133, 30, 24, 144, 1, 136, 61, 114, 100, 19, 43, 100, 144, 7, 49, 28, 27, 105, 90, 33, 55, 70, 110, 31, 95, 40, 1]"
15,0,4950,5920,7152,0,4325,625,"[0, 38, 111, 36, 202, 208, 182, 129, 10, 141, 125, 118, 80, 41, 208, 193, 134, 80, 105, 80, 15, 97, 98, 59, 126, 165, 158, 79, 125]"
16,0,4089,6621,4620,0,2979,1110,"[0, 121, 247, 44, 273, 370, 84, 316, 204, 148, 130, 135, 330, 248, 370, 118, 246, 295, 18, 26, 191, 55, 219, 73, 305, 79, 282, 232, 360]"
17,0,3803,2931,5492,0,2954,849,"[0, 245, 192, 105, 182, 283, 205, 102, 281, 78, 208, 146, 214, 225, 283, 13, 139, 235, 123, 121, 109, 157, 68, 116, 80, 81, 1, 138, 187]"
18,0,3252,1981,6763,0,356,2896,"[0, 377, 264, 291, 118, 965, 21, 56, 522, 768, 938, 178, 888, 257, 965, 643, 690, 82, 53, 870, 463, 373, 239, 673, 253, 145, 270, 484, 513]"
19,0,4886,5014,6635,0,1093,3793,"[0, 36, 797, 843, 993, 1264, 273, 399, 1245, 442, 778, 243, 654, 1037, 1264, 457, 709, 319, 635, 736, 840, 67, 11, 978, 323, 1065, 97, 635, 109]"
20,0,4803,5643,5795,0,2096,2707,"[0, 318, 101, 398, 754, 902, 537, 802, 10, 35, 775, 836, 510, 494, 902, 622, 211, 373, 6, 471, 110, 604, 774, 728, 816, 638, 664, 11, 24]"
21,0,4731,256,10000,270,4521,210,"[0, 33, 55, 47, 25, 70, 50, 58, 54, 55, 17, 26, 65, 10, 70, 0, 21, 45, 68, 45, 60, 3, 4, 26, 23, 41, 34, 39, 35]"
22,0,3516,6405,7111,0,1990,1526,"[0, 51, 508, 98, 342, 508, 298, 423, 364, 210, 54, 285, 15, 206, 508, 130, 66, 290, 24, 301, 356, 130, 241, 84, 343, 362, 485, 335, 108]"
23,0,4550,6260,5401,0,1011,3539,"[0, 242, 29, 243, 608, 1179, 194, 486, 1158, 291, 904, 865, 898, 795, 1179, 1148, 946, 1036, 323, 49, 432, 1102, 94, 457, 33, 569, 339, 36, 837]"
24,0,4317,1705,8013,0,965,3352,"[0, 665, 585, 839, 337, 1117, 138, 606, 493, 713, 198, 816, 273, 50, 1117, 211, 515, 639, 407, 57, 1012, 228, 360, 933, 883, 1040, 741, 1022, 794]"
25,0,3968,6409,5572,0,1561,2407,"[0, 617, 657, 303, 532, 802, 743, 340, 115, 581, 113, 90, 141, 470, 802, 43, 395, 72, 105, 85, 348, 87, 424, 443, 197, 526, 236, 782, 258]"
26,0,4378,1377,8573,0,3369,1009,"[0, 31, 297, 86, 201, 336, 223, 86, 94, 232, 59, 220, 31, 179, 336, 279, 215, 318, 77, 197, 115, 321, 286, 95, 175, 249, 315, 144, 68]"
27,0,4858,6817,6614,0,3984,874,"[0, 102, 85, 9, 67, 291, 211, 19, 181, 9, 110, 8, 166, 255, 291, 57, 178, 253, 160, 193, 225, 156, 285, 198, 39, 212, 222, 247, 81]"
28,0,3100,468,9246,0,1191,1909,"[0, 98, 496, 182, 11, 636, 50, 464, 196, 194, 88, 602, 508, 88, 636, 226, 23, 607, 386, 615, 209, 367, 16, 587, 56, 296, 571, 308, 584]"
29,0,3764,6630,6380,0,3072,692,"[0, 93, 230, 107, 108, 230, 82, 103, 204, 36, 112, 70, 33, 153, 230, 71, 125, 169, 115, 178, 127, 152, 27, 137, 56, 44, 75, 168, 176]"
30,0,3009,2717,6672,0,1635,1374,"[0, 196, 19, 343, 373, 458, 406, 4, 303, 136, 130, 416, 326, 385, 458, 212, 2, 72, 44, 77, 188, 44, 211, 164, 390, 114, 91, 378, 338]"
31,0,4724,5812,5584,0,4490,234,"[0, 19, 39, 33, 28, 78, 58, 18, 28, 20, 14, 27, 66, 3, 78, 7, 52, 25, 35, 22, 10, 1, 68, 52, 2, 47, 24, 21, 15]"
32,0,4265,1076,8773,0,4047,218,"[0, 56, 2, 7, 67, 72, 57, 67, 5, 30, 35, 46, 53, 38, 72, 0, 41, 59, 19, 22, 62, 10, 61, 50, 44, 51, 13, 17, 31]"
33,0,4722,5338,8157,0,3433,1289,"[0, 334, 91, 348, 217, 429, 164, 228, 103, 113, 96, 138, 159, 206, 429, 410, 232, 160, 79, 260, 65, 425, 236, 203, 356, 377, 134, 126, 14]"
34,0,3028,6129,5056,0,1551,1477,"[0, 399, 279, 68, 233, 492, 100, 349, 451, 266, 482, 183, 361, 56, 492, 446, 307, 330, 199, 68, 144, 418, 64, 275, 112, 141, 425, 461, 6]"
35,0,3719,2392,6383,0,3252,467,"[0, 130, 42, 153, 91, 155, 15, 54, 84, 39, 53, 150, 66, 71, 155, 75, 155, 120, 25, 24, 146, 103, 135, 145, 32, 91, 80, 48, 31]"
36,0,4519,1480,9422,0,1143,3376,"[0, 918, 160, 54, 682, 1125, 955, 667, 1076, 883, 454, 322, 125, 958, 1125, 777, 855, 309, 800, 6, 833, 742, 256, 1034, 196, 924, 654, 113, 802]"
37,0,3040,5774,6688,0,2557,483,"[0, 22, 65, 71, 152, 161, 39, 137, 150, 80, 117, 32, 16, 49, 161, 155, 4, 39, 120, 51, 93, 158, 4, 21, 40, 49, 75, 3, 37]"
38,0,3989,2224,8453,0,615,3374,"[0, 813, 566, 523, 582, 1124, 256, 1034, 385, 1082, 717, 225, 38, 167, 1124, 760, 429, 349, 4, 324, 898, 709, 291, 196, 956, 579, 583, 417, 443]"
39,0,4486,6488,6451,0,1142,3344,"[0, 437, 473, 760, 881, 1114, 479, 340, 36, 974, 36, 315, 94, 195, 1114, 150, 715, 978, 146, 581, 955, 559, 663, 840, 913, 712, 373, 377, 996]"
40,0,5000,5283,6168,0,3651,1349,"[0, 55, 337, 172, 371, 449, 38, 224, 353, 59, 348, 73, 432, 402, 449, 315, 172, 41, 31, 178, 342, 390, 173, 226, 200, 316, 306, 263, 357]"
41,0,3453,1730,7891,0,163,3290,"[0, 84, 118, 237, 276, 1096, 978, 341, 1058, 398, 853, 882, 501, 648, 1096, 1042, 689, 377, 804, 245, 1020, 102, 888, 91, 357, 56, 266, 801, 235]"
42,0,4313,7357,4847,0,89,4224,"[0, 1296, 1044, 680, 370, 1408, 772, 943, 866, 955, 1224, 389, 334, 803, 1408, 1327, 124, 1318, 817, 427, 798, 9, 31, 1272, 40, 412, 1196, 41, 483]"
43,0,3290,1617,6520,0,2237,1053,"[0, 30, 5, 111, 182, 351, 48, 314, 36, 247, 218, 11, 68, 37, 351, 206, 160, 82, 25, 323, 246, 60, 143, 32, 236, 225, 205, 20, 167]"
44,0,4603,5812,5311,0,1415,3188,"[0, 893, 575, 116, 330, 1062, 484, 28, 180, 895, 166, 105, 891, 372, 1062, 710, 1038, 529, 880, 798, 1046, 617, 905, 380, 1059, 342, 92, 436, 869]"
45,0,3123,1979,6455,0,2730,393,"[0, 4, 124, 14, 127, 131, 121, 10, 81, 95, 77, 4, 15, 75, 131, 130, 119, 131, 74, 23, 23, 61, 14, 131, 104, 106, 7, 114, 91]"
46,0,4968,6052,5371,0,1395,3573,"[0, 699, 797, 927, 937, 1191, 583, 397, 133, 793, 5, 410, 33, 564, 1191, 651, 363, 33, 57, 958, 895, 5, 436, 262, 957, 274, 499, 148, 179]"
47,0,3302,2833,5840,0,2735,567,"[0, 185, 161, 69, 9, 189, 94, 107, 58, 28, 6, 117, 180, 23, 189, 184, 55, 159, 182, 183, 133, 181, 168, 85, 1, 109, 100, 182, 79]"
48,0,4894,2363,8371,0,1728,3166,"[0, 172, 1050, 726, 723, 1055, 706, 290, 970, 916, 1006, 905, 307, 109, 1055, 232, 761, 833, 572, 521, 826, 734, 696, 551, 441, 816, 254, 473, 681]"
49,0,4179,5004,7546,0,392,3787,"[0, 647, 769, 56, 259, 1262, 296, 302, 935, 763, 590, 80, 1255, 1201, 1262, 334, 775, 1012, 878, 591, 1167, 1116, 1151, 353, 1163, 53, 964, 81, 746]"
50,0,3385,3,10000,928,3235,150,"[0, 46, 30, 26, 8, 50, 3, 10, 7, 26, 36, 36, 12, 22, 50, 44, 48, 33, 13, 50, 23, 26, 17, 50, 43, 10, 19, 40, 28]"
51,0,3989,5376,8613,0,253,3736,"[0, 629, 845, 874, 286, 1245, 1142, 529, 219, 1158, 603, 343, 833, 907, 1245, 229, 600, 706, 871, 442, 330, 607, 966, 1202, 501, 487, 796, 1081, 148]"
52,0,3584,6456,5741,0,1773,1811,"[0, 237, 551, 476, 580, 603, 15, 476, 295, 434, 412, 138, 535, 3, 603, 221, 290, 50, 558, 190, 571, 168, 394, 470, 348, 170, 236, 153, 228]"
53,0,4483,3835,6389,0,1575,2908,"[0, 621, 169, 843, 598, 969, 384, 246, 295, 656, 183, 120, 446, 918, 969, 382, 464, 754, 67, 306, 139, 154, 497, 827, 290, 627, 863, 863, 168]"
54,0,3675,1007,9057,0,3044,631,"[0, 112, 114, 8, 97, 210, 55, 204, 42, 100, 202, 153, 136, 210, 210, 31, 2, 36, 47, 49, 47, 50, 108, 28, 187, 50, 15, 104, 89]"
55,0,4205,5340,7922,0,3431,774,"[0, 227, 210, 18, 115, 258, 144, 180, 166, 255, 151, 180, 242, 164, 258, 174, 86, 238, 119, 16, 232, 116, 32, 174, 218, 202, 220, 120, 108]"
56,0,3629,7303,4248,0,192,3437,"[0, 704, 568, 499, 581, 1145, 288, 748, 928, 917, 118, 228, 327, 424, 1145, 71, 171, 1059, 1072, 1063, 622, 1128, 359, 1069, 1035, 367, 549, 152, 139]"
57,0,4542,3763,5027,0,1039,3503,"[0, 1147, 183, 34, 140, 1167, 1012, 667, 233, 268, 1149, 107, 1147, 713, 1167, 1116, 317, 96, 571, 173, 245, 815, 124, 1029, 939, 1008, 155, 442, 60]"
58,0,4008,633,8402,0,190,3818,"[0, 415, 350, 1037, 1253, 1272, 282, 1233, 299, 1064, 1218, 549, 361, 1072, 1272, 531, 865, 352, 100, 415, 597, 72, 577, 824, 767, 618, 162, 1244, 921]"
59,0,3625,5479,6548,0,641,2984,"[0, 824, 408, 487, 412, 994, 728, 193, 203, 476, 656, 253, 265, 231, 994, 840, 872, 111, 981, 759, 691, 19, 40, 829, 487, 882, 394, 734, 758]"
60,0,3884,747,9685,0,831,3053,"[0, 691, 82, 516, 962, 1017, 89, 697, 830, 505, 657, 837, 269, 448, 1017, 430, 656, 898, 461, 978, 122, 555, 458, 3, 708, 765, 164, 844, 236]"
61,0,3750,5713,7722,0,1584,2166,"[0, 105, 577, 543, 285, 722, 426, 322, 90, 191, 357, 602, 485, 55, 722, 651, 95, 682, 338, 100, 348, 246, 517, 212, 685, 695, 442, 403, 391]"
62,0,3952,7353,4321,0,3775,177,"[0, 6, 7, 43, 37, 59, 59, 56, 15, 31, 52, 26, 43, 8, 59, 27, 54, 54, 46, 55, 58, 41, 29, 11, 52, 0, 55, 11, 47]"
63,0,4423,1937,6807,0,3611,812,"[0, 206, 248, 80, 6, 270, 43, 143, 53, 183, 227, 74, 140, 159, 270, 176, 88, 243, 220, 138, 239, 6, 140, 213, 197, 181, 41, 34, 204]"
64,0,4985,6606,5186,0,2022,2963,"[0, 743, 137, 426, 949, 987, 37, 722, 337, 674, 891, 305, 558, 475, 987, 479, 610, 861, 203, 257, 783, 617, 386, 636, 229, 716, 477, 662, 8]"
65,0,3934,1074,8046,0,3781,153,"[0, 51, 46, 5, 15, 51, 32, 2, 4, 27, 38, 41, 39, 4, 51, 39, 34, 41, 36, 10, 2, 3, 33, 38, 28, 28, 44, 41, 10]"
66,0,3682,6168,5560,0,274,3408,"[0, 790, 171, 786, 647, 1136, 985, 555, 555, 1084, 603, 110, 1057, 873, 1136, 493, 358, 106, 947, 625, 617, 507, 960, 386, 37, 1131, 95, 560, 893]"
67,0,4529,3942,6147,0,1793,2736,"[0, 812, 484, 93, 298, 912, 450, 77, 887, 492, 836, 72, 246, 286, 912, 819, 835, 382, 433, 178, 81, 591, 543, 800, 694, 757, 708, 834, 599]"
68,0,3977,628,9496,0,427,3550,"[0, 346, 378, 771, 1028, 1183, 1133, 87, 41, 38, 541, 741, 1010, 778, 1183, 395, 866, 587, 816, 1, 1103, 733, 652, 736, 1088, 120, 1116, 806, 939]"
69,0,3618,6730,6384,0,3514,104,"[0, 28, 14, 13, 4, 34, 23, 30, 23, 20, 7, 29, 1, 1, 34, 26, 29, 22, 31, 12, 22, 18, 5, 30, 25, 34, 7, 12, 19]"
70,0,3235,1034,8585,0,2206,1029,"[0, 276, 321, 215, 53, 343, 41, 43, 170, 54, 94, 244, 263, 80, 343, 73, 302, 29, 189, 181, 333, 343, 133, 113, 141, 338, 210, 99, 272]"
71,0,3246,6181,5650,0,907,2339,"[0, 700, 239, 693, 615, 779, 301, 140, 424, 24, 198, 190, 408, 425, 779, 268, 712, 437, 776, 40, 133, 415, 302, 592, 311, 447, 356, 754, 611]"
72,0,4597,2985,7262,0,2509,2088,"[0, 605, 298, 123, 120, 696, 459, 674, 641, 67, 584, 121, 532, 77, 696, 135, 63, 609, 371, 166, 9, 59, 122, 6, 16, 377, 433, 31, 631]"
73,0,4256,5202,6316,0,1066,3190,"[0, 1, 606, 453, 366, 1063, 665, 884, 68, 220, 357, 446, 522, 172, 1063, 490, 233, 509, 247, 366, 820, 734, 1008, 86, 1061, 269, 682, 690, 190]"
74,0,4083,496,9903,0,305,3778,"[0, 828, 527, 821, 1133, 1259, 1092, 908, 1076, 648, 1231, 562, 588, 1094, 1259, 534, 4, 483, 427, 279, 554, 649, 840, 573, 301, 604, 984, 504, 819]"
75,0,3799,5971,7731,0,1963,1836,"[0, 35, 271, 568, 300, 612, 570, 158, 513, 344, 133, 403, 101, 422, 612, 501, 337, 24, 3, 144, 598, 443, 277, 600, 207, 67, 528, 358, 124]"
76,0,3176,1702,9205,0,358,2818,"[0, 58, 360, 22, 246, 939, 417, 745, 73, 792, 542, 694, 554, 533, 939, 866, 541, 800, 851, 369, 309, 179, 241, 201, 721, 667, 939, 855, 809]"
77,0,3973,5786,7392,0,391,3582,"[0, 687, 1159, 936, 312, 1194, 618, 468, 418, 377, 965, 388, 480, 135, 1194, 123, 201, 839, 33, 233, 71, 828, 540, 1000, 323, 513, 289, 581, 149]"
78,0,4638,6270,5760,0,3852,786,"[0, 170, 144, 106, 258, 262, 228, 51, 153, 206, 25, 8, 107, 39, 262, 62, 164, 17, 136, 247, 128, 121, 93, 218, 175, 8, 137, 76, 96]"
79,0,3572,1991,7341,0,2685,887,"[0, 177, 244, 21, 231, 295, 274, 203, 206, 216, 82, 145, 10, 199, 295, 80, 22, 113, 251, 223, 129, 256, 256, 52, 139, 106, 211, 277, 199]"
80,0,3355,3138,7558,0,1584,1771,"[0, 185, 248, 470, 488, 590, 212, 167, 372, 13, 386, 155, 501, 429, 590, 145, 520, 488, 552, 48, 555, 209, 512, 568, 565, 139, 143, 376, 113]"
81,0,3996,5319,6235,0,2171,1825,"[0, 510, 273, 175, 517, 608, 493, 49, 427, 254, 577, 571, 556, 296, 608, 192, 565, 528, 464, 390, 476, 228, 357, 318, 12, 558, 323, 175, 345]"
82,0,4756,4598,6393,0,1735,3021,"[0, 969, 641, 396, 983, 1007, 305, 512, 467, 453, 522, 654, 268, 730, 1007, 768, 590, 844, 390, 281, 404, 990, 346, 908, 259, 837, 18, 634, 197]"
83,0,4983,7195,4181,0,1215,3768,"[0, 267, 905, 1254, 94, 1256, 536, 988, 668, 222, 727, 465, 673, 1105, 1256, 98, 67, 307, 328, 738, 528, 389, 635, 610, 1150, 382, 35, 283, 807]"
84,0,3597,925,6853,0,2683,914,"[0, 72, 44, 166, 128, 304, 72, 84, 194, 183, 69, 65, 143, 48, 304, 71, 279, 20, 238, 65, 11, 266, 247, 44, 186, 183, 173, 273, 261]"
85,0,4098,529,10000,422,1414,2684,"[0, 593, 681, 873, 77, 894, 52, 359, 605, 625, 886, 388, 707, 561, 894, 807, 57, 517, 467, 139, 26, 643, 218, 726, 495, 55, 890, 624, 565]"
86,0,3575,7206,6369,0,199,3376,"[0, 856, 733, 1043, 226, 1125, 134, 463, 809, 299, 354, 186, 74, 307, 1125, 997, 435, 298, 1079, 369, 582, 167, 998, 331, 425, 1019, 879, 1055, 703]"
87,0,3470,3316,6523,0,3126,344,"[0, 61, 47, 31, 74, 114, 31, 73, 36, 34, 4, 86, 6, 70, 114, 32, 25, 30, 59, 79, 70, 22, 58, 89, 59, 101, 67, 63, 20]"
88,0,3123,730,8916,0,1813,1310,"[0, 17, 296, 222, 181, 436, 46, 286, 399, 372, 219, 381, 108, 352, 436, 260, 159, 396, 416, 316, 421, 170, 193, 93, 409, 8, 334, 331, 113]"
89,0,3494,6972,5438,0,2692,802,"[0, 195, 102, 132, 184, 267, 202, 177, 182, 136, 10, 247, 257, 95, 267, 246, 189, 48, 10, 47, 197, 194, 163, 60, 1, 13, 120, 200, 86]"
90,0,3129,1209,7358,0,421,2708,"[0, 308, 701, 477, 649, 902, 101, 32, 525, 428, 753, 893, 807, 480, 902, 729, 290, 779, 608, 895, 755, 97, 239, 624, 619, 351, 740, 615, 427]"
91,0,3716,5310,5764,0,2457,1259,"[0, 129, 299, 8, 404, 419, 367, 107, 184, 131, 371, 251, 392, 404, 419, 149, 86, 273, 242, 416, 220, 180, 223, 235, 18, 396, 346, 87, 181]"
92,0,4792,4147,6409,0,126,4666,"[0, 1189, 941, 874, 1421, 1555, 1437, 208, 1124, 1365, 1208, 785, 995, 365, 1555, 1343, 833, 1099, 118, 1481, 1396, 1133, 145, 909, 571, 406, 947, 531, 522]"
93,0,4543,2229,8723,0,3629,914,"[0, 4, 222, 80, 250, 304, 271, 159, 5, 103, 106, 72, 15, 248, 304, 147, 22, 211, 196, 224, 153, 252, 106, 225, 118, 254, 301, 293, 153]"
94,0,4271,7378,5616,0,38,4233,"[0, 638, 116, 1315, 1179, 1411, 1405, 885, 575, 980, 710, 195, 1117, 1012, 1411, 562, 408, 494, 1043, 1060, 583, 726, 1204, 774, 98, 1278, 277, 1213, 1215]"
95,0,3573,679,8510,0,268,3305,"[0, 995, 404, 19, 452, 1101, 670, 554, 251, 380, 220, 1004, 505, 576, 1101, 169, 400, 317, 644, 668, 242, 101, 794, 1031, 772, 654, 988, 33, 429]"
96,0,4196,5271,7435,0,3035,1161,"[0, 250, 76, 272, 288, 387, 216, 235, 41, 66, 347, 175, 101, 30, 387, 58, 202, 267, 115, 97, 112, 136, 231, 174, 23, 307, 106, 164, 163]"
97,0,4385,5682,6138,0,3118,1267,"[0, 152, 152, 309, 286, 422, 272, 101, 97, 129, 372, 219, 52, 75, 422, 138, 97, 317, 34, 9, 18, 332, 370, 138, 187, 408, 223, 393, 75]"
98,0,4048,306,9880,0,1207,2841,"[0, 942, 559, 383, 245, 947, 389, 104, 853, 909, 372, 425, 455, 885, 947, 218, 367, 248, 101, 170, 886, 815, 238, 373, 114, 50, 625, 194, 75]"
99,0,3261,6129,7012,0,1571,1690,"[0, 37, 562, 220, 145, 563, 25, 125, 459, 404, 465, 125, 402, 129, 563, 410, 205, 310, 9, 43, 529, 93, 0, 415, 240, 413, 207, 276, 463]"
100,0,3434,3006,7440,0,1582,1852,"[0, 15, 569, 429, 212, 617, 442, 244, 109, 56, 151, 384, 186, 534, 617, 608, 42, 308, 550, 597, 226, 291, 413, 162, 453, 384, 390, 216, 109]"
101,0,3924,5576,5788,0,2300,1624,"[0, 436, 98, 313, 240, 541, 335, 171, 128, 383, 384, 513, 416, 407, 541, 73, 321, 262, 529, 469, 354, 323, 222, 260, 516, 301, 314, 67, 87]"
102,0,3780,3772,5796,0,2308,1472,"[0, 309, 467, 394, 268, 490, 303, 375, 200, 197, 474, 224, 261, 79, 490, 109, 369, 153, 396, 450, 442, 145, 448, 297, 35, 11, 175, 195, 30]"
103,0,4303,3097,7002,0,2562,1741,"[0, 368, 153, 251, 474, 580, 171, 407, 519, 312, 362, 347, 487, 472, 580, 386, 251, 561, 3, 283, 151, 134, 302, 506, 156, 421, 113, 374, 195]"
104,0,3171,1676,8497,0,2856,315,"[0, 63, 89, 22, 34, 105, 63, 32, 34, 32, 17, 19, 79, 1, 105, 82, 33, 58, 48, 81, 17, 49, 6, 17, 20, 70, 46, 48, 99]"
105,0,4347,5197,7647,0,3353,994,"[0, 119, 199, 64, 317, 331, 88, 284, 63, 308, 226, 35, 159, 317, 331, 306, 172, 286, 22, 217, 146, 108, 156, 270, 221, 116, 119, 260, 253]"
106,0,4263,6258,5652,0,3015,1248,"[0, 292, 369, 269, 340, 416, 51, 353, 29, 372, 230, 305, 163, 32, 416, 396, 327, 240, 46, 258, 278, 11, 142, 1, 120, 337, 305, 308, 25]"
107,0,3845,1908,7589,0,565,3280,"[0, 335, 779, 1028, 934, 1093, 199, 76, 221, 258, 548, 789, 811, 221, 1093, 940, 695, 596, 716, 659, 498, 1092, 450, 81, 219, 481, 374, 518, 387]"
108,0,3028,2541,8076,0,2667,361,"[0, 86, 45, 5, 24, 120, 8, 22, 43, 93, 116, 33, 117, 38, 120, 84, 83, 47, 12, 84, 33, 104, 31, 2, 79, 19, 118, 77, 63]"
109,0,3065,5198,5943,0,651,2414,"[0, 680, 650, 651, 63, 804, 622, 524, 554, 15, 185, 399, 42, 89, 804, 142, 673, 567, 588, 664, 346, 160, 318, 542, 44, 661, 17, 684, 520]"
110,0,4379,785,9537,0,4079,300,"[0, 27, 63, 47, 57, 100, 12, 73, 49, 20, 50, 49, 42, 46, 100, 76, 68, 35, 41, 90, 66, 98, 43, 92, 8, 91, 83, 5, 60]"
111,0,3588,6120,7005,0,715,2873,"[0, 871, 312, 643, 752, 957, 100, 529, 723, 542, 579, 251, 275, 623, 957, 600, 566, 704, 304, 485, 176, 770, 515, 79, 511, 883, 93, 583, 879]"
112,0,3456,3386,7075,0,2058,1398,"[0, 51, 273, 266, 69, 466, 376, 185, 414, 327, 261, 50, 115, 4, 466, 13, 344, 371, 159, 87, 173, 1, 328, 232, 24, 394, 453, 67, 263]"
113,0,3708,1732,9051,0,1126,2582,"[0, 821, 229, 790, 507, 860, 87, 641, 176, 64, 731, 265, 821, 32, 860, 117, 47, 858, 839, 682, 52, 492, 569, 185, 249, 444, 557, 73, 196]"
114,0,3062,5145,6968,0,834,2228,"[0, 565, 224, 533, 264, 742, 182, 672, 604, 453, 134, 630, 284, 713, 742, 226, 238, 450, 356, 635, 31, 271, 322, 535, 698, 24, 524, 592, 275]"
115,0,3920,1468,9420,0,1543,2377,"[0, 364, 768, 11, 121, 792, 645, 444, 190, 468, 274, 503, 70, 165, 792, 601, 458, 658, 26, 355, 758, 200, 578, 651, 377, 309, 238, 81, 727]"
116,0,3138,7272,5286,0,926,2212,"[0, 244, 52, 659, 720, 737, 468, 479, 0, 269, 150, 350, 200, 579, 737, 661, 359, 179, 120, 592, 367, 428, 206, 281, 636, 265, 717, 495, 236]"
117,0,3637,2696,6227,0,999,2638,"[0, 341, 608, 58, 488, 879, 540, 373, 552, 86, 416, 9, 75, 477, 879, 738, 591, 659, 816, 383, 757, 377, 545, 633, 788, 73, 713, 834, 278]"
118,0,3712,3696,6243,0,406,3306,"[0, 193, 927, 238, 1024, 1102, 491, 914, 273, 365, 707, 899, 324, 297, 1102, 911, 343, 1081, 848, 50, 236, 718, 563, 59, 864, 552, 877, 848, 552]"
119,0,3113,1752,7604,0,2900,213,"[0, 40, 59, 17, 14, 71, 34, 50, 5, 69, 25, 3, 22, 47, 71, 66, 57, 58, 38, 8, 34, 17, 21, 22, 63, 43, 7, 27, 33]"
0,1,5707,0,5707,0,1894,3813,"[1670, 0, 864, 1054, 1004, 1105, 1906, 1869, 797, 625, 740, 181, 1848, 1077, 1755, 109, 1463, 1717, 1779, 1210, 1692, 278, 354, 1762, 22, 934, 1688, 1900, 690]"
1,1,6969,6283,6393,0,316,6653,"[2547, 0, 2329, 3319, 243, 1283, 3326, 3057, 2089, 1475, 1617, 1025, 2035, 97, 2296, 1257, 2832, 200, 1816, 3247, 940, 885, 1961, 1990, 2752, 2222, 2417, 2944, 1931]"
2,1,6536,7290,5639,0,3503,3033,"[919, 0, 1270, 990, 575, 1211, 1516, 435, 1247, 1119, 378, 453, 1409, 1504, 25, 1056, 405, 1072, 807, 976, 20, 407, 944, 614, 1223, 163, 107, 199, 1177]"
3,1,5585,6193,5031,0,1080,4505,"[409, 0, 2098, 443, 234, 865, 2252, 1174, 849, 1684, 1221, 1137, 1397, 1784, 563, 1850, 782, 483, 268, 13, 378, 1141, 2199, 1031, 1680, 1693, 578, 572, 2045]"
4,1,5837,1603,9265,0,2969,2868,"[1273, 0, 1013, 68, 337, 744, 1434, 865, 644, 1303, 958, 1159, 73, 1143, 234, 716, 340, 1089, 478, 540, 299, 1022, 837, 140, 360, 690, 26, 567, 1385]"
5,1,5843,5054,10000,54,839,5004,"[2039, 0, 1333, 1583, 2479, 876, 2502, 939, 1914, 1179, 580, 1945, 185, 101, 1082, 1772, 1046, 2093, 1354, 140, 1522, 1581, 762, 75, 2033, 801, 1709, 96, 218]"
6,1,6872,6455,10000,417,5672,1200,"[117, 0, 165, 537, 419, 287, 600, 558, 227, 186, 68, 417, 559, 542, 145, 245, 248, 125, 186, 482, 104, 311, 458, 89, 356, 98, 359, 26, 260]"
7,1,5016,6432,8584,0,3769,1247,"[111, 0, 541, 570, 588, 474, 623, 295, 104, 140, 333, 177, 368, 400, 194, 236, 509, 440, 386, 168, 335, 543, 473, 614, 89, 507, 220, 487, 224]"
8,1,5281,5273,8592,0,1162,4119,"[1971, 0, 351, 296, 1580, 1762, 2059, 123, 154, 212, 1520, 393, 786, 1261, 293, 115, 1799, 814, 1547, 971, 1225, 1392, 762, 709, 1137, 818, 679, 1414, 1272]"
9,1,6789,5544,9837,0,1356,5433,"[1732, 0, 1996, 7, 14, 516, 2716, 2153, 1185, 997, 1891, 1840, 1876, 5, 376, 1073, 388, 448, 728, 967, 2160, 738, 1771, 394, 342, 1556, 919, 415, 738]"
10,1,6536,5435,10000,938,1758,4778,"[320, 0, 2205, 1032, 85, 1633, 2389, 1186, 399, 1573, 2075, 1971, 1576, 2049, 388, 2010, 590, 2380, 266, 1262, 696, 1657, 126, 1371, 1338, 452, 889, 2119, 1431]"
11,1,5253,5609,9644,0,5239,14,"[2, 0, 5, 1, 7, 6, 7, 4, 7, 2, 2, 5, 1, 4, 0, 3, 4, 5, 0, 0, 0, 5, 4, 2, 4, 0, 6, 6, 1]"
12,1,5558,7474,7728,0,2514,3044,"[807, 0, 853, 1017, 1037, 132, 1522, 1047, 739, 1029, 213, 121, 1291, 653, 1123, 903, 328, 275, 1155, 277, 481, 850, 1130, 872, 852, 1303, 1301, 431, 294]"
13,1,6420,7316,6832,0,6051,369,"[29, 0, 172, 14, 132, 35, 184, 107, 160, 92, 99, 134, 164, 184, 110, 42, 64, 37, 147, 45, 99, 168, 169, 139, 181, 170, 154, 105, 87]"
14,1,6187,7158,5861,0,1532,4655,"[1364, 0, 959, 2024, 2055, 536, 2327, 1194, 254, 2038, 1166, 1514, 497, 1179, 433, 2046, 1308, 2067, 128, 184, 2327, 769, 2211, 2171, 942, 1081, 560, 2218, 2204]"
15,1,5535,5600,5796,0,2418,3117,"[478, 0, 1278, 1226, 75, 1238, 1558, 1551, 545, 412, 947, 1376, 126, 928, 1461, 991, 29, 486, 1223, 942, 68, 1305, 333, 986, 892, 866, 1139, 1176, 358]"
16,1,5705,7029,4472,0,5690,15,"[7, 0, 2, 5, 0, 6, 7, 1, 3, 4, 1, 2, 2, 6, 3, 1, 6, 7, 6, 4, 5, 1, 0, 2, 3, 3, 0, 1, 7]"
17,1,5334,3870,5936,0,3775,1559,"[25, 0, 80, 130, 374, 1, 779, 734, 3, 758, 153, 163, 596, 137, 50, 34, 695, 277, 220, 60, 771, 44, 74, 214, 247, 433, 651, 136, 635]"
18,1,6085,7376,4645,0,2482,3603,"[803, 0, 1021, 311, 692, 1226, 1801, 1468, 678, 878, 242, 1372, 278, 603, 1264, 1088, 769, 579, 578, 413, 1680, 588, 218, 72, 955, 1548, 1019, 1115, 1734]"
19,1,6276,3005,7916,0,1452,4824,"[2412, 0, 275, 255, 648, 598, 2412, 695, 2191, 961, 662, 385, 1775, 1345, 2201, 686, 1007, 1069, 1643, 2211, 490, 535, 1201, 2035, 1857, 252, 1533, 1666, 2384]"
20,1,5326,6946,6296,0,3642,1684,"[332, 0, 422, 387, 675, 759, 842, 423, 166, 159, 66, 586, 6, 118, 261, 103, 551, 23, 299, 189, 317, 573, 439, 783, 294, 733, 452, 102, 627]"
21,1,5348,7115,4529,0,2740,2608,"[1218, 0, 144, 791, 920, 787, 1304, 637, 719, 827, 603, 552, 909, 463, 145, 656, 1187, 116, 326, 819, 810, 45, 992, 20, 119, 944, 476, 145, 506]"
22,1,5122,1284,8367,0,3298,1824,"[803, 0, 171, 811, 86, 179, 912, 654, 430, 552, 751, 463, 317, 120, 31, 227, 396, 716, 840, 263, 61, 704, 171, 885, 42, 332, 33, 553, 494]"
23,1,6260,5367,9260,0,2122,4138,"[1397, 0, 856, 1616, 398, 455, 2069, 718, 657, 1023, 1372, 756, 1150, 1854, 2038, 621, 237, 519, 775, 1868, 668, 849, 381, 1115, 562, 1824, 838, 1478, 1580]"
24,1,5512,5719,9053,0,563,4949,"[626, 0, 682, 2316, 1230, 5, 2474, 1578, 1748, 2440, 543, 2053, 2316, 786, 935, 762, 472, 22, 234, 90, 1301, 2256, 656, 1507, 1176, 1118, 22, 369, 2369]"
25,1,5398,6295,8156,0,3433,1965,"[93, 0, 539, 592, 29, 687, 982, 348, 213, 926, 383, 96, 330, 556, 28, 301, 489, 820, 156, 354, 406, 218, 423, 32, 791, 371, 480, 146, 561]"
26,1,6472,6163,8465,0,1171,5301,"[1817, 0, 2124, 838, 179, 2013, 2650, 1900, 693, 1877, 1312, 2208, 1767, 1306, 386, 2507, 2092, 1419, 876, 2424, 1552, 2243, 470, 496, 570, 1268, 2589, 1728, 139]"
27,1,6324,5685,9104,0,3327,2997,"[1434, 0, 401, 1425, 635, 1025, 1498, 133, 1158, 1337, 427, 861, 460, 1121, 673, 735, 748, 4, 118, 974, 426, 1317, 555, 1021, 1390, 595, 747, 820, 1353]"
28,1,6197,6434,8867,0,5868,329,"[87, 0, 1, 149, 0, 100, 164, 31, 108, 63, 13, 152, 122, 48, 13, 64, 110, 47, 137, 105, 45, 61, 60, 116, 99, 4, 58, 81, 120]"
29,1,5275,5782,8360,0,2343,2932,"[967, 0, 200, 552, 795, 524, 1466, 1078, 1329, 1348, 224, 165, 168, 1005, 1426, 249, 111, 609, 764, 591, 1234, 394, 795, 466, 960, 497, 386, 430, 615]"
30,1,5608,7385,6583,0,4727,881,"[245, 0, 324, 307, 129, 269, 440, 63, 74, 385, 174, 398, 347, 190, 433, 166, 234, 59, 339, 276, 7, 124, 354, 168, 15, 34, 30, 258, 366]"
31,1,5054,6121,5516,0,2692,2362,"[869, 0, 577, 430, 152, 185, 1181, 51, 217, 1147, 1088, 47, 377, 824, 918, 433, 1098, 4, 869, 114, 182, 783, 1071, 656, 678, 1074, 416, 636, 871]"
32,1,5449,1014,9951,0,2941,2508,"[413, 0, 1124, 677, 792, 1073, 1254, 506, 911, 1136, 412, 991, 1079, 761, 1206, 130, 887, 525, 17, 1053, 666, 487, 137, 45, 567, 626, 937, 562, 1082]"
33,1,6935,6672,10000,214,6486,449,"[24, 0, 31, 211, 68, 156, 224, 14, 217, 175, 171, 163, 146, 20, 64, 136, 68, 67, 101, 206, 209, 186, 65, 173, 186, 124, 206, 186, 9]"
34,1,6049,6980,9069,0,2263,3786,"[60, 0, 84, 1396, 1317, 106, 1893, 616, 1232, 124, 1412, 199, 489, 1354, 1823, 639, 623, 885, 49, 328, 1540, 1238, 1087, 1603, 971, 976, 1544, 1480, 1445]"
35,1,6769,6505,9333,0,2041,4728,"[801, 0, 1409, 745, 2358, 879, 2364, 1434, 807, 1335, 905, 2211, 837, 1206, 1314, 385, 349, 62, 271, 503, 2210, 467, 224, 1426, 1344, 1546, 1676, 283, 866]"
36,1,6951,6904,9380,0,5893,1058,"[58, 0, 483, 68, 177, 191, 529, 202, 287, 238, 310, 365, 441, 249, 249, 114, 242, 128, 339, 205, 371, 12, 7, 344, 490, 473, 175, 445, 478]"
37,1,5015,5337,9058,0,4081,934,"[441, 0, 423, 366, 7, 356, 467, 21, 378, 223, 197, 115, 360, 22, 53, 8, 126, 49, 443, 394, 401, 47, 77, 363, 195, 217, 5, 311, 152]"
38,1,5605,5997,8666,0,5561,44,"[9, 0, 4, 13, 17, 11, 22, 11, 22, 8, 2, 0, 22, 15, 10, 21, 13, 4, 12, 9, 0, 16, 13, 8, 0, 3, 10, 18, 15]"
39,1,5454,5351,8769,0,2983,2471,"[1003, 0, 931, 37, 1116, 246, 1235, 866, 95, 1000, 469, 1112, 691, 448, 850, 559, 449, 802, 73, 802, 216, 914, 554, 732, 403, 544, 497, 844, 285]"
40,1,5258,6219,7808,0,1142,4116,"[1299, 0, 467, 1339, 1925, 1294, 2058, 353, 1797, 1141, 1893, 246, 1350, 101, 1958, 265, 1673, 948, 1603, 1160, 1920, 639, 1933, 613, 737, 860, 1618, 1668, 242]"
41,1,6890,7135,7563,0,749,6141,"[2660, 0, 1311, 1746, 959, 2735, 3070, 1807, 1939, 2512, 1180, 188, 2412, 1670, 2194, 1043, 1848, 689, 68, 1815, 235, 2542, 2851, 2380, 1906, 1862, 13, 2699, 2977]"
42,1,5656,6468,6751,0,5098,558,"[92, 0, 211, 38, 265, 247, 279, 61, 7, 72, 216, 18, 266, 137, 239, 11, 144, 117, 141, 108, 195, 35, 205, 182, 145, 191, 61, 21, 40]"
43,1,6908,5720,7939,0,5377,1531,"[693, 0, 517, 163, 385, 557, 765, 17, 211, 509, 217, 272, 683, 79, 443, 68, 3, 452, 251, 63, 625, 742, 340, 296, 173, 158, 694, 18, 181]"
44,1,6015,6214,7740,0,2804,3211,"[1235, 0, 159, 690, 416, 235, 1605, 693, 59, 1369, 1053, 976, 1281, 252, 49, 1029, 1232, 1351, 55, 641, 112, 902, 367, 849, 1271, 955, 824, 413, 1600]"
45,1,6965,6186,8519,0,6924,41,"[14, 0, 4, 6, 11, 10, 20, 2, 20, 2, 3, 5, 1, 13, 2, 14, 2, 8, 20, 8, 7, 17, 8, 14, 8, 16, 19, 2, 12]"
46,1,5174,6208,7485,0,2166,3008,"[1181, 0, 787, 1369, 215, 59, 1504, 93, 843, 988, 681, 917, 346, 1376, 1093, 812, 460, 787, 885, 1446, 1098, 382, 636, 367, 930, 1253, 1244, 1125, 674]"
47,1,5231,6320,6396,0,472,4759,"[2336, 0, 1883, 2132, 2167, 2294, 2379, 1979, 130, 166, 1584, 1240, 982, 1487, 321, 2080, 352, 1175, 2096, 1961, 176, 0, 474, 1258, 665, 1032, 2306, 2116, 793]"
48,1,5032,7433,3995,0,763,4269,"[49, 0, 1242, 1817, 533, 278, 2134, 1880, 396, 1748, 1409, 2011, 1278, 1142, 1887, 114, 563, 987, 36, 1985, 1166, 1875, 310, 1060, 545, 482, 1368, 528, 1947]"
49,1,5619,4613,5001,0,3568,2051,"[640, 0, 820, 897, 172, 91, 1025, 118, 72, 537, 162, 270, 96, 681, 870, 980, 121, 41, 275, 94, 875, 760, 817, 466, 392, 380, 390, 109, 0]"
50,1,6407,5769,5639,0,397,6010,"[2443, 0, 151, 2776, 382, 1254, 3005, 2283, 393, 710, 1611, 2986, 596, 1154, 487, 465, 2436, 2138, 758, 2099, 1659, 1041, 274, 1554, 2440, 752, 431, 1801, 2999]"
51,1,5586,6589,4636,0,2486,3100,"[546, 0, 287, 786, 1485, 66, 1550, 1305, 1299, 423, 521, 502, 900, 1033, 707, 785, 1318, 793, 258, 513, 1246, 1167, 757, 384, 997, 197, 286, 950, 8]"
52,1,5326,3055,6907,0,2457,2869,"[1165, 0, 203, 49, 843, 653, 1434, 17, 107, 1013, 1153, 804, 928, 1357, 263, 808, 735, 553, 275, 1249, 907, 788, 529, 1288, 961, 1432, 501, 1433, 65]"
53,1,6127,7324,5710,0,5282,845,"[43, 0, 154, 284, 384, 17, 422, 92, 203, 47, 164, 190, 365, 87, 183, 23, 358, 140, 142, 185, 240, 214, 66, 282, 141, 318, 200, 99, 280]"
54,1,5219,1974,8955,0,4725,494,"[9, 0, 72, 22, 229, 193, 247, 168, 8, 213, 200, 244, 63, 133, 210, 24, 147, 143, 123, 58, 118, 202, 206, 23, 93, 52, 59, 134, 118]"
55,1,6598,7337,8216,0,4072,2526,"[181, 0, 996, 763, 1154, 660, 1263, 778, 166, 262, 156, 285, 1067, 1010, 431, 542, 1125, 533, 1102, 296, 741, 978, 266, 61, 152, 113, 359, 318, 1116]"
56,1,5610,6188,7638,0,521,5089,"[120, 0, 359, 1904, 311, 798, 2544, 438, 434, 2311, 1187, 181, 1329, 915, 1352, 266, 1025, 347, 1201, 774, 1500, 1008, 625, 1706, 357, 1357, 2212, 913, 1108]"
57,1,6133,7373,6398,0,3622,2511,"[338, 0, 483, 1149, 527, 169, 1255, 906, 642, 1110, 1054, 597, 819, 1207, 790, 336, 499, 1169, 713, 775, 483, 388, 918, 1107, 999, 1144, 244, 669, 190]"
58,1,6822,6440,6780,0,1191,5631,"[264, 0, 607, 2537, 2291, 1946, 2815, 1700, 1748, 1982, 234, 2246, 976, 73, 2171, 192, 1085, 2458, 579, 288, 1729, 322, 2741, 915, 2670, 1329, 2275, 919, 1602]"
59,1,5020,6371,5429,0,3495,1525,"[442, 0, 528, 665, 134, 447, 762, 547, 661, 407, 625, 43, 107, 313, 667, 19, 386, 276, 257, 588, 731, 722, 93, 757, 432, 69, 715, 514, 395]"
60,1,6468,7177,4720,0,5911,557,"[268, 0, 132, 65, 13, 81, 278, 128, 156, 173, 140, 61, 272, 251, 46, 92, 156, 103, 164, 136, 132, 93, 63, 89, 28, 14, 150, 141, 230]"
61,1,5594,3787,6527,0,3939,1655,"[705, 0, 276, 472, 770, 490, 827, 682, 623, 364, 485, 433, 676, 11, 162, 693, 825, 703, 470, 668, 170, 602, 270, 444, 115, 230, 141, 88, 76]"
62,1,5944,5589,6882,0,2612,3332,"[606, 0, 442, 1495, 1225, 1468, 1666, 818, 1401, 1486, 655, 427, 1162, 1125, 888, 1459, 752, 819, 1446, 113, 1618, 307, 568, 1647, 1096, 634, 397, 87, 1265]"
63,1,6973,5564,8291,0,1100,5873,"[931, 0, 858, 1716, 639, 2089, 2936, 1823, 1546, 94, 394, 2591, 1024, 1037, 1001, 796, 2562, 2822, 1019, 582, 2824, 2168, 2789, 1154, 993, 2764, 2474, 1323, 2757]"
64,1,5024,5976,7339,0,1354,3670,"[1076, 0, 805, 71, 1831, 1593, 1835, 1374, 1701, 1345, 236, 1795, 883, 1558, 60, 1634, 1051, 125, 1031, 1798, 1454, 982, 145, 1150, 610, 878, 1831, 1688, 386]"
65,1,5260,5023,7576,0,4585,675,"[130, 0, 196, 130, 326, 212, 337, 9, 3, 23, 310, 286, 27, 260, 147, 148, 112, 284, 206, 144, 273, 79, 22, 31, 121, 245, 201, 60, 219]"
66,1,5233,5904,6905,0,4411,822,"[155, 0, 1, 108, 100, 329, 411, 340, 348, 70, 139, 130, 317, 85, 346, 375, 214, 318, 46, 262, 316, 235, 220, 94, 387, 17, 404, 20, 135]"
67,1,6337,6065,7177,0,2466,3871,"[941, 0, 1042, 213, 440, 1729, 1935, 199, 1219, 547, 1461, 793, 1728, 1330, 1503, 657, 1277, 1523, 1707, 451, 201, 1667, 747, 959, 383, 1794, 1590, 661, 394]"
68,1,6034,7178,6033,0,5621,413,"[21, 0, 21, 2, 62, 203, 206, 134, 71, 179, 109, 22, 55, 81, 164, 24, 138, 194, 1, 92, 68, 190, 117, 132, 24, 137, 170, 161, 108]"
69,1,5502,5150,6385,0,1326,4176,"[1044, 0, 2046, 1257, 550, 306, 2088, 1326, 571, 1162, 1665, 1618, 1150, 1803, 288, 1522, 1937, 839, 911, 1613, 1178, 1484, 352, 1540, 887, 1274, 349, 603, 768]"
70,1,6595,6387,6593,0,4262,2333,"[1074, 0, 232, 451, 925, 282, 1166, 580, 1064, 660, 817, 239, 1115, 361, 102, 873, 627, 673, 452, 964, 956, 581, 1071, 557, 368, 441, 543, 170, 335]"
71,1,5813,5795,6611,0,5397,416,"[144, 0, 132, 190, 189, 124, 208, 126, 18, 130, 76, 51, 133, 168, 4, 69, 195, 118, 8, 145, 120, 18, 105, 44, 83, 129, 64, 205, 116]"
72,1,6761,6826,6546,0,4959,1802,"[642, 0, 435, 779, 230, 540, 901, 657, 164, 431, 315, 436, 668, 428, 114, 79, 12, 57, 850, 232, 898, 370, 361, 805, 716, 222, 656, 785, 804]"
73,1,6806,5961,7391,0,5118,1688,"[644, 0, 96, 796, 15, 24, 844, 509, 328, 530, 415, 629, 790, 660, 125, 168, 768, 301, 386, 473, 17, 199, 441, 316, 43, 762, 623, 404, 684]"
74,1,6084,6860,6615,0,2657,3427,"[1096, 0, 525, 985, 1495, 124, 1713, 428, 594, 664, 1226, 1052, 115, 1680, 390, 907, 76, 898, 552, 1578, 1094, 446, 305, 822, 1615, 1224, 461, 1309, 425]"
75,1,5327,6568,5374,0,943,4384,"[1319, 0, 1880, 1502, 461, 227, 2192, 441, 1850, 702, 1629, 659, 1748, 1699, 2076, 1882, 1106, 415, 1343, 1965, 1418, 765, 502, 870, 1301, 115, 22, 397, 304]"
76,1,5046,4920,5500,0,1267,3779,"[1474, 0, 342, 1364, 956, 391, 1889, 1396, 1535, 1063, 689, 1208, 314, 422, 1316, 939, 1510, 1304, 1211, 1812, 504, 102, 1646, 1642, 651, 483, 1880, 589, 1849]"
77,1,6203,6078,5625,0,1484,4719,"[445, 0, 2191, 1619, 772, 1759, 2359, 208, 815, 2199, 637, 1453, 553, 991, 906, 1549, 194, 1350, 1302, 864, 2310, 1367, 1899, 1575, 947, 2152, 167, 359, 2088]"
78,1,5428,5857,5196,0,3211,2217,"[607, 0, 321, 726, 306, 761, 1108, 240, 303, 24, 840, 1022, 703, 419, 1065, 329, 339, 1097, 79, 984, 177, 890, 795, 133, 61, 813, 610, 777, 496]"
79,1,6957,6852,5301,0,6431,526,"[222, 0, 140, 151, 219, 204, 263, 37, 175, 69, 239, 158, 145, 57, 25, 30, 190, 197, 97, 10, 53, 253, 191, 227, 205, 143, 12, 19, 84]"
80,1,6749,5033,7017,0,5517,1232,"[227, 0, 182, 311, 258, 224, 616, 399, 467, 383, 467, 48, 187, 345, 403, 572, 479, 205, 535, 576, 205, 170, 597, 318, 489, 169, 75, 537, 120]"
81,1,6126,6155,6988,0,2524,3602,"[522, 0, 378, 632, 1486, 860, 1801, 1289, 783, 1481, 931, 1664, 1150, 1575, 1442, 1117, 516, 380, 37, 937, 959, 1049, 692, 228, 1365, 101, 249, 965, 426]"
82,1,6406,6306,7088,0,2189,4217,"[1012, 0, 385, 1895, 714, 203, 2108, 226, 1799, 167, 621, 1730, 1661, 2005, 1474, 376, 269, 578, 625, 5, 968, 50, 876, 385, 331, 946, 632, 1242, 577]"
83,1,5357,7059,5386,0,2332,3025,"[829, 0, 868, 914, 615, 1336, 1512, 444, 168, 933, 165, 709, 1345, 1149, 213, 1400, 1470, 969, 781, 59, 104, 208, 321, 1008, 750, 1367, 1457, 868, 406]"
84,1,5684,5245,5825,0,4337,1347,"[429, 0, 537, 223, 673, 371, 673, 212, 558, 250, 653, 313, 249, 510, 156, 309, 448, 362, 194, 261, 118, 140, 14, 312, 544, 190, 419, 466, 636]"
85,1,5179,7378,3626,0,2393,2786,"[756, 0, 395, 600, 480, 1193, 1393, 142, 141, 1171, 861, 1256, 893, 330, 268, 513, 1127, 1276, 1288, 406, 1142, 1106, 1051, 1105, 40, 791, 1072, 904, 1373]"
86,1,5985,2614,6997,0,1730,4255,"[590, 0, 1647, 537, 813, 1537, 2127, 1249, 1685, 522, 2023, 920, 1175, 568, 2040, 1405, 1425, 1586, 726, 721, 919, 1812, 1048, 1867, 21, 1892, 1079, 277, 964]"
87,1,6561,5991,7567,0,5610,951,"[346, 0, 98, 312, 71, 430, 475, 474, 84, 359, 11, 451, 294, 348, 380, 228, 326, 25, 254, 316, 184, 9, 256, 359, 102, 9, 279, 63, 244]"
88,1,5000,7172,5395,0,4272,728,"[306, 0, 150, 323, 50, 325, 364, 179, 167, 82, 335, 145, 206, 239, 79, 49, 199, 234, 248, 110, 129, 221, 144, 131, 337, 334, 330, 253, 74]"
89,1,6505,5994,5906,0,4743,1762,"[219, 0, 488, 881, 501, 690, 881, 466, 420, 323, 795, 309, 621, 673, 215, 335, 872, 180, 490, 747, 326, 190, 13, 793, 269, 41, 180, 323, 675]"
90,1,6222,5037,7091,0,487,5735,"[561, 0, 1443, 494, 2505, 1048, 2867, 86, 1925, 1169, 2440, 2647, 1255, 2822, 904, 561, 768, 237, 1660, 1923, 2391, 2270, 1863, 458, 1943, 1538, 103, 1097, 1228]"
91,1,5466,5332,7225,0,5084,382,"[127, 0, 150, 122, 16, 109, 191, 89, 54, 47, 26, 44, 32, 81, 13, 132, 79, 59, 83, 30, 100, 76, 112, 101, 63, 4, 126, 94, 56]"
92,1,6684,5882,8027,0,598,6086,"[1376, 0, 1019, 2878, 1374, 2514, 3043, 658, 1504, 256, 1921, 2376, 810, 1163, 730, 2343, 998, 2615, 2594, 2348, 2853, 1857, 1431, 127, 2280, 989, 2690, 673, 1844]"
93,1,5957,7380,6604,0,756,5201,"[1432, 0, 2508, 1935, 1539, 1650, 2600, 1974, 1071, 1807, 1293, 2023, 318, 1448, 1165, 1993, 2238, 1533, 2119, 2481, 375, 2045, 2206, 582, 1972, 1389, 1674, 2415, 603]"
94,1,5233,6268,5569,0,4323,910,"[306, 0, 274, 144, 142, 63, 455, 64, 191, 150, 10, 295, 339, 434, 200, 45, 105, 109, 417, 82, 350, 320, 431, 86, 80, 32, 341, 301, 7]"
95,1,5818,7281,4106,0,1490,4328,"[602, 0, 1908, 68, 1543, 1595, 2164, 14, 879, 227, 170, 695, 1497, 2093, 600, 99, 984, 1268, 1940, 678, 2081, 956, 1914, 786, 2064, 1386, 2092, 1098, 2164]"
96,1,5144,642,8608,0,4804,340,"[99, 0, 5, 31, 151, 99, 170, 38, 21, 38, 107, 125, 34, 60, 132, 45, 169, 64, 118, 89, 75, 164, 78, 40, 132, 30, 144, 1, 46]"
97,1,5986,5673,8921,0,1631,4355,"[921, 0, 922, 991, 748, 943, 2177, 385, 602, 843, 1598, 1092, 2055, 967, 760, 797, 773, 860, 548, 1884, 117, 2129, 1878, 340, 376, 1391, 35, 1654, 912]"
98,1,6537,5662,9796,0,6051,486,"[91, 0, 129, 104, 153, 156, 243, 171, 59, 16, 137, 121, 220, 142, 122, 148, 101, 30, 63, 84, 155, 71, 164, 241, 62, 202, 31, 29, 129]"
99,1,5676,6114,9358,0,2903,2773,"[1348, 0, 915, 397, 282, 1337, 1386, 1043, 64, 662, 1379, 853, 823, 1162, 267, 570, 364, 210, 445, 353, 571, 963, 13, 572, 127, 1126, 1304, 684, 548]"
100,1,5493,5402,9449,0,3756,1737,"[307, 0, 332, 84, 37, 736, 868, 59, 439, 822, 333, 281, 63, 434, 53, 63, 228, 416, 804, 469, 418, 689, 733, 191, 26, 435, 836, 739, 106]"
101,1,6406,6889,8966,0,4995,1411,"[249, 0, 481, 1, 33, 60, 705, 87, 510, 244, 201, 120, 2, 647, 555, 626, 617, 448, 91, 386, 134, 543, 538, 221, 142, 603, 611, 23, 326]"
102,1,6314,5929,9351,0,5412,902,"[244, 0, 395, 103, 281, 304, 451, 212, 353, 12, 175, 32, 163, 315, 258, 173, 59, 190, 86, 287, 52, 194, 327, 173, 171, 209, 126, 402, 84]"
103,1,6965,6650,9666,0,407,6558,"[902, 0, 2344, 75, 2722, 3279, 3279, 2904, 2158, 1698, 1407, 1251, 1300, 2938, 421, 2773, 532, 140, 2841, 1280, 790, 2701, 2277, 1344, 2937, 2685, 315, 2937, 1184]"
104,1,6914,7383,9197,0,5290,1624,"[188, 0, 473, 359, 252, 394, 812, 271, 734, 497, 482, 782, 336, 86, 494, 649, 518, 725, 314, 504, 236, 397, 0, 310, 497, 184, 793, 181, 575]"
105,1,6235,7063,8369,0,1258,4977,"[1046, 0, 2246, 264, 1326, 1333, 2488, 1617, 671, 417, 1188, 1916, 832, 2384, 434, 1328, 496, 624, 958, 1879, 585, 588, 512, 2339, 477, 714, 372, 1607, 1760]"
106,1,6379,6477,8271,0,54,6325,"[683, 0, 256, 327, 2196, 2929, 3162, 1315, 1303, 1786, 1052, 416, 208, 2193, 2292, 371, 2093, 1403, 1717, 1107, 87, 2280, 1572, 2837, 1573, 1889, 247, 1740, 2096]"
107,1,5598,5049,8820,0,2849,2749,"[780, 0, 62, 421, 749, 1259, 1374, 922, 750, 854, 1340, 1197, 852, 466, 322, 820, 359, 683, 1291, 503, 226, 871, 1070, 853, 915, 1077, 987, 235, 987]"
108,1,5806,5127,9499,0,1985,3821,"[1255, 0, 960, 770, 752, 898, 1910, 1225, 1504, 9, 1179, 1277, 9, 1352, 871, 1890, 84, 208, 1423, 614, 1032, 881, 1413, 602, 1272, 612, 1119, 1371, 1757]"
109,1,6890,7143,9246,0,4964,1926,"[758, 0, 243, 872, 395, 699, 963, 295, 626, 337, 790, 388, 438, 622, 910, 817, 654, 498, 961, 384, 408, 846, 153, 549, 23, 636, 386, 476, 623]"
110,1,5500,7237,7509,0,5441,59,"[3, 0, 16, 28, 6, 13, 29, 10, 28, 3, 1, 29, 9, 8, 20, 15, 27, 14, 5, 6, 13, 1, 14, 13, 10, 9, 10, 24, 20]"
111,1,6887,6662,7734,0,1098,5789,"[2039, 0, 2153, 1182, 2678, 366, 2894, 709, 1912, 1521, 2206, 664, 2497, 149, 1734, 2594, 367, 2707, 1260, 1610, 2617, 1787, 2818, 1801, 2400, 642, 112, 131, 2459]"
112,1,5303,5499,7538,0,4800,503,"[191, 0, 13, 215, 23, 11, 251, 204, 228, 230, 214, 111, 90, 63, 36, 85, 47, 174, 120, 148, 167, 241, 152, 220, 246, 73, 141, 140, 45]"
113,1,5740,5734,7544,0,5578,162,"[23, 0, 59, 56, 35, 74, 81, 72, 6, 19, 29, 14, 31, 30, 57, 71, 43, 55, 47, 28, 21, 48, 8, 28, 8, 24, 71, 66, 36]"
114,1,5282,6219,6607,0,2753,2529,"[112, 0, 1027, 462, 112, 134, 1264, 955, 381, 1261, 453, 564, 1195, 673, 1152, 361, 594, 744, 132, 1194, 244, 354, 140, 798, 1043, 938, 1223, 448, 949]"
115,1,5043,6405,5245,0,643,4400,"[1189, 0, 1886, 860, 1921, 2097, 2200, 696, 1185, 1269, 1204, 60, 766, 818, 1192, 216, 646, 1109, 965, 867, 2191, 307, 735, 2017, 2072, 355, 1406, 130, 2016]"
116,1,5099,4436,5908,0,478,4621,"[920, 0, 1498, 912, 984, 755, 2310, 56, 2049, 434, 130, 1619, 510, 125, 1645, 754, 1319, 2302, 769, 911, 1951, 1214, 1223, 1229, 1244, 2122, 260, 745, 1101]"
117,1,6656,6211,6353,0,2200,4456,"[1313, 0, 2215, 1224, 704, 1613, 2228, 520, 2109, 320, 862, 1283, 451, 837, 642, 2122, 483, 1206, 24, 2174, 247, 1132, 637, 2095, 831, 2174, 2102, 624, 835]"
118,1,5663,6611,5405,0,3918,1745,"[154, 0, 358, 360, 595, 645, 872, 361, 188, 652, 732, 608, 403, 600, 460, 730, 625, 636, 212, 622, 379, 642, 347, 328, 870, 630, 772, 808, 580]"
119,1,6811,5120,7096,0,6537,274,"[92, 0, 50, 3, 135, 78, 137, 9, 132, 70, 75, 1, 25, 124, 13, 90, 13, 53, 100, 90, 71, 55, 131, 106, 4, 136, 47, 78, 28]"
0,2,3055,0,3055,0,1860,1195,"[217, 328, 0, 327, 398, 126, 31, 398, 37, 294, 22, 19, 30, 264, 54, 26, 97, 371, 317, 311, 281, 313, 62, 258, 248, 297, 271, 86, 387]"
1,2,4573,3476,4152,0,1788,2785,"[256, 603, 0, 76, 928, 1, 880, 928, 15, 306, 12, 669, 398, 96, 861, 100, 190, 82, 570, 370, 398, 413, 798, 697, 807, 716, 166, 403, 822]"
2,2,3814,25,7941,0,648,3166,"[954, 325, 0, 215, 1055, 415, 447, 1055, 655, 201, 914, 638, 404, 426, 394, 612, 948, 182, 521, 809, 510, 39, 710, 323, 224, 849, 575, 32, 464]"
3,2,4721,7012,5650,0,1628,3093,"[147, 393, 0, 578, 1031, 736, 3, 1031, 264, 597, 93, 507, 95, 756, 745, 657, 20, 139, 563, 607, 647, 574, 117, 175, 185, 748, 515, 629, 826]"
4,2,4807,3125,7332,0,586,4221,"[601, 204, 0, 147, 1407, 458, 1050, 1407, 653, 1149, 687, 1189, 1330, 636, 1018, 1239, 649, 584, 1375, 380, 970, 998, 1102, 693, 1267, 697, 939, 987, 839]"
5,2,4673,6525,5480,0,2031,2642,"[288, 360, 0, 426, 880, 749, 167, 880, 409, 831, 474, 812, 46, 472, 312, 1, 656, 169, 636, 37, 256, 176, 268, 287, 673, 714, 743, 107, 508]"
6,2,4272,1200,8552,0,2908,1364,"[55, 439, 0, 100, 454, 247, 82, 454, 284, 284, 237, 365, 411, 116, 3, 210, 83, 50, 257, 417, 237, 269, 69, 370, 278, 331, 426, 125, 20]"
7,2,4900,5284,8168,0,2703,2197,"[21, 607, 0, 565, 732, 147, 299, 732, 637, 452, 84, 486, 221, 299, 387, 150, 157, 26, 666, 420, 71, 330, 190, 587, 162, 84, 442, 685, 376]"
8,2,3595,6734,5029,0,2686,909,"[303, 186, 0, 107, 303, 293, 190, 303, 57, 277, 283, 157, 250, 268, 127, 15, 145, 189, 254, 54, 195, 0, 163, 298, 63, 263, 160, 192, 110]"
9,2,3759,1015,7773,0,3700,59,"[3, 16, 0, 16, 19, 5, 16, 19, 2, 4, 2, 5, 17, 9, 7, 4, 17, 16, 12, 3, 5, 18, 13, 14, 3, 7, 6, 8, 4]"
10,2,3902,5218,6457,0,262,3640,"[525, 914, 0, 839, 1213, 751, 598, 1213, 1156, 500, 1015, 641, 1189, 510, 419, 672, 324, 330, 632, 1166, 67, 964, 1166, 158, 120, 313, 756, 712, 801]"
11,2,4909,6300,5066,0,201,4708,"[1501, 875, 0, 151, 1569, 992, 829, 1569, 685, 481, 92, 919, 1438, 323, 1085, 591, 373, 574, 646, 1160, 702, 1470, 1127, 995, 751, 498, 364, 1362, 1414]"
12,2,3510,1013,7563,0,984,2526,"[651, 282, 0, 710, 842, 405, 695, 842, 259, 655, 763, 525, 278, 48, 21, 196, 29, 218, 761, 620, 763, 576, 535, 429, 745, 569, 524, 539, 117]"
13,2,4103,7466,4200,0,1034,3069,"[627, 299, 0, 285, 1023, 731, 628, 1023, 57, 877, 733, 756, 413, 908, 588, 942, 951, 23, 116, 705, 334, 959, 274, 561, 67, 448, 786, 402, 139]"
14,2,3593,1524,6269,0,1391,2202,"[114, 453, 0, 341, 734, 426, 69, 734, 188, 460, 630, 551, 24, 441, 419, 660, 378, 253, 594, 418, 719, 275, 399, 599, 22, 378, 231, 136, 402]"
15,2,3464,220,9513,0,1940,1524,"[379, 366, 0, 150, 508, 290, 163, 508, 314, 129, 342, 217, 150, 228, 437, 96, 89, 372, 146, 294, 182, 142, 422, 39, 376, 352, 478, 288, 201]"
16,2,3539,6192,6860,0,1684,1855,"[588, 549, 0, 369, 618, 370, 487, 618, 415, 147, 209, 445, 356, 218, 216, 407, 18, 278, 493, 389, 333, 130, 322, 359, 574, 180, 47, 558, 280]"
17,2,3934,3646,7148,0,2345,1589,"[355, 270, 0, 488, 529, 26, 288, 529, 339, 363, 253, 57, 319, 82, 272, 475, 230, 129, 277, 476, 83, 113, 115, 461, 91, 13, 29, 491, 318]"
18,2,4095,6784,4459,0,3036,1059,"[123, 314, 0, 245, 353, 107, 146, 353, 16, 64, 180, 53, 87, 83, 88, 253, 258, 197, 313, 223, 171, 333, 132, 298, 36, 162, 103, 349, 9]"
19,2,4303,108,8654,0,3527,776,"[237, 117, 0, 121, 258, 34, 218, 258, 48, 164, 186, 176, 130, 211, 235, 218, 153, 141, 174, 258, 106, 165, 254, 129, 90, 139, 215, 54, 99]"
20,2,3969,5576,7047,0,3598,371,"[120, 95, 0, 107, 123, 13, 73, 123, 40, 42, 117, 20, 48, 30, 105, 89, 7, 44, 85, 99, 37, 21, 49, 103, 59, 86, 99, 63, 118]"
21,2,4855,5709,6193,0,2775,2080,"[531, 385, 0, 537, 693, 411, 225, 693, 653, 576, 532, 187, 437, 78, 154, 481, 44, 368, 361, 430, 269, 645, 305, 165, 649, 398, 15, 88, 484]"
22,2,3790,3621,6362,0,82,3708,"[1010, 529, 0, 633, 1236, 959, 438, 1236, 689, 1142, 369, 685, 1209, 1163, 768, 1092, 253, 1007, 320, 957, 668, 566, 237, 554, 281, 884, 296, 1041, 631]"
23,2,4819,5898,5283,0,1153,3666,"[379, 883, 0, 372, 1222, 20, 959, 1222, 873, 330, 688, 486, 9, 931, 776, 1134, 1062, 1210, 845, 131, 681, 105, 730, 768, 446, 133, 107, 320, 1012]"
24,2,3108,1019,7372,0,414,2694,"[322, 466, 0, 362, 898, 87, 567, 898, 372, 570, 3, 157, 539, 658, 733, 269, 74, 486, 583, 287, 146, 618, 14, 721, 591, 817, 387, 96, 255]"
25,2,4562,5455,6479,0,3716,846,"[229, 31, 0, 90, 282, 89, 129, 282, 60, 268, 123, 227, 159, 60, 53, 187, 113, 144, 262, 161, 254, 209, 128, 111, 242, 53, 248, 46, 112]"
26,2,3213,507,9185,0,1473,1740,"[432, 524, 0, 404, 580, 8, 536, 580, 37, 413, 439, 306, 449, 392, 406, 226, 161, 15, 50, 31, 437, 273, 388, 455, 377, 354, 25, 521, 378]"
27,2,3138,6235,6088,0,2253,885,"[229, 128, 0, 216, 295, 91, 261, 295, 196, 167, 53, 63, 3, 214, 38, 147, 90, 22, 65, 62, 216, 140, 131, 184, 245, 69, 171, 62, 68]"
28,2,3863,1302,8649,0,1530,2333,"[146, 358, 0, 380, 777, 293, 137, 777, 48, 374, 240, 145, 750, 210, 610, 755, 667, 74, 189, 503, 409, 539, 361, 757, 245, 558, 341, 332, 350]"
29,2,4549,5943,7255,0,4425,124,"[23, 8, 0, 30, 41, 18, 17, 41, 9, 22, 1, 24, 33, 20, 40, 39, 41, 20, 10, 36, 18, 4, 37, 38, 41, 15, 31, 10, 17]"
30,2,4328,6999,4584,0,2368,1960,"[227, 395, 0, 390, 653, 356, 439, 653, 259, 435, 568, 361, 630, 629, 242, 428, 574, 102, 454, 98, 78, 365, 576, 172, 516, 337, 643, 48, 257]"
31,2,4425,1498,7511,0,569,3856,"[929, 249, 0, 42, 1285, 56, 1199, 1285, 145, 442, 597, 590, 208, 124, 883, 875, 232, 1181, 929, 690, 862, 1099, 685, 1115, 1253, 267, 595, 99, 1173]"
32,2,4461,6223,5749,0,4354,107,"[4, 25, 0, 35, 35, 22, 21, 35, 30, 33, 12, 6, 22, 34, 16, 13, 18, 18, 21, 17, 34, 18, 29, 2, 32, 23, 32, 23, 13]"
33,2,3394,1292,7851,0,43,3351,"[707, 1063, 0, 1052, 1117, 972, 833, 1117, 835, 285, 1110, 993, 896, 857, 334, 922, 1004, 688, 29, 926, 542, 716, 681, 23, 644, 357, 383, 356, 879]"
34,2,4623,7206,5268,0,4511,112,"[16, 30, 0, 33, 37, 33, 14, 37, 34, 4, 2, 0, 24, 22, 27, 8, 32, 11, 22, 7, 0, 27, 4, 26, 31, 25, 19, 23, 37]"
35,2,3992,2598,6662,0,3892,100,"[25, 18, 0, 14, 33, 28, 3, 33, 22, 6, 5, 15, 23, 19, 5, 18, 30, 29, 24, 9, 13, 14, 17, 0, 19, 30, 26, 17, 5]"
36,2,3053,607,9108,0,1354,1699,"[312, 545, 0, 77, 566, 58, 159, 566, 404, 284, 485, 36, 425, 45, 37, 296, 549, 79, 198, 238, 130, 408, 312, 149, 206, 511, 183, 508, 46]"
37,2,4732,5303,8537,0,2504,2228,"[111, 462, 0, 71, 742, 624, 364, 742, 207, 342, 388, 430, 622, 41, 283, 101, 448, 221, 185, 728, 251, 668, 710, 62, 267, 332, 210, 444, 50]"
38,2,3982,5745,6774,0,544,3438,"[654, 616, 0, 333, 1146, 1128, 128, 1146, 589, 892, 1081, 794, 1016, 1014, 1083, 1124, 229, 102, 607, 126, 419, 655, 429, 704, 1011, 250, 797, 225, 972]"
39,2,3913,3286,7401,0,3709,204,"[67, 19, 0, 22, 68, 34, 13, 68, 40, 40, 55, 28, 17, 66, 51, 23, 39, 12, 64, 66, 43, 23, 15, 18, 1, 31, 48, 20, 55]"
40,2,3249,284,10000,366,1042,2207,"[118, 581, 0, 329, 735, 482, 538, 735, 442, 536, 195, 463, 708, 492, 632, 309, 265, 244, 523, 713, 707, 375, 516, 243, 722, 510, 544, 392, 269]"
41,2,4692,6530,8162,0,1591,3101,"[941, 641, 0, 701, 1033, 357, 152, 1033, 172, 704, 646, 451, 838, 529, 164, 445, 472, 1030, 757, 290, 215, 784, 699, 68, 845, 392, 383, 173, 732]"
42,2,4970,6726,6406,0,2070,2900,"[803, 246, 0, 668, 966, 434, 834, 966, 949, 848, 715, 334, 549, 663, 499, 656, 21, 205, 97, 612, 938, 105, 855, 322, 132, 920, 726, 576, 757]"
43,2,4793,5279,5920,0,4166,627,"[119, 99, 0, 78, 209, 150, 99, 209, 22, 26, 140, 86, 52, 98, 1, 103, 44, 25, 60, 23, 86, 57, 95, 50, 75, 188, 40, 165, 1]"
44,2,3079,462,8537,0,1867,1212,"[355, 263, 0, 127, 404, 12, 318, 404, 400, 145, 199, 29, 291, 37, 262, 190, 129, 386, 342, 376, 91, 288, 197, 258, 42, 106, 354, 247, 381]"
45,2,3706,5909,6334,0,2254,1452,"[18, 252, 0, 137, 484, 427, 88, 484, 261, 396, 423, 174, 197, 129, 49, 63, 412, 458, 87, 92, 466, 217, 415, 428, 449, 268, 208, 132, 194]"
46,2,3144,208,9270,0,1390,1754,"[219, 189, 0, 101, 584, 399, 363, 584, 176, 251, 148, 413, 235, 210, 565, 305, 106, 187, 245, 56, 313, 391, 470, 358, 277, 260, 495, 192, 208]"
47,2,3225,6370,6125,0,2249,976,"[130, 157, 0, 3, 325, 124, 67, 325, 100, 46, 69, 12, 165, 286, 208, 10, 89, 282, 228, 288, 218, 50, 315, 79, 117, 181, 150, 56, 151]"
48,2,4251,1772,8604,0,1522,2729,"[486, 221, 0, 183, 909, 169, 224, 909, 848, 54, 154, 583, 221, 417, 354, 144, 145, 690, 890, 62, 568, 47, 479, 711, 206, 531, 413, 68, 866]"
49,2,4788,5941,7451,0,2060,2728,"[843, 263, 0, 303, 909, 195, 182, 909, 262, 185, 340, 15, 75, 98, 816, 883, 296, 826, 813, 826, 903, 713, 831, 875, 16, 45, 845, 717, 691]"
50,2,3897,5815,5533,0,2303,1594,"[46, 46, 0, 89, 531, 426, 132, 531, 172, 327, 511, 15, 392, 234, 128, 68, 213, 273, 142, 35, 59, 496, 122, 39, 317, 405, 241, 190, 421]"
51,2,3498,43,8988,0,3232,266,"[62, 8, 0, 36, 88, 30, 55, 88, 42, 13, 60, 25, 46, 67, 61, 39, 31, 71, 35, 42, 1, 55, 54, 40, 42, 19, 77, 81, 23]"
52,2,3419,6631,5776,0,2727,692,"[91, 59, 0, 74, 230, 11, 225, 230, 219, 63, 188, 120, 172, 29, 71, 100, 31, 29, 216, 81, 167, 92, 89, 171, 131, 153, 84, 39, 15]"
53,2,4703,2838,7641,0,120,4583,"[40, 795, 0, 586, 1527, 979, 199, 1527, 1337, 361, 1174, 1168, 1432, 259, 1348, 60, 487, 1139, 835, 49, 81, 635, 203, 1508, 894, 912, 661, 775, 955]"
54,2,3508,6648,4501,0,3291,217,"[31, 12, 0, 68, 72, 21, 55, 72, 23, 26, 27, 44, 11, 22, 58, 10, 25, 6, 48, 64, 48, 15, 46, 59, 18, 28, 66, 71, 24]"
55,2,4673,2788,6386,0,4537,136,"[44, 17, 0, 36, 45, 24, 35, 45, 26, 6, 42, 22, 12, 13, 44, 39, 27, 23, 14, 40, 45, 37, 36, 21, 39, 22, 26, 2, 39]"
56,2,4448,1619,9215,0,4,4444,"[895, 865, 0, 606, 1481, 1331, 284, 1481, 568, 911, 111, 294, 1263, 1203, 841, 1271, 547, 550, 547, 889, 151, 1243, 623, 586, 1116, 1458, 984, 372, 404]"
57,2,4687,6269,7633,0,1139,3548,"[828, 686, 0, 716, 1182, 828, 356, 1182, 964, 786, 183, 176, 1041, 661, 1178, 31, 1083, 346, 953, 1071, 430, 1152, 1137, 1109, 432, 894, 618, 333, 141]"
58,2,3100,1829,8904,0,3093,7,"[2, 1, 0, 2, 2, 2, 2, 2, 1, 0, 2, 1, 2, 0, 1, 1, 2, 2, 1, 0, 0, 1, 2, 1, 2, 0, 0, 2, 1]"
59,2,4009,5042,7871,0,2408,1601,"[67, 466, 0, 74, 533, 405, 178, 533, 218, 101, 30, 217, 112, 73, 240, 239, 499, 361, 373, 155, 231, 19, 452, 492, 447, 458, 2, 2, 185]"
60,2,4584,6446,6009,0,4098,486,"[105, 142, 0, 146, 162, 15, 109, 162, 111, 89, 161, 127, 110, 37, 64, 96, 138, 0, 140, 32, 139, 37, 151, 116, 44, 86, 115, 142, 96]"
61,2,3504,2764,6749,0,1722,1782,"[136, 191, 0, 299, 594, 403, 138, 594, 186, 32, 43, 386, 254, 281, 197, 556, 211, 184, 59, 25, 174, 137, 272, 439, 285, 339, 446, 243, 369]"
62,2,3307,2038,8018,0,3053,254,"[19, 18, 0, 30, 84, 58, 73, 84, 20, 10, 42, 61, 25, 58, 5, 81, 10, 70, 27, 57, 31, 65, 19, 70, 30, 52, 51, 52, 62]"
63,2,3556,5511,6063,0,2875,681,"[62, 177, 0, 106, 227, 208, 102, 227, 227, 21, 7, 56, 13, 98, 141, 13, 147, 93, 6, 89, 179, 42, 87, 68, 74, 217, 179, 123, 114]"
64,2,4846,1994,8915,0,2923,1923,"[259, 315, 0, 341, 641, 565, 60, 641, 145, 565, 234, 80, 218, 504, 169, 206, 5, 513, 93, 223, 59, 620, 397, 213, 98, 186, 228, 8, 550]"
65,2,3123,5365,6673,0,2579,544,"[135, 80, 0, 54, 181, 62, 28, 181, 123, 65, 167, 78, 100, 124, 175, 76, 169, 37, 27, 66, 152, 120, 168, 162, 163, 27, 46, 19, 153]"
66,2,3623,2330,7966,0,3201,422,"[38, 125, 0, 44, 140, 19, 112, 140, 68, 78, 11, 129, 66, 28, 139, 10, 62, 16, 92, 43, 36, 47, 128, 136, 126, 96, 116, 43, 53]"
67,2,4789,5928,6827,0,3924,865,"[218, 215, 0, 213, 288, 76, 179, 288, 131, 119, 160, 96, 274, 172, 162, 128, 279, 142, 18, 36, 93, 121, 69, 122, 95, 172, 226, 109, 15]"
68,2,4947,7359,4415,0,133,4814,"[735, 802, 0, 1486, 1604, 160, 1052, 1604, 529, 574, 1457, 11, 817, 456, 1064, 1532, 374, 875, 1546, 1244, 1068, 1303, 1239, 354, 289, 1183, 868, 1401, 841]"
69,2,3078,2275,5218,0,2024,1054,"[97, 53, 0, 314, 351, 274, 21, 351, 165, 278, 139, 128, 139, 57, 326, 310, 308, 62, 60, 139, 57, 261, 87, 6, 262, 159, 325, 13, 188]"
70,2,3439,2763,5894,0,2560,879,"[279, 107, 0, 60, 293, 243, 259, 293, 172, 247, 188, 77, 123, 290, 43, 122, 209, 44, 285, 177, 285, 16, 201, 42, 18, 235, 204, 93, 56]"
71,2,3537,1890,7541,0,3305,232,"[61, 66, 0, 44, 77, 33, 51, 77, 47, 53, 45, 72, 1, 57, 53, 36, 46, 57, 16, 62, 3, 52, 65, 72, 45, 57, 13, 33, 25]"
72,2,4487,5713,6315,0,3795,692,"[9, 189, 0, 19, 230, 68, 208, 230, 71, 14, 27, 25, 107, 185, 143, 90, 53, 214, 192, 46, 119, 135, 182, 139, 175, 99, 170, 34, 181]"
73,2,4653,3143,7825,0,1692,2961,"[870, 47, 0, 344, 987, 950, 326, 987, 584, 130, 87, 350, 703, 156, 739, 494, 702, 267, 891, 383, 192, 5, 942, 86, 4, 695, 174, 806, 244]"
74,2,3786,6814,4797,0,1052,2734,"[526, 845, 0, 136, 911, 738, 438, 911, 565, 745, 326, 99, 337, 161, 23, 21, 844, 503, 737, 220, 688, 319, 296, 120, 400, 367, 534, 495, 819]"
75,2,3545,2506,5836,0,2445,1100,"[247, 334, 0, 200, 366, 226, 184, 366, 207, 343, 302, 159, 16, 4, 136, 79, 30, 280, 31, 343, 6, 147, 306, 85, 265, 9, 30, 162, 68]"
76,2,4655,3865,6626,0,4480,175,"[39, 4, 0, 44, 58, 41, 24, 58, 49, 44, 36, 50, 5, 48, 18, 27, 13, 49, 6, 39, 13, 32, 55, 56, 26, 14, 43, 54, 54]"
77,2,4951,5813,5764,0,2415,2536,"[495, 103, 0, 776, 845, 11, 21, 845, 724, 95, 605, 89, 343, 535, 616, 257, 94, 346, 164, 145, 136, 62, 486, 109, 662, 763, 376, 229, 493]"
78,2,3712,1058,8418,0,1170,2542,"[585, 691, 0, 255, 847, 69, 418, 847, 784, 255, 626, 703, 784, 191, 384, 82, 10, 113, 100, 476, 262, 809, 456, 804, 328, 336, 7, 769, 286]"
79,2,3774,5560,6632,0,2739,1035,"[213, 313, 0, 269, 345, 80, 170, 345, 187, 289, 246, 45, 202, 169, 246, 289, 190, 240, 344, 112, 106, 311, 34, 330, 315, 231, 25, 53, 233]"
80,2,4509,6757,4384,0,3084,1425,"[463, 225, 0, 349, 475, 134, 395, 475, 439, 377, 282, 135, 376, 349, 48, 213, 249, 447, 242, 146, 236, 205, 175, 204, 169, 437, 262, 235, 376]"
81,2,4071,2996,5459,0,55,4016,"[238, 640, 0, 816, 1338, 1215, 1062, 1338, 651, 1098, 621, 145, 490, 1219, 694, 230, 21, 662, 308, 763, 738, 795, 1138, 814, 915, 937, 1251, 78, 580]"
82,2,4699,2119,8039,0,783,3916,"[346, 69, 0, 118, 1305, 986, 1035, 1305, 99, 1119, 25, 345, 336, 693, 1299, 431, 762, 416, 1221, 1249, 1124, 357, 1229, 1079, 416, 320, 160, 737, 930]"
83,2,4573,5765,6847,0,1976,2597,"[827, 435, 0, 631, 865, 594, 295, 865, 118, 165, 310, 243, 118, 827, 36, 500, 287, 785, 598, 594, 541, 111, 55, 600, 443, 764, 560, 852, 313]"
84,2,3331,2483,7695,0,2646,685,"[172, 202, 0, 67, 228, 111, 85, 228, 16, 146, 38, 179, 38, 25, 199, 197, 118, 220, 167, 166, 63, 68, 190, 179, 193, 211, 174, 120, 125]"
85,2,4121,6407,5409,0,676,3445,"[1046, 444, 0, 984, 1148, 306, 328, 1148, 606, 484, 564, 643, 912, 609, 205, 694, 57, 309, 588, 338, 649, 243, 822, 142, 160, 1106, 94, 617, 575]"
86,2,3647,1289,7767,0,3115,532,"[79, 38, 0, 116, 177, 88, 103, 177, 152, 30, 141, 157, 63, 38, 74, 130, 164, 40, 53, 129, 3, 167, 124, 166, 61, 130, 175, 144, 36]"
87,2,4551,5333,6985,0,1452,3099,"[450, 295, 0, 968, 1033, 177, 457, 1033, 328, 451, 177, 578, 231, 89, 192, 806, 215, 43, 824, 565, 820, 407, 256, 1020, 347, 712, 718, 511, 448]"
88,2,3115,2129,7971,0,698,2417,"[665, 282, 0, 195, 805, 389, 633, 805, 417, 15, 428, 348, 274, 324, 470, 154, 745, 60, 18, 372, 565, 109, 737, 141, 747, 143, 149, 226, 145]"
89,2,3035,6573,4433,0,3033,2,"[0, 0, 0, 0, 0, 0, 0, 0, 0, 0, 0, 0, 0, 0, 0, 0, 0, 0, 0, 0, 0, 0, 0, 0, 0, 0, 0, 0, 0]"
90,2,3055,2883,4605,0,629,2426,"[278, 472, 0, 317, 808, 369, 336, 808, 44, 194, 541, 143, 90, 479, 434, 47, 364, 518, 538, 429, 426, 493, 241, 779, 142, 435, 152, 214, 205]"
91,2,4455,1744,7316,0,839,3616,"[1082, 231, 0, 523, 1205, 1190, 492, 1205, 80, 1162, 1117, 805, 1050, 760, 612, 140, 615, 654, 1113, 250, 438, 1089, 439, 941, 610, 476, 102, 430, 292]"
92,2,4679,5852,6143,0,2688,1991,"[637, 448, 0, 44, 663, 559, 311, 663, 570, 623, 91, 31, 254, 604, 576, 592, 492, 561, 464, 67, 35, 4, 111, 553, 131, 637, 202, 327, 243]"
93,2,4113,1082,9174,0,930,3183,"[446, 190, 0, 165, 1061, 300, 623, 1061, 60, 822, 413, 601, 354, 915, 65, 955, 90, 389, 668, 601, 624, 736, 651, 864, 589, 473, 1028, 843, 42]"
94,2,4332,6615,6891,0,3772,560,"[53, 71, 0, 0, 186, 180, 79, 186, 100, 150, 86, 99, 101, 164, 74, 52, 0, 148, 40, 57, 36, 53, 29, 102, 1, 50, 99, 27, 173]"
95,2,4775,7149,4517,0,3843,932,"[35, 126, 0, 128, 310, 232, 216, 310, 307, 216, 86, 285, 79, 101, 253, 217, 262, 185, 137, 24, 57, 25, 304, 17, 217, 44, 211, 60, 53]"
96,2,3368,2814,5071,0,1392,1976,"[88, 106, 0, 285, 658, 306, 515, 658, 355, 658, 587, 368, 160, 134, 169, 37, 186, 392, 564, 572, 200, 429, 423, 437, 286, 647, 37, 635, 526]"
97,2,3093,1219,6945,0,2721,372,"[19, 53, 0, 118, 124, 91, 106, 124, 54, 78, 52, 60, 46, 84, 25, 43, 42, 7, 54, 113, 65, 74, 86, 118, 54, 46, 115, 14, 38]"
98,2,3959,1488,9416,0,3653,306,"[2, 54, 0, 56, 102, 40, 50, 102, 12, 4, 101, 82, 92, 4, 16, 88, 41, 76, 80, 7, 23, 92, 49, 2, 31, 3, 100, 1, 3]"
99,2,3141,7311,5246,0,1895,1246,"[48, 189, 0, 242, 415, 47, 136, 415, 218, 385, 76, 363, 36, 343, 365, 369, 47, 269, 43, 6, 263, 29, 401, 72, 33, 192, 403, 43, 255]"
100,2,4963,4626,5583,0,4621,342,"[102, 88, 0, 33, 114, 88, 90, 114, 15, 71, 21, 20, 98, 16, 11, 49, 59, 65, 14, 36, 53, 89, 0, 8, 91, 27, 103, 79, 54]"
101,2,4366,1856,8093,0,1296,3070,"[546, 587, 0, 724, 1023, 728, 476, 1023, 844, 816, 112, 713, 173, 690, 358, 682, 976, 895, 275, 950, 344, 352, 198, 0, 16, 342, 340, 351, 635]"
102,2,3475,5468,6100,0,359,3116,"[771, 989, 0, 48, 1038, 92, 70, 1038, 193, 641, 672, 501, 590, 397, 258, 467, 542, 613, 255, 594, 365, 400, 178, 818, 887, 187, 171, 707, 924]"
103,2,4109,3423,6786,0,1094,3015,"[377, 714, 0, 330, 1005, 689, 681, 1005, 548, 189, 303, 491, 697, 524, 373, 932, 24, 285, 786, 56, 292, 547, 315, 830, 987, 683, 311, 445, 640]"
104,2,3690,641,9835,0,1803,1887,"[536, 134, 0, 500, 629, 186, 336, 629, 517, 239, 414, 222, 144, 516, 197, 368, 349, 248, 207, 346, 554, 619, 252, 510, 398, 592, 387, 37, 148]"
105,2,4202,5638,8399,0,2233,1969,"[504, 463, 0, 208, 656, 57, 586, 656, 586, 16, 647, 310, 530, 294, 573, 259, 360, 591, 150, 51, 642, 556, 163, 534, 219, 285, 101, 342, 494]"
106,2,3612,6780,5231,0,141,3471,"[521, 762, 0, 434, 1157, 677, 443, 1157, 803, 1029, 715, 508, 99, 23, 128, 966, 950, 197, 913, 445, 693, 1156, 962, 895, 728, 978, 1087, 126, 703]"
107,2,4769,296,9704,0,2609,2160,"[429, 96, 0, 325, 720, 588, 627, 720, 505, 683, 542, 428, 128, 73, 593, 47, 462, 332, 228, 275, 424, 627, 267, 645, 351, 606, 390, 199, 120]"
108,2,4763,7263,7204,0,4072,691,"[121, 22, 0, 24, 230, 23, 175, 230, 131, 175, 58, 46, 56, 184, 32, 0, 122, 91, 37, 219, 62, 216, 128, 147, 48, 223, 95, 49, 64]"
109,2,4779,7215,4768,0,1260,3519,"[234, 516, 0, 78, 1173, 1164, 406, 1173, 3, 787, 492, 1043, 602, 996, 296, 282, 560, 288, 504, 687, 406, 1155, 66, 600, 213, 892, 271, 1115, 194]"
110,2,4062,1434,7396,0,3388,674,"[174, 30, 0, 190, 224, 93, 45, 224, 101, 47, 99, 134, 46, 161, 12, 176, 101, 136, 37, 160, 187, 100, 185, 40, 191, 197, 126, 187, 163]"
111,2,3529,2303,8622,0,1484,2045,"[8, 528, 0, 156, 681, 207, 440, 681, 592, 239, 206, 140, 129, 70, 348, 479, 350, 457, 231, 637, 143, 1, 66, 476, 498, 47, 532, 288, 250]"
112,2,4750,5717,7655,0,804,3946,"[1063, 327, 0, 349, 1315, 1300, 1170, 1315, 75, 121, 1313, 96, 1271, 60, 932, 186, 629, 527, 1077, 1269, 1056, 1283, 1176, 854, 694, 216, 90, 5, 442]"
113,2,4625,5999,6281,0,1019,3606,"[509, 918, 0, 433, 1202, 345, 735, 1202, 968, 195, 772, 91, 971, 1141, 540, 454, 899, 133, 959, 501, 869, 463, 174, 1150, 1108, 766, 1072, 1012, 36]"
114,2,3088,2955,6414,0,2804,284,"[62, 5, 0, 34, 94, 51, 84, 94, 25, 65, 67, 88, 7, 58, 0, 73, 14, 69, 59, 81, 66, 20, 45, 44, 17, 32, 36, 82, 66]"
115,2,3027,897,8544,0,306,2721,"[322, 485, 0, 773, 907, 607, 641, 907, 625, 724, 292, 349, 263, 280, 347, 114, 469, 40, 905, 653, 278, 91, 115, 590, 270, 62, 278, 242, 115]"
116,2,3938,5584,6898,0,473,3465,"[259, 305, 0, 199, 1155, 589, 748, 1155, 288, 215, 412, 475, 784, 794, 80, 406, 764, 591, 1146, 959, 984, 284, 470, 271, 560, 1039, 723, 699, 1088]"
117,2,3831,3067,7662,0,3430,401,"[126, 54, 0, 110, 133, 70, 35, 133, 87, 20, 29, 53, 82, 48, 118, 81, 3, 106, 96, 36, 101, 116, 33, 105, 44, 48, 54, 57, 128]"
118,2,3854,5281,6235,0,3174,680,"[7, 103, 0, 135, 226, 93, 14, 226, 112, 113, 194, 159, 77, 172, 111, 3, 9, 93, 31, 21, 207, 46, 217, 108, 193, 184, 69, 9, 72]"
119,2,4840,6111,4964,0,687,4153,"[9, 1139, 0, 755, 1384, 1352, 80, 1384, 217, 188, 821, 1361, 1153, 1030, 869, 72, 306, 54, 858, 1002, 790, 1368, 1051, 1142, 523, 638, 614, 1081, 1019]"
0,3,53,0,53,0,18,35,"[9, 8, 0, 0, 7, 7, 7, 7, 3, 5, 11, 7, 11, 6, 0, 9, 9, 9, 0, 6, 4, 10, 0, 7, 0, 9, 3, 11, 8]"
1,3,55,27,81,0,28,27,"[1, 8, 8, 0, 3, 6, 6, 3, 5, 7, 9, 6, 3, 0, 9, 2, 3, 8, 6, 0, 0, 6, 5, 4, 0, 0, 2, 9, 3]"
2,3,84,24,141,0,42,42,"[7, 12, 7, 0, 7, 2, 3, 5, 6, 12, 14, 10, 12, 14, 8, 11, 13, 13, 8, 1, 14, 7, 6, 4, 10, 12, 5, 14, 12]"
3,3,62,16,187,0,3,59,"[0, 2, 9, 0, 11, 18, 8, 11, 3, 6, 19, 2, 16, 14, 2, 0, 14, 4, 17, 0, 9, 12, 7, 9, 10, 16, 5, 19, 17]"
4,3,54,54,187,0,15,39,"[9, 3, 12, 0, 8, 4, 0, 5, 8, 2, 13, 2, 8, 13, 2, 11, 7, 4, 11, 3, 2, 5, 9, 5, 13, 10, 4, 13, 8]"
5,3,52,24,215,0,23,29,"[0, 5, 9, 0, 0, 8, 9, 7, 1, 5, 9, 6, 0, 4, 8, 8, 3, 7, 2, 3, 1, 8, 4, 2, 3, 8, 8, 9, 8]"
6,3,93,28,280,0,68,25,"[0, 2, 3, 0, 5, 8, 7, 5, 3, 3, 8, 0, 3, 8, 1, 6, 1, 1, 6, 6, 7, 3, 3, 3, 8, 5, 5, 8, 8]"
7,3,10,1,289,0,8,2,"[0, 0, 0, 0, 0, 0, 0, 0, 0, 0, 0, 0, 0, 0, 0, 0, 0, 0, 0, 0, 0, 0, 0, 0, 0, 0, 0, 0, 0]"
8,3,95,86,298,0,4,91,"[12, 3, 27, 0, 1, 26, 7, 27, 11, 19, 30, 17, 20, 28, 28, 28, 0, 0, 7, 0, 28, 17, 21, 20, 13, 6, 15, 30, 21]"
9,3,73,0,371,0,24,49,"[0, 10, 11, 0, 4, 13, 6, 6, 2, 8, 16, 3, 4, 1, 11, 13, 7, 6, 12, 9, 2, 4, 4, 6, 1, 10, 10, 16, 16]"
10,3,82,40,413,0,70,12,"[3, 0, 2, 0, 4, 1, 3, 2, 0, 3, 4, 0, 4, 2, 1, 4, 0, 3, 4, 1, 0, 4, 3, 1, 0, 1, 0, 4, 3]"
11,3,40,15,438,0,35,5,"[1, 0, 1, 0, 1, 0, 0, 1, 0, 0, 1, 0, 0, 0, 1, 1, 1, 1, 1, 1, 0, 1, 0, 1, 1, 1, 0, 1, 1]"
12,3,30,7,461,0,6,24,"[7, 4, 1, 0, 4, 3, 8, 2, 2, 5, 8, 8, 2, 5, 1, 2, 5, 3, 3, 4, 7, 3, 3, 7, 3, 7, 8, 8, 5]"
13,3,76,39,498,0,13,63,"[5, 6, 11, 0, 16, 6, 11, 10, 20, 20, 21, 21, 8, 21, 10, 0, 13, 16, 7, 8, 19, 20, 5, 0, 9, 2, 6, 21, 9]"
14,3,65,7,556,0,62,3,"[1, 0, 0, 0, 1, 1, 0, 0, 0, 1, 1, 0, 1, 1, 1, 1, 1, 0, 1, 0, 1, 1, 0, 1, 1, 1, 0, 1, 1]"
15,3,96,28,624,0,19,77,"[13, 4, 24, 0, 20, 13, 13, 19, 20, 24, 25, 7, 4, 15, 12, 13, 7, 2, 24, 17, 15, 11, 18, 23, 17, 23, 9, 25, 11]"
16,3,21,19,626,0,11,10,"[1, 2, 1, 0, 3, 3, 2, 3, 1, 1, 3, 3, 2, 3, 3, 0, 1, 0, 2, 2, 3, 3, 0, 2, 2, 3, 3, 3, 1]"
17,3,77,68,635,0,38,39,"[11, 10, 8, 0, 3, 11, 5, 3, 10, 12, 13, 8, 8, 10, 5, 3, 11, 7, 8, 10, 0, 7, 11, 12, 7, 5, 2, 13, 1]"
18,3,97,43,689,0,93,4,"[1, 0, 1, 0, 0, 1, 1, 1, 0, 0, 1, 0, 0, 1, 1, 0, 1, 0, 1, 0, 1, 1, 1, 1, 1, 1, 1, 1, 0]"
19,3,49,28,710,0,39,10,"[2, 1, 1, 0, 3, 1, 0, 0, 3, 1, 3, 3, 3, 0, 2, 2, 1, 1, 0, 0, 0, 1, 0, 0, 2, 1, 3, 3, 1]"
20,3,11,11,710,0,3,8,"[1, 2, 1, 0, 1, 2, 1, 0, 2, 1, 2, 1, 1, 0, 1, 0, 0, 0, 2, 0, 1, 2, 2, 2, 0, 2, 2, 2, 1]"
21,3,20,15,715,0,11,9,"[0, 2, 3, 0, 2, 3, 3, 0, 3, 1, 3, 1, 0, 1, 1, 1, 0, 0, 2, 3, 3, 1, 2, 1, 2, 0, 3, 3, 2]"
22,3,34,7,742,0,28,6,"[1, 2, 1, 0, 0, 2, 0, 2, 2, 2, 2, 1, 2, 2, 0, 1, 1, 1, 1, 1, 1, 2, 2, 2, 2, 2, 1, 2, 2]"
23,3,27,5,764,0,25,2,"[0, 0, 0, 0, 0, 0, 0, 0, 0, 0, 0, 0, 0, 0, 0, 0, 0, 0, 0, 0, 0, 0, 0, 0, 0, 0, 0, 0, 0]"
24,3,11,0,775,0,7,4,"[1, 1, 1, 0, 0, 1, 1, 0, 0, 1, 1, 0, 0, 1, 1, 1, 0, 1, 1, 0, 0, 1, 1, 1, 0, 0, 1, 1, 1]"
25,3,13,8,780,0,0,13,"[1, 2, 0, 0, 2, 1, 2, 0, 0, 0, 4, 4, 3, 4, 0, 4, 2, 3, 1, 1, 4, 1, 3, 3, 0, 0, 3, 4, 0]"
26,3,47,44,783,0,39,8,"[2, 1, 2, 0, 1, 2, 1, 2, 0, 0, 2, 1, 0, 0, 2, 0, 1, 2, 0, 1, 1, 0, 2, 2, 0, 2, 2, 2, 0]"
27,3,73,46,810,0,32,41,"[3, 5, 10, 0, 5, 4, 9, 12, 0, 8, 13, 4, 11, 1, 8, 12, 2, 7, 1, 2, 8, 8, 9, 11, 9, 0, 13, 13, 3]"
28,3,34,21,823,0,33,1,"[0, 0, 0, 0, 0, 0, 0, 0, 0, 0, 0, 0, 0, 0, 0, 0, 0, 0, 0, 0, 0, 0, 0, 0, 0, 0, 0, 0, 0]"
29,3,20,4,839,0,17,3,"[0, 1, 1, 0, 0, 1, 1, 1, 1, 1, 1, 0, 0, 1, 0, 1, 0, 1, 0, 1, 0, 1, 0, 0, 1, 0, 1, 1, 0]"
30,3,28,22,845,0,9,19,"[4, 2, 1, 0, 2, 6, 1, 2, 0, 5, 6, 1, 0, 3, 3, 5, 0, 6, 3, 5, 1, 1, 2, 5, 1, 3, 1, 6, 3]"
31,3,62,18,889,0,10,52,"[4, 4, 12, 0, 3, 1, 17, 1, 10, 14, 17, 4, 10, 2, 4, 10, 5, 15, 16, 15, 4, 5, 2, 4, 15, 7, 15, 17, 7]"
32,3,77,11,955,0,33,44,"[14, 6, 14, 0, 10, 11, 13, 11, 13, 2, 14, 4, 9, 1, 0, 10, 13, 4, 12, 9, 14, 11, 7, 4, 6, 13, 4, 14, 12]"
33,3,38,17,976,0,35,3,"[0, 1, 1, 0, 1, 0, 0, 0, 0, 0, 1, 0, 1, 0, 0, 0, 1, 1, 1, 0, 1, 1, 0, 0, 1, 0, 0, 1, 1]"
34,3,86,75,987,0,56,30,"[5, 8, 6, 0, 7, 7, 4, 5, 4, 7, 10, 6, 7, 0, 6, 5, 2, 0, 6, 7, 4, 2, 2, 10, 9, 4, 4, 10, 1]"
35,3,32,32,987,0,3,29,"[2, 9, 7, 0, 7, 2, 4, 1, 4, 8, 9, 1, 3, 9, 5, 8, 2, 7, 2, 5, 7, 9, 2, 7, 0, 3, 1, 9, 9]"
36,3,66,12,1041,0,25,41,"[7, 3, 2, 0, 11, 1, 0, 12, 2, 5, 13, 13, 7, 5, 5, 7, 12, 8, 7, 11, 4, 9, 2, 5, 8, 6, 5, 13, 1]"
37,3,40,28,1053,0,9,31,"[7, 10, 3, 0, 3, 7, 8, 2, 8, 6, 10, 10, 9, 8, 2, 7, 6, 6, 1, 6, 9, 6, 2, 10, 6, 2, 0, 10, 7]"
38,3,0,0,1053,0,0,0,"[0, 0, 0, 0, 0, 0, 0, 0, 0, 0, 0, 0, 0, 0, 0, 0, 0, 0, 0, 0, 0, 0, 0, 0, 0, 0, 0, 0, 0]"
39,3,57,7,1103,0,40,17,"[0, 1, 2, 0, 0, 3, 0, 2, 3, 1, 5, 3, 0, 0, 3, 3, 5, 3, 3, 0, 4, 1, 5, 0, 1, 3, 5, 5, 0]"
40,3,71,37,1137,0,68,3,"[0, 0, 0, 0, 0, 0, 0, 1, 0, 1, 1, 0, 1, 1, 0, 0, 1, 1, 0, 0, 0, 0, 1, 1, 0, 0, 1, 1, 1]"
41,3,11,4,1144,0,9,2,"[0, 0, 0, 0, 0, 0, 0, 0, 0, 0, 0, 0, 0, 0, 0, 0, 0, 0, 0, 0, 0, 0, 0, 0, 0, 0, 0, 0, 0]"
42,3,75,62,1157,0,67,8,"[2, 2, 0, 0, 2, 1, 0, 1, 1, 0, 2, 2, 1, 1, 0, 0, 2, 1, 1, 1, 1, 1, 2, 1, 0, 1, 1, 2, 2]"
43,3,43,37,1163,0,0,43,"[14, 1, 2, 0, 8, 14, 7, 1, 12, 8, 14, 14, 8, 11, 11, 0, 8, 13, 8, 3, 12, 2, 13, 0, 12, 9, 12, 14, 5]"
44,3,82,66,1179,0,13,69,"[19, 15, 8, 0, 23, 10, 23, 4, 11, 2, 23, 14, 18, 8, 12, 0, 9, 14, 21, 17, 0, 13, 18, 20, 3, 16, 6, 23, 10]"
45,3,61,58,1182,0,25,36,"[1, 5, 5, 0, 3, 8, 2, 0, 12, 9, 12, 3, 1, 7, 10, 10, 5, 1, 8, 10, 9, 8, 4, 7, 9, 6, 7, 12, 8]"
46,3,38,4,1216,0,3,35,"[2, 1, 9, 0, 10, 0, 0, 2, 10, 3, 11, 2, 0, 4, 8, 6, 10, 11, 11, 10, 5, 11, 0, 5, 8, 8, 5, 11, 2]"
47,3,56,1,1271,0,30,26,"[8, 6, 5, 0, 0, 5, 6, 7, 5, 8, 8, 0, 8, 0, 4, 2, 8, 0, 3, 2, 7, 2, 4, 0, 8, 6, 0, 8, 8]"
48,3,73,7,1337,0,71,2,"[0, 0, 0, 0, 0, 0, 0, 0, 0, 0, 0, 0, 0, 0, 0, 0, 0, 0, 0, 0, 0, 0, 0, 0, 0, 0, 0, 0, 0]"
49,3,21,0,1358,0,18,3,"[0, 0, 0, 0, 1, 0, 1, 0, 1, 1, 1, 1, 1, 1, 1, 0, 0, 0, 0, 1, 1, 0, 1, 0, 0, 1, 1, 1, 1]"
50,3,1,0,1338,0,0,1,"[0, 0, 0, 0, 0, 0, 0, 0, 0, 0, 0, 0, 0, 0, 0, 0, 0, 0, 0, 0, 0, 0, 0, 0, 0, 0, 0, 0, 0]"
51,3,61,4,1395,0,53,8,"[1, 1, 2, 0, 0, 1, 0, 0, 2, 0, 2, 2, 2, 0, 2, 2, 1, 1, 1, 1, 2, 2, 2, 1, 2, 2, 0, 2, 2]"
52,3,13,11,1397,0,7,6,"[1, 1, 2, 0, 2, 2, 2, 2, 2, 0, 2, 2, 2, 1, 1, 2, 1, 0, 1, 2, 1, 2, 0, 2, 1, 2, 1, 2, 1]"
53,3,96,90,1403,0,59,37,"[5, 2, 7, 0, 9, 3, 12, 0, 2, 10, 12, 11, 6, 11, 11, 10, 12, 6, 11, 6, 4, 6, 2, 11, 6, 3, 8, 12, 5]"
54,3,8,2,1409,0,5,3,"[1, 0, 1, 0, 1, 0, 0, 1, 1, 0, 1, 1, 0, 1, 1, 1, 0, 0, 1, 0, 0, 1, 0, 0, 1, 0, 0, 1, 1]"
55,3,8,1,1416,0,5,3,"[1, 1, 0, 0, 1, 0, 1, 0, 1, 1, 1, 1, 0, 1, 1, 1, 0, 1, 0, 1, 1, 1, 0, 0, 0, 1, 0, 1, 0]"
56,3,91,82,1425,0,41,50,"[13, 4, 7, 0, 6, 12, 13, 16, 0, 1, 16, 15, 14, 13, 16, 12, 6, 2, 4, 6, 4, 6, 1, 2, 0, 16, 6, 16, 9]"
57,3,64,3,1486,0,53,11,"[2, 1, 1, 0, 2, 2, 3, 3, 0, 0, 3, 3, 3, 1, 3, 0, 0, 3, 1, 3, 2, 3, 3, 2, 3, 1, 3, 3, 0]"
58,3,80,54,1512,0,56,24,"[1, 0, 5, 0, 0, 2, 6, 7, 3, 8, 8, 7, 7, 5, 3, 8, 2, 2, 2, 7, 8, 4, 0, 5, 8, 7, 5, 8, 6]"
59,3,49,47,1514,0,27,22,"[4, 4, 7, 0, 6, 2, 2, 0, 3, 7, 7, 3, 7, 5, 4, 4, 2, 6, 6, 7, 1, 7, 7, 6, 0, 7, 2, 7, 0]"
60,3,32,8,1538,0,28,4,"[1, 1, 0, 0, 1, 0, 1, 0, 1, 1, 1, 1, 1, 1, 1, 1, 1, 0, 1, 0, 0, 0, 0, 1, 0, 1, 0, 1, 0]"
61,3,1,0,1515,0,0,1,"[0, 0, 0, 0, 0, 0, 0, 0, 0, 0, 0, 0, 0, 0, 0, 0, 0, 0, 0, 0, 0, 0, 0, 0, 0, 0, 0, 0, 0]"
62,3,34,23,1526,0,30,4,"[0, 0, 0, 0, 0, 1, 1, 1, 0, 0, 1, 1, 1, 0, 1, 1, 0, 0, 0, 0, 0, 1, 1, 1, 1, 1, 0, 1, 0]"
63,3,46,32,1540,0,39,7,"[0, 0, 0, 0, 0, 1, 1, 1, 2, 2, 2, 1, 1, 1, 2, 1, 0, 1, 2, 2, 1, 1, 0, 1, 0, 0, 0, 2, 0]"
64,3,36,33,1543,0,23,13,"[4, 1, 2, 0, 0, 4, 4, 1, 2, 4, 4, 0, 4, 3, 0, 2, 0, 3, 2, 4, 1, 4, 2, 2, 1, 2, 2, 4, 3]"
65,3,23,2,1564,0,2,21,"[2, 0, 5, 0, 6, 5, 0, 4, 5, 5, 7, 7, 6, 3, 1, 5, 0, 2, 2, 4, 1, 6, 1, 5, 2, 7, 5, 7, 1]"
66,3,2,0,1566,0,2,0,"[0, 0, 0, 0, 0, 0, 0, 0, 0, 0, 0, 0, 0, 0, 0, 0, 0, 0, 0, 0, 0, 0, 0, 0, 0, 0, 0, 0, 0]"
67,3,21,9,1578,0,20,1,"[0, 0, 0, 0, 0, 0, 0, 0, 0, 0, 0, 0, 0, 0, 0, 0, 0, 0, 0, 0, 0, 0, 0, 0, 0, 0, 0, 0, 0]"
68,3,96,9,1665,0,78,18,"[2, 5, 1, 0, 0, 5, 4, 6, 2, 4, 6, 2, 5, 3, 6, 4, 0, 5, 6, 2, 1, 1, 2, 3, 2, 6, 3, 6, 2]"
69,3,58,54,1669,0,20,38,"[5, 2, 8, 0, 0, 6, 9, 11, 11, 6, 12, 4, 7, 9, 5, 1, 11, 7, 7, 4, 7, 8, 10, 3, 8, 8, 0, 12, 12]"
70,3,45,29,1685,0,32,13,"[4, 0, 4, 0, 1, 0, 0, 0, 3, 2, 4, 2, 2, 1, 3, 1, 3, 2, 1, 1, 3, 1, 0, 0, 1, 2, 3, 4, 0]"
71,3,86,84,1687,0,21,65,"[4, 12, 9, 0, 9, 19, 9, 4, 18, 18, 21, 21, 13, 17, 19, 21, 6, 6, 12, 13, 9, 10, 16, 9, 13, 2, 4, 21, 2]"
72,3,43,18,1712,0,25,18,"[3, 5, 4, 0, 3, 2, 4, 5, 3, 3, 6, 1, 1, 4, 5, 1, 4, 5, 6, 1, 0, 0, 2, 6, 6, 3, 6, 6, 5]"
73,3,52,7,1757,0,47,5,"[0, 0, 1, 0, 0, 1, 0, 0, 1, 1, 1, 0, 1, 0, 1, 0, 1, 1, 0, 1, 1, 0, 1, 1, 1, 0, 0, 1, 1]"
74,3,82,21,1818,0,37,45,"[14, 9, 1, 0, 10, 12, 11, 3, 6, 4, 15, 3, 3, 2, 14, 7, 2, 2, 11, 1, 2, 1, 8, 7, 0, 6, 4, 15, 3]"
75,3,89,29,1878,0,67,22,"[0, 7, 5, 0, 1, 7, 7, 5, 2, 0, 7, 6, 3, 2, 4, 2, 6, 2, 1, 4, 4, 2, 2, 6, 6, 0, 0, 7, 3]"
76,3,41,25,1894,0,14,27,"[8, 7, 5, 0, 2, 7, 2, 6, 2, 5, 9, 2, 9, 6, 0, 1, 6, 7, 1, 5, 9, 1, 8, 1, 3, 5, 4, 9, 1]"
77,3,40,3,1931,0,21,19,"[1, 0, 4, 0, 1, 2, 6, 2, 3, 1, 6, 2, 1, 6, 1, 6, 3, 5, 2, 0, 3, 3, 1, 3, 5, 3, 0, 6, 0]"
78,3,30,22,1939,0,2,28,"[6, 2, 9, 0, 1, 4, 8, 9, 4, 8, 9, 1, 8, 9, 7, 9, 1, 1, 1, 4, 5, 4, 2, 3, 8, 7, 7, 9, 1]"
79,3,21,0,1960,0,4,17,"[3, 5, 0, 0, 3, 3, 2, 4, 1, 1, 5, 2, 5, 5, 0, 5, 5, 4, 4, 1, 2, 0, 4, 1, 3, 4, 2, 5, 1]"
80,3,47,29,1978,0,20,27,"[5, 1, 6, 0, 0, 8, 8, 1, 1, 9, 9, 4, 2, 5, 5, 4, 8, 2, 7, 8, 7, 5, 3, 7, 5, 7, 6, 9, 7]"
81,3,64,57,1985,0,6,58,"[12, 4, 10, 0, 0, 6, 10, 19, 17, 3, 19, 5, 17, 6, 6, 16, 8, 13, 10, 13, 1, 6, 9, 17, 16, 9, 16, 19, 8]"
82,3,84,59,2010,0,13,71,"[13, 2, 2, 0, 5, 6, 16, 2, 9, 23, 23, 2, 17, 0, 8, 21, 20, 3, 11, 11, 14, 2, 5, 11, 17, 16, 7, 23, 22]"
83,3,38,23,2025,0,24,14,"[0, 1, 0, 0, 2, 2, 2, 2, 4, 3, 4, 3, 4, 1, 2, 1, 2, 4, 2, 2, 1, 4, 1, 2, 1, 3, 3, 4, 2]"
84,3,59,57,2027,0,18,41,"[1, 13, 8, 0, 10, 13, 6, 0, 4, 3, 13, 9, 3, 5, 1, 6, 4, 3, 11, 0, 2, 4, 6, 12, 1, 1, 5, 13, 6]"
85,3,38,33,2032,0,35,3,"[1, 0, 1, 0, 0, 1, 0, 0, 1, 0, 1, 0, 0, 0, 1, 0, 1, 0, 0, 0, 0, 0, 0, 1, 1, 0, 0, 1, 1]"
86,3,65,37,2060,0,2,63,"[18, 10, 19, 0, 13, 1, 17, 10, 21, 11, 21, 6, 4, 18, 7, 8, 18, 20, 4, 6, 0, 3, 8, 4, 21, 10, 6, 21, 1]"
87,3,83,76,2067,0,33,50,"[9, 7, 12, 0, 4, 2, 10, 2, 7, 7, 16, 14, 16, 12, 9, 7, 15, 3, 15, 7, 11, 10, 4, 13, 11, 11, 11, 16, 15]"
88,3,89,85,2071,0,48,41,"[8, 9, 1, 0, 0, 11, 11, 10, 6, 11, 13, 6, 1, 10, 5, 10, 5, 11, 1, 2, 11, 0, 8, 5, 4, 6, 4, 13, 3]"
89,3,51,31,2091,0,29,22,"[3, 2, 7, 0, 4, 5, 2, 5, 4, 1, 7, 7, 3, 2, 0, 7, 7, 3, 6, 4, 0, 2, 1, 5, 6, 7, 3, 7, 2]"
90,3,42,10,2123,0,6,36,"[11, 8, 4, 0, 9, 11, 9, 11, 8, 2, 12, 1, 2, 1, 3, 5, 2, 3, 4, 9, 6, 4, 2, 2, 0, 4, 6, 12, 4]"
91,3,27,20,2130,0,25,2,"[0, 0, 0, 0, 0, 0, 0, 0, 0, 0, 0, 0, 0, 0, 0, 0, 0, 0, 0, 0, 0, 0, 0, 0, 0, 0, 0, 0, 0]"
92,3,83,65,2148,0,39,44,"[6, 8, 11, 0, 12, 1, 7, 12, 1, 9, 14, 10, 10, 5, 14, 3, 11, 7, 1, 7, 5, 14, 1, 3, 0, 6, 4, 14, 0]"
93,3,97,85,2160,0,86,11,"[2, 3, 3, 0, 2, 3, 3, 2, 3, 2, 3, 2, 1, 3, 0, 1, 0, 1, 1, 2, 0, 2, 2, 2, 2, 2, 1, 3, 0]"
94,3,8,5,2163,0,4,4,"[1, 0, 1, 0, 0, 0, 0, 0, 0, 0, 1, 1, 0, 0, 0, 0, 1, 0, 0, 0, 0, 0, 1, 0, 0, 1, 1, 1, 1]"
95,3,52,7,2208,0,43,9,"[1, 0, 3, 0, 0, 0, 3, 3, 1, 2, 3, 2, 0, 0, 2, 3, 1, 2, 0, 0, 3, 3, 0, 2, 3, 3, 1, 3, 0]"
96,3,78,69,2217,0,29,49,"[13, 11, 15, 0, 2, 2, 10, 5, 9, 16, 16, 13, 10, 8, 15, 15, 10, 1, 8, 9, 5, 9, 9, 13, 14, 1, 11, 16, 8]"
97,3,42,25,2234,0,15,27,"[1, 0, 9, 0, 4, 1, 0, 8, 6, 1, 9, 0, 3, 4, 5, 7, 9, 4, 5, 5, 1, 1, 2, 0, 1, 2, 6, 9, 9]"
98,3,16,11,2239,0,14,2,"[0, 0, 0, 0, 0, 0, 0, 0, 0, 0, 0, 0, 0, 0, 0, 0, 0, 0, 0, 0, 0, 0, 0, 0, 0, 0, 0, 0, 0]"
99,3,38,11,2266,0,15,23,"[3, 1, 2, 0, 5, 7, 6, 0, 6, 7, 7, 6, 5, 4, 4, 4, 2, 0, 0, 3, 6, 6, 0, 7, 0, 5, 6, 7, 0]"
100,3,74,64,2276,0,33,41,"[0, 2, 9, 0, 10, 1, 7, 9, 8, 8, 13, 7, 1, 12, 10, 11, 8, 12, 5, 8, 10, 3, 0, 4, 0, 13, 5, 13, 12]"
101,3,64,25,2315,0,47,17,"[3, 2, 0, 0, 5, 2, 5, 0, 0, 1, 5, 2, 3, 2, 4, 4, 3, 0, 2, 3, 0, 4, 1, 2, 3, 5, 1, 5, 4]"
102,3,1,0,2277,0,0,1,"[0, 0, 0, 0, 0, 0, 0, 0, 0, 0, 0, 0, 0, 0, 0, 0, 0, 0, 0, 0, 0, 0, 0, 0, 0, 0, 0, 0, 0]"
103,3,10,10,2277,0,5,5,"[0, 0, 0, 0, 1, 1, 1, 1, 0, 1, 1, 0, 0, 1, 1, 1, 0, 0, 1, 1, 1, 1, 0, 0, 0, 1, 0, 1, 0]"
104,3,43,40,2280,0,4,39,"[0, 1, 13, 0, 1, 11, 7, 12, 1, 12, 13, 12, 6, 7, 5, 9, 3, 13, 7, 6, 10, 1, 11, 9, 7, 1, 0, 13, 7]"
105,3,23,9,2294,0,8,15,"[2, 1, 4, 0, 0, 1, 4, 5, 4, 0, 5, 4, 0, 0, 2, 4, 4, 4, 5, 4, 2, 4, 4, 4, 3, 4, 0, 5, 4]"
106,3,3,2,2295,0,3,0,"[0, 0, 0, 0, 0, 0, 0, 0, 0, 0, 0, 0, 0, 0, 0, 0, 0, 0, 0, 0, 0, 0, 0, 0, 0, 0, 0, 0, 0]"
107,3,33,9,2319,0,18,15,"[3, 5, 0, 0, 0, 1, 2, 1, 5, 4, 5, 2, 0, 4, 4, 2, 0, 1, 1, 4, 2, 5, 2, 0, 5, 4, 4, 5, 2]"
108,3,20,14,2325,0,18,2,"[0, 0, 0, 0, 0, 0, 0, 0, 0, 0, 0, 0, 0, 0, 0, 0, 0, 0, 0, 0, 0, 0, 0, 0, 0, 0, 0, 0, 0]"
109,3,35,27,2333,0,27,8,"[2, 1, 1, 0, 1, 0, 0, 0, 2, 1, 2, 0, 2, 0, 0, 0, 2, 0, 1, 0, 1, 2, 0, 1, 0, 2, 0, 2, 0]"
110,3,62,58,2337,0,52,10,"[1, 1, 3, 0, 0, 2, 0, 1, 2, 1, 3, 0, 2, 2, 0, 0, 2, 2, 0, 0, 3, 0, 3, 0, 0, 3, 0, 3, 1]"
111,3,95,53,2379,0,43,52,"[7, 3, 11, 0, 1, 4, 3, 11, 7, 0, 17, 12, 10, 12, 3, 12, 4, 4, 4, 17, 8, 7, 16, 13, 7, 14, 9, 17, 1]"
112,3,23,7,2395,0,9,14,"[2, 2, 1, 0, 0, 0, 4, 3, 1, 0, 4, 3, 4, 4, 3, 0, 0, 2, 4, 3, 1, 2, 4, 2, 1, 1, 1, 4, 0]"
113,3,83,58,2420,0,17,66,"[14, 1, 17, 0, 8, 2, 22, 17, 0, 13, 22, 0, 6, 4, 22, 16, 22, 10, 14, 4, 11, 18, 4, 2, 8, 13, 5, 22, 21]"
114,3,86,47,2459,0,82,4,"[1, 1, 1, 0, 0, 0, 1, 0, 0, 1, 1, 0, 1, 0, 1, 1, 0, 1, 1, 0, 0, 0, 0, 0, 0, 1, 1, 1, 0]"
115,3,62,0,2521,0,60,2,"[0, 0, 0, 0, 0, 0, 0, 0, 0, 0, 0, 0, 0, 0, 0, 0, 0, 0, 0, 0, 0, 0, 0, 0, 0, 0, 0, 0, 0]"
116,3,58,20,2559,0,14,44,"[2, 10, 7, 0, 11, 7, 10, 7, 4, 0, 14, 3, 7, 0, 5, 8, 7, 8, 4, 5, 7, 13, 5, 12, 3, 2, 11, 14, 12]"
117,3,70,43,2586,0,48,22,"[4, 4, 5, 0, 4, 4, 1, 1, 0, 4, 7, 2, 2, 0, 1, 5, 5, 2, 4, 0, 1, 3, 0, 7, 1, 7, 3, 7, 0]"
118,3,19,13,2592,0,16,3,"[0, 1, 0, 0, 1, 0, 1, 0, 0, 1, 1, 0, 0, 0, 0, 0, 0, 0, 1, 0, 0, 1, 0, 1, 0, 1, 1, 1, 1]"
119,3,23,8,2607,0,13,10,"[0, 0, 0, 0, 3, 1, 3, 2, 3, 3, 3, 1, 2, 3, 1, 2, 2, 2, 0, 0, 3, 2, 2, 0, 2, 1, 1, 3, 1]"
0,4,3870,0,3870,0,3043,827,"[224, 253, 275, 63, 0, 163, 87, 275, 57, 79, 32, 171, 25, 45, 168, 30, 31, 177, 27, 129, 2, 100, 39, 59, 98, 121, 221, 195, 134]"
1,4,4130,328,7672,0,3367,763,"[186, 158, 254, 27, 0, 232, 195, 254, 149, 110, 144, 135, 240, 248, 19, 6, 221, 14, 95, 35, 6, 152, 247, 32, 148, 62, 202, 63, 244]"
2,4,4959,5126,7505,0,173,4786,"[433, 753, 1595, 766, 0, 729, 625, 1595, 1399, 893, 960, 1393, 1225, 935, 1563, 102, 82, 650, 1520, 1469, 115, 90, 1468, 69, 1339, 511, 995, 1122, 149]"
3,4,4855,7145,5215,0,4263,592,"[4, 167, 197, 153, 0, 62, 19, 197, 133, 54, 40, 106, 6, 53, 173, 27, 194, 32, 137, 8, 71, 26, 114, 114, 150, 61, 93, 96, 117]"
4,4,3822,3725,5312,0,1455,2367,"[3, 542, 789, 101, 0, 85, 469, 789, 211, 748, 27, 214, 82, 157, 704, 657, 424, 309, 185, 326, 656, 194, 280, 365, 323, 593, 673, 65, 589]"
5,4,4084,67,9329,0,1644,2440,"[405, 634, 813, 189, 0, 742, 520, 813, 9, 573, 320, 78, 790, 1, 700, 93, 757, 758, 630, 307, 165, 304, 137, 295, 651, 664, 230, 506, 695]"
6,4,3874,5340,7863,0,2313,1561,"[493, 172, 520, 486, 0, 467, 433, 520, 376, 293, 63, 276, 502, 267, 115, 52, 336, 82, 110, 128, 80, 51, 358, 51, 405, 118, 412, 379, 343]"
7,4,4540,5322,7081,0,3834,706,"[62, 182, 235, 225, 0, 185, 88, 235, 32, 137, 40, 186, 89, 98, 126, 73, 41, 50, 6, 13, 80, 119, 159, 145, 40, 12, 51, 109, 217]"
8,4,4266,5685,5662,0,3583,683,"[71, 52, 227, 91, 0, 16, 150, 227, 115, 23, 11, 126, 98, 127, 95, 166, 67, 120, 159, 166, 129, 26, 38, 170, 127, 188, 214, 174, 178]"
9,4,4262,3272,6652,0,141,4121,"[571, 1323, 1373, 427, 0, 1348, 437, 1373, 451, 1273, 731, 484, 33, 363, 679, 1285, 1138, 1059, 739, 919, 262, 1231, 84, 140, 512, 875, 576, 1058, 141]"
10,4,3553,118,10000,87,2893,660,"[131, 70, 220, 4, 0, 26, 177, 220, 75, 23, 189, 73, 210, 183, 170, 33, 149, 71, 75, 218, 1, 56, 180, 193, 38, 153, 58, 38, 210]"
11,4,3447,5659,7788,0,1437,2010,"[187, 446, 670, 54, 0, 611, 280, 670, 328, 26, 249, 456, 430, 427, 465, 509, 484, 220, 231, 319, 617, 11, 363, 311, 524, 84, 610, 655, 574]"
12,4,4008,6119,5677,0,1244,2764,"[49, 6, 921, 194, 0, 133, 368, 921, 466, 716, 607, 52, 518, 773, 837, 328, 87, 183, 643, 419, 812, 161, 253, 259, 1, 571, 646, 685, 696]"
13,4,4067,3703,6041,0,2747,1320,"[234, 329, 440, 330, 0, 259, 413, 440, 310, 115, 132, 65, 70, 309, 277, 339, 371, 384, 279, 203, 100, 369, 11, 392, 336, 384, 59, 14, 9]"
14,4,3769,272,9538,0,1760,2009,"[406, 278, 669, 76, 0, 90, 101, 669, 381, 521, 172, 339, 657, 600, 137, 347, 262, 379, 175, 526, 298, 173, 615, 602, 337, 535, 473, 89, 634]"
15,4,3556,7448,5646,0,1735,1821,"[352, 481, 607, 330, 0, 527, 275, 607, 581, 203, 206, 211, 23, 34, 346, 382, 504, 579, 251, 219, 137, 188, 47, 461, 103, 182, 301, 388, 388]"
16,4,3269,748,8167,0,2527,742,"[239, 59, 247, 206, 0, 131, 157, 247, 238, 153, 69, 44, 24, 137, 9, 21, 33, 172, 207, 53, 47, 70, 54, 54, 234, 222, 117, 188, 155]"
17,4,3355,6019,5503,0,3008,347,"[114, 31, 115, 58, 0, 74, 61, 115, 13, 87, 92, 59, 72, 36, 58, 112, 11, 47, 56, 98, 103, 65, 3, 19, 43, 60, 87, 11, 31]"
18,4,4448,1705,8246,0,1678,2770,"[423, 628, 923, 859, 0, 278, 630, 923, 731, 68, 899, 817, 907, 445, 282, 778, 5, 785, 553, 651, 883, 493, 40, 221, 555, 486, 367, 337, 140]"
19,4,3281,7316,4211,0,3188,93,"[22, 15, 31, 25, 0, 13, 11, 31, 26, 29, 1, 23, 17, 11, 11, 1, 18, 1, 17, 6, 31, 7, 23, 23, 11, 30, 5, 4, 2]"
20,4,4470,1606,7075,0,3814,656,"[194, 35, 218, 201, 0, 166, 208, 218, 96, 180, 92, 175, 155, 214, 128, 163, 165, 100, 156, 203, 39, 213, 169, 114, 101, 193, 218, 50, 147]"
21,4,3602,2700,7977,0,993,2609,"[645, 584, 869, 334, 0, 215, 39, 869, 472, 799, 629, 435, 186, 293, 62, 733, 817, 514, 839, 417, 378, 430, 699, 519, 76, 447, 15, 816, 352]"
22,4,3151,5165,5963,0,872,2279,"[1, 443, 759, 148, 0, 442, 276, 759, 500, 110, 20, 321, 378, 94, 500, 393, 171, 43, 379, 89, 687, 496, 76, 621, 373, 427, 134, 492, 16]"
23,4,3651,2428,7186,0,619,3032,"[884, 110, 1010, 914, 0, 927, 137, 1010, 903, 522, 282, 16, 474, 542, 733, 666, 886, 616, 663, 1008, 3, 373, 98, 219, 699, 116, 252, 998, 928]"
24,4,3374,165,10000,395,1904,1470,"[468, 436, 490, 444, 0, 381, 301, 490, 138, 31, 190, 340, 85, 488, 168, 185, 71, 456, 259, 291, 188, 378, 156, 412, 241, 196, 58, 385, 384]"
25,4,3828,5108,8720,0,2747,1081,"[345, 91, 360, 242, 0, 166, 113, 360, 59, 108, 273, 160, 100, 74, 145, 111, 310, 160, 315, 136, 202, 130, 94, 206, 2, 299, 239, 227, 221]"
26,4,4843,6323,7240,0,4312,531,"[168, 69, 177, 73, 0, 43, 44, 177, 74, 173, 140, 138, 101, 24, 170, 38, 35, 22, 135, 147, 83, 87, 148, 21, 141, 127, 31, 161, 12]"
27,4,4428,7125,4543,0,638,3790,"[587, 802, 1263, 657, 0, 80, 1069, 1263, 336, 879, 13, 928, 145, 687, 517, 520, 534, 124, 1183, 421, 968, 460, 936, 14, 950, 297, 447, 304, 617]"
28,4,3660,2442,5761,0,1216,2444,"[102, 811, 814, 761, 0, 117, 699, 814, 681, 39, 777, 530, 24, 280, 715, 598, 410, 228, 58, 364, 582, 656, 474, 397, 767, 679, 32, 650, 482]"
29,4,4368,3102,7027,0,2119,2249,"[98, 42, 749, 564, 0, 446, 165, 749, 713, 414, 568, 555, 189, 156, 592, 17, 481, 47, 417, 592, 101, 237, 33, 203, 656, 184, 57, 556, 96]"
30,4,4949,5528,6448,0,3307,1642,"[36, 34, 547, 332, 0, 52, 275, 547, 220, 301, 200, 500, 32, 427, 520, 290, 38, 39, 279, 250, 493, 252, 485, 36, 346, 147, 520, 250, 220]"
31,4,4325,1303,9470,0,1731,2594,"[642, 179, 864, 294, 0, 697, 273, 864, 247, 710, 387, 328, 154, 236, 746, 296, 149, 461, 114, 393, 506, 694, 55, 511, 694, 587, 344, 551, 98]"
32,4,4497,7280,6687,0,1091,3406,"[228, 516, 1135, 90, 0, 171, 322, 1135, 653, 1131, 57, 461, 35, 444, 368, 667, 87, 334, 547, 970, 154, 520, 193, 556, 984, 122, 483, 595, 1012]"
33,4,3748,2347,8088,0,3135,613,"[99, 142, 204, 177, 0, 58, 4, 204, 104, 22, 107, 165, 39, 112, 98, 37, 18, 35, 168, 161, 57, 151, 24, 113, 142, 94, 200, 139, 142]"
34,4,4398,6404,6082,0,2799,1599,"[213, 386, 533, 127, 0, 48, 319, 533, 220, 17, 170, 259, 376, 247, 207, 44, 168, 10, 196, 488, 196, 287, 112, 194, 329, 103, 196, 35, 374]"
35,4,4720,2975,7827,0,4183,537,"[5, 164, 179, 96, 0, 93, 74, 179, 77, 81, 134, 95, 2, 74, 54, 73, 34, 92, 15, 150, 8, 0, 14, 32, 46, 165, 109, 134, 15]"
36,4,4237,7343,4721,0,308,3929,"[803, 959, 1309, 1205, 0, 736, 962, 1309, 827, 1135, 1033, 1276, 459, 180, 386, 478, 531, 747, 1114, 372, 158, 1106, 223, 1256, 893, 400, 1298, 670, 607]"
37,4,3790,2202,6309,0,970,2820,"[230, 36, 940, 238, 0, 358, 219, 940, 721, 698, 827, 201, 240, 553, 180, 121, 175, 280, 126, 805, 240, 829, 572, 571, 302, 566, 432, 424, 424]"
38,4,3566,1925,7950,0,66,3500,"[1111, 1106, 1166, 1000, 0, 196, 163, 1166, 289, 752, 516, 625, 93, 101, 532, 305, 230, 968, 1020, 629, 905, 30, 1109, 221, 344, 426, 21, 718, 507]"
39,4,4067,5813,6204,0,1517,2550,"[165, 679, 850, 370, 0, 715, 254, 850, 470, 67, 170, 764, 496, 645, 224, 683, 376, 509, 540, 645, 678, 459, 297, 354, 618, 759, 658, 680, 604]"
40,4,4861,7277,3788,0,918,3943,"[205, 151, 1314, 706, 0, 1220, 1294, 1314, 67, 862, 577, 706, 2, 630, 1159, 597, 1094, 507, 567, 913, 1112, 726, 472, 51, 88, 1271, 963, 447, 1071]"
41,4,3020,198,6610,0,622,2398,"[788, 434, 799, 792, 0, 76, 523, 799, 123, 94, 74, 22, 334, 166, 701, 287, 720, 591, 370, 51, 203, 395, 521, 799, 668, 336, 585, 233, 563]"
42,4,4708,5297,6021,0,953,3755,"[1107, 1049, 1251, 202, 0, 933, 383, 1251, 431, 542, 636, 665, 913, 841, 20, 597, 273, 1057, 888, 367, 287, 196, 603, 569, 1041, 1096, 383, 1031, 1133]"
43,4,3256,2710,6567,0,2766,490,"[97, 60, 163, 158, 0, 31, 43, 163, 71, 126, 53, 158, 63, 38, 49, 32, 14, 94, 101, 151, 69, 8, 151, 112, 34, 59, 29, 55, 72]"
44,4,3285,809,9043,0,130,3155,"[665, 706, 1051, 20, 0, 688, 834, 1051, 403, 150, 607, 661, 1008, 806, 729, 851, 998, 935, 954, 390, 847, 562, 698, 656, 282, 815, 42, 179, 470]"
45,4,3193,7358,4878,0,2820,373,"[57, 43, 124, 52, 0, 124, 120, 124, 64, 22, 52, 61, 63, 29, 75, 9, 106, 5, 30, 68, 117, 18, 79, 40, 99, 39, 74, 36, 60]"
46,4,4102,1978,7002,0,3579,523,"[101, 127, 174, 76, 0, 14, 15, 174, 31, 48, 157, 73, 11, 103, 135, 79, 2, 101, 12, 117, 95, 97, 116, 48, 87, 143, 64, 153, 50]"
47,4,4076,5226,5852,0,677,3399,"[89, 257, 1133, 467, 0, 942, 940, 1133, 381, 261, 442, 217, 230, 715, 243, 1006, 1024, 989, 749, 667, 1050, 134, 959, 1050, 497, 337, 834, 1054, 300]"
48,4,3493,1319,8026,0,2055,1438,"[398, 252, 479, 301, 0, 230, 344, 479, 65, 63, 297, 233, 411, 89, 349, 303, 248, 392, 347, 138, 469, 251, 117, 303, 249, 207, 189, 350, 23]"
49,4,4082,5177,6931,0,620,3462,"[455, 523, 1154, 268, 0, 160, 668, 1154, 319, 850, 256, 38, 303, 350, 1047, 1067, 372, 747, 431, 97, 982, 428, 366, 997, 198, 270, 7, 171, 564]"
50,4,4903,6427,5407,0,2201,2702,"[56, 889, 900, 93, 0, 564, 573, 900, 784, 607, 474, 296, 180, 149, 477, 807, 120, 432, 246, 306, 806, 535, 342, 818, 549, 391, 583, 215, 61]"
51,4,3685,2430,6662,0,2131,1554,"[249, 43, 518, 456, 0, 274, 486, 518, 452, 212, 312, 6, 466, 503, 200, 486, 170, 24, 288, 264, 433, 454, 141, 322, 277, 185, 416, 493, 90]"
52,4,3736,373,10000,25,501,3235,"[273, 616, 1078, 980, 0, 530, 421, 1078, 55, 604, 780, 379, 662, 759, 952, 314, 29, 715, 654, 467, 707, 991, 1070, 489, 581, 630, 1003, 470, 951]"
53,4,4698,5028,9670,0,726,3972,"[368, 715, 1324, 235, 0, 896, 433, 1324, 954, 948, 762, 472, 1049, 1179, 760, 1001, 240, 60, 289, 1066, 1141, 87, 724, 339, 1190, 948, 89, 1203, 787]"
54,4,4815,5216,9269,0,271,4544,"[176, 417, 1514, 1427, 0, 274, 1407, 1514, 617, 588, 282, 244, 563, 982, 1090, 1106, 1055, 1187, 717, 1178, 1234, 398, 471, 1438, 732, 597, 841, 734, 124]"
55,4,4602,6412,7459,0,665,3937,"[644, 405, 1312, 1009, 0, 559, 292, 1312, 429, 1280, 838, 482, 217, 74, 1110, 400, 317, 1130, 731, 1029, 16, 914, 420, 1130, 1256, 393, 1200, 421, 926]"
56,4,3347,288,10000,518,228,3119,"[409, 866, 1039, 625, 0, 509, 144, 1039, 673, 404, 920, 343, 816, 193, 394, 146, 1020, 869, 320, 302, 580, 520, 16, 929, 895, 223, 479, 796, 813]"
57,4,4325,6514,7811,0,1017,3308,"[552, 689, 1102, 598, 0, 462, 239, 1102, 243, 860, 391, 702, 740, 774, 875, 369, 1060, 757, 60, 272, 606, 819, 472, 927, 651, 361, 667, 1007, 812]"
58,4,4829,6780,5860,0,3041,1788,"[237, 5, 596, 190, 0, 0, 295, 596, 270, 183, 542, 45, 292, 381, 574, 50, 390, 270, 13, 216, 369, 85, 280, 437, 546, 193, 145, 86, 350]"
59,4,4713,757,9816,0,2778,1935,"[629, 414, 645, 28, 0, 159, 111, 645, 457, 282, 468, 530, 313, 279, 341, 364, 444, 230, 587, 102, 608, 506, 377, 644, 83, 16, 106, 18, 73]"
60,4,4729,6352,8193,0,2567,2162,"[408, 393, 720, 11, 0, 398, 620, 720, 299, 119, 646, 566, 687, 427, 227, 521, 162, 415, 579, 380, 275, 362, 643, 516, 98, 34, 165, 508, 414]"
61,4,3055,5771,5477,0,1057,1998,"[210, 459, 666, 585, 0, 518, 312, 666, 141, 479, 13, 284, 563, 404, 212, 234, 78, 75, 600, 574, 282, 281, 234, 604, 427, 281, 661, 87, 355]"
62,4,3358,1327,7508,0,1638,1720,"[416, 230, 573, 167, 0, 86, 383, 573, 418, 8, 61, 67, 448, 353, 43, 164, 408, 289, 258, 385, 505, 304, 60, 44, 80, 553, 468, 214, 69]"
63,4,3307,2392,8423,0,1462,1845,"[84, 45, 615, 580, 0, 255, 0, 615, 400, 478, 180, 24, 348, 158, 352, 231, 251, 268, 92, 575, 546, 373, 216, 11, 602, 386, 533, 70, 204]"
64,4,4501,6229,6695,0,3349,1152,"[54, 117, 384, 107, 0, 137, 101, 384, 129, 195, 384, 39, 103, 89, 345, 360, 191, 141, 136, 322, 157, 91, 15, 201, 314, 95, 235, 43, 297]"
65,4,4076,1162,9609,0,2469,1607,"[381, 509, 535, 41, 0, 250, 404, 535, 432, 460, 242, 288, 421, 407, 506, 371, 145, 70, 457, 391, 0, 20, 246, 1, 491, 264, 112, 364, 48]"
66,4,4041,7157,6493,0,1457,2584,"[623, 415, 861, 65, 0, 438, 859, 861, 310, 2, 403, 708, 256, 395, 415, 34, 146, 49, 217, 753, 480, 639, 64, 181, 288, 434, 709, 172, 353]"
67,4,3316,2104,7705,0,504,2812,"[494, 484, 937, 920, 0, 929, 563, 937, 225, 86, 883, 120, 732, 152, 706, 544, 748, 320, 468, 284, 509, 872, 635, 327, 171, 352, 396, 507, 900]"
68,4,3132,1666,9171,0,2288,844,"[48, 158, 281, 193, 0, 243, 113, 281, 157, 180, 95, 253, 243, 18, 222, 99, 223, 87, 195, 130, 37, 148, 7, 87, 144, 81, 238, 31, 125]"
69,4,3004,5162,7013,0,587,2417,"[18, 751, 805, 330, 0, 549, 9, 805, 173, 674, 375, 116, 557, 213, 307, 789, 450, 147, 709, 547, 651, 241, 560, 778, 37, 722, 473, 240, 511]"
70,4,3323,2346,7990,0,1299,2024,"[91, 473, 674, 162, 0, 260, 552, 674, 188, 488, 284, 165, 428, 486, 557, 432, 546, 651, 277, 25, 125, 234, 664, 167, 479, 664, 451, 217, 639]"
71,4,4864,5671,7183,0,2361,2503,"[591, 349, 834, 397, 0, 686, 453, 834, 155, 494, 508, 534, 718, 145, 269, 601, 730, 362, 833, 170, 415, 485, 588, 595, 795, 167, 493, 426, 89]"
72,4,4129,6662,4650,0,2867,1262,"[142, 263, 420, 35, 0, 13, 275, 420, 415, 296, 193, 162, 326, 396, 347, 130, 332, 153, 280, 303, 359, 28, 185, 63, 231, 338, 369, 163, 210]"
73,4,3939,258,8331,0,1481,2458,"[350, 161, 819, 606, 0, 314, 240, 819, 129, 545, 51, 21, 106, 692, 563, 634, 606, 115, 558, 391, 90, 151, 21, 486, 759, 572, 407, 94, 25]"
74,4,4368,5415,7284,0,2105,2263,"[152, 164, 754, 240, 0, 679, 590, 754, 452, 541, 19, 692, 458, 70, 455, 594, 82, 692, 191, 664, 752, 364, 400, 258, 11, 103, 738, 297, 263]"
75,4,4887,5940,6231,0,457,4430,"[643, 68, 1476, 564, 0, 13, 890, 1476, 1000, 914, 471, 354, 1051, 1270, 732, 129, 320, 973, 70, 1106, 548, 120, 1052, 522, 620, 1152, 409, 740, 877]"
76,4,4082,2350,7963,0,362,3720,"[872, 280, 1240, 1, 0, 362, 42, 1240, 414, 462, 347, 113, 208, 700, 319, 601, 247, 593, 1164, 143, 1031, 71, 1087, 612, 494, 856, 968, 968, 710]"
77,4,4487,6709,5741,0,3077,1410,"[362, 39, 470, 83, 0, 69, 203, 470, 42, 74, 10, 196, 237, 181, 426, 134, 461, 409, 238, 397, 83, 128, 179, 454, 325, 418, 467, 10, 354]"
78,4,3303,1498,7546,0,923,2380,"[593, 699, 793, 481, 0, 199, 639, 793, 350, 680, 82, 174, 353, 402, 476, 51, 696, 369, 510, 202, 8, 550, 70, 355, 9, 361, 531, 617, 698]"
79,4,4614,5934,6226,0,256,4358,"[739, 1319, 1452, 1334, 0, 741, 356, 1452, 43, 359, 852, 361, 482, 1084, 59, 976, 1178, 749, 351, 1384, 1298, 235, 1451, 396, 493, 61, 360, 97, 412]"
80,4,3796,2254,7768,0,3530,266,"[84, 33, 88, 63, 0, 69, 32, 88, 56, 27, 62, 49, 43, 11, 20, 48, 16, 76, 65, 38, 57, 68, 37, 86, 27, 9, 5, 2, 24]"
81,4,4644,6497,5915,0,1427,3217,"[45, 303, 1072, 628, 0, 1038, 904, 1072, 30, 279, 441, 1037, 422, 368, 665, 1049, 717, 386, 514, 325, 799, 202, 830, 825, 418, 1036, 103, 767, 237]"
82,4,3719,3029,6605,0,2107,1612,"[275, 526, 537, 372, 0, 508, 401, 537, 170, 165, 367, 361, 49, 243, 233, 25, 375, 27, 147, 465, 417, 349, 293, 449, 260, 134, 223, 131, 511]"
83,4,3520,2437,7688,0,1782,1738,"[204, 37, 579, 38, 0, 62, 564, 579, 80, 285, 310, 63, 103, 23, 272, 327, 387, 91, 14, 194, 312, 12, 194, 304, 124, 259, 135, 335, 503]"
84,4,3524,6798,4414,0,941,2583,"[399, 522, 861, 268, 0, 576, 264, 861, 183, 516, 98, 419, 129, 623, 460, 151, 550, 618, 108, 196, 656, 241, 2, 163, 41, 858, 695, 167, 258]"
85,4,4508,3246,5676,0,234,4274,"[353, 778, 1424, 1110, 0, 718, 721, 1424, 1087, 1115, 212, 7, 500, 1128, 1401, 848, 113, 1362, 143, 620, 1304, 1405, 309, 169, 976, 1228, 374, 1144, 107]"
86,4,3224,1849,7051,0,1832,1392,"[157, 265, 464, 199, 0, 119, 121, 464, 351, 117, 69, 315, 440, 162, 199, 27, 287, 209, 318, 359, 365, 442, 345, 399, 371, 92, 128, 218, 42]"
87,4,4076,6816,4311,0,3008,1068,"[29, 104, 356, 171, 0, 199, 327, 356, 276, 273, 299, 237, 249, 266, 172, 132, 110, 37, 96, 271, 312, 356, 65, 87, 126, 179, 258, 242, 78]"
88,4,4047,548,7810,0,921,3126,"[765, 226, 1042, 105, 0, 170, 181, 1042, 310, 418, 774, 26, 330, 568, 702, 692, 835, 391, 366, 1001, 483, 401, 638, 390, 940, 590, 53, 367, 785]"
89,4,3112,2056,8866,0,2344,768,"[116, 151, 256, 81, 0, 255, 185, 256, 169, 167, 58, 113, 66, 177, 204, 204, 26, 214, 74, 197, 171, 186, 132, 44, 69, 234, 42, 156, 188]"
90,4,3330,6313,5883,0,711,2619,"[233, 176, 873, 324, 0, 265, 78, 873, 433, 504, 336, 626, 49, 637, 225, 560, 269, 698, 87, 10, 522, 822, 375, 502, 867, 53, 362, 597, 104]"
91,4,3570,1430,8023,0,3251,319,"[16, 98, 106, 51, 0, 86, 63, 106, 41, 65, 85, 64, 29, 46, 88, 18, 46, 17, 80, 81, 106, 56, 63, 76, 34, 103, 48, 98, 63]"
92,4,4245,7161,5107,0,1287,2958,"[917, 490, 986, 471, 0, 552, 223, 986, 344, 162, 917, 457, 629, 780, 736, 836, 30, 915, 809, 575, 5, 842, 261, 96, 153, 910, 133, 341, 27]"
93,4,3477,1541,7043,0,2411,1066,"[190, 187, 355, 130, 0, 184, 214, 355, 71, 103, 324, 254, 87, 87, 224, 222, 265, 219, 334, 108, 22, 60, 267, 290, 67, 106, 217, 13, 134]"
94,4,3434,2572,7905,0,252,3182,"[598, 377, 1060, 307, 0, 1038, 689, 1060, 326, 760, 984, 756, 679, 349, 484, 92, 296, 236, 468, 644, 588, 537, 752, 915, 307, 600, 248, 772, 742]"
95,4,4308,7333,4880,0,3354,954,"[218, 114, 318, 147, 0, 8, 184, 318, 279, 143, 53, 16, 261, 182, 18, 175, 148, 248, 141, 233, 111, 156, 178, 266, 107, 235, 35, 195, 274]"
96,4,4950,3132,6698,0,4353,597,"[122, 112, 199, 92, 0, 114, 7, 199, 79, 164, 103, 38, 55, 142, 7, 42, 111, 144, 119, 104, 132, 155, 2, 111, 162, 164, 190, 20, 152]"
97,4,4627,5613,5712,0,322,4305,"[164, 1251, 1435, 492, 0, 433, 491, 1435, 527, 836, 1017, 140, 687, 1206, 554, 1361, 586, 165, 449, 697, 1315, 1315, 1094, 730, 1169, 767, 14, 573, 744]"
98,4,3401,2090,7023,0,2650,751,"[234, 110, 250, 211, 0, 75, 208, 250, 182, 230, 239, 197, 144, 235, 170, 62, 129, 223, 188, 95, 8, 99, 124, 169, 149, 239, 226, 23, 163]"
99,4,4633,5605,6051,0,224,4409,"[1170, 338, 1469, 632, 0, 1422, 643, 1469, 1252, 9, 1184, 920, 303, 399, 1350, 387, 137, 337, 1043, 1200, 1161, 816, 917, 514, 1268, 1350, 898, 952, 1339]"
100,4,4042,2762,7331,0,1735,2307,"[735, 399, 769, 162, 0, 364, 678, 769, 511, 602, 244, 606, 334, 138, 576, 313, 769, 543, 272, 764, 751, 514, 145, 708, 271, 180, 271, 617, 22]"
101,4,3676,6957,4050,0,1739,1937,"[629, 56, 645, 10, 0, 192, 295, 645, 525, 111, 98, 495, 578, 449, 243, 112, 25, 263, 567, 403, 460, 68, 373, 120, 449, 367, 20, 153, 220]"
102,4,3610,2417,5243,0,895,2715,"[410, 818, 905, 61, 0, 66, 738, 905, 355, 27, 410, 865, 493, 765, 728, 658, 750, 578, 436, 251, 645, 125, 781, 182, 848, 583, 829, 414, 77]"
103,4,4498,46,9695,0,3205,1293,"[64, 13, 431, 61, 0, 375, 286, 431, 172, 414, 94, 210, 44, 279, 190, 135, 298, 424, 396, 101, 403, 191, 197, 25, 242, 288, 120, 63, 250]"
104,4,3534,6063,7166,0,574,2960,"[883, 304, 986, 120, 0, 70, 809, 986, 512, 857, 343, 363, 282, 506, 856, 801, 713, 422, 243, 154, 206, 521, 328, 984, 857, 406, 683, 813, 948]"
105,4,4753,6605,5314,0,3197,1556,"[189, 82, 518, 205, 0, 267, 283, 518, 185, 149, 201, 122, 465, 413, 423, 195, 254, 68, 413, 324, 275, 339, 167, 239, 508, 402, 301, 323, 396]"
106,4,4346,2920,6740,0,2952,1394,"[276, 52, 464, 355, 0, 180, 290, 464, 239, 256, 255, 73, 336, 459, 408, 311, 16, 430, 51, 105, 42, 426, 372, 377, 132, 352, 144, 276, 159]"
107,4,4596,7437,3899,0,1945,2651,"[178, 266, 883, 640, 0, 209, 736, 883, 86, 406, 245, 34, 150, 489, 9, 15, 244, 383, 87, 27, 840, 429, 263, 343, 461, 110, 306, 184, 89]"
108,4,4393,4232,4060,0,2689,1704,"[232, 437, 568, 508, 0, 232, 351, 568, 549, 9, 488, 201, 355, 430, 56, 565, 324, 394, 19, 220, 474, 201, 121, 410, 306, 37, 434, 325, 201]"
109,4,3537,2322,5275,0,1787,1750,"[96, 41, 583, 229, 0, 92, 416, 583, 419, 560, 315, 480, 267, 452, 421, 490, 355, 310, 411, 554, 542, 370, 39, 274, 103, 171, 98, 563, 434]"
110,4,4267,3135,6407,0,3582,685,"[192, 120, 228, 112, 0, 46, 55, 228, 91, 11, 185, 66, 217, 195, 111, 170, 46, 74, 18, 146, 161, 207, 68, 1, 89, 64, 68, 14, 72]"
111,4,3778,3305,6880,0,1314,2464,"[489, 120, 821, 239, 0, 805, 705, 821, 128, 56, 307, 587, 663, 583, 317, 140, 251, 613, 730, 614, 379, 727, 809, 227, 434, 773, 36, 320, 51]"
112,4,3436,3365,6951,0,2389,1047,"[277, 311, 349, 87, 0, 39, 218, 349, 22, 115, 135, 125, 229, 234, 118, 273, 229, 282, 91, 108, 72, 187, 217, 230, 36, 64, 214, 107, 331]"
113,4,3325,1316,8960,0,1687,1638,"[56, 58, 546, 343, 0, 352, 469, 546, 164, 37, 257, 48, 255, 204, 501, 249, 474, 362, 466, 275, 141, 527, 431, 243, 395, 483, 489, 324, 49]"
114,4,4143,5286,7817,0,3926,217,"[14, 8, 72, 29, 0, 32, 59, 72, 45, 29, 10, 61, 38, 71, 16, 67, 18, 47, 6, 55, 65, 6, 48, 3, 57, 35, 21, 30, 29]"
115,4,4785,5945,6657,0,1639,3146,"[201, 249, 1048, 464, 0, 819, 823, 1048, 1045, 155, 829, 714, 121, 231, 34, 459, 26, 1029, 47, 865, 3, 388, 447, 889, 914, 599, 954, 215, 1022]"
116,4,4327,2669,8315,0,472,3855,"[7, 155, 1285, 1157, 0, 120, 998, 1285, 379, 149, 183, 943, 883, 642, 786, 382, 862, 34, 602, 1069, 382, 165, 846, 1258, 97, 210, 729, 806, 156]"
117,4,4618,5263,7670,0,2644,1974,"[398, 565, 658, 170, 0, 222, 402, 658, 24, 181, 2, 603, 338, 481, 185, 525, 559, 401, 538, 6, 101, 158, 557, 489, 471, 475, 316, 183, 186]"
118,4,4342,5540,6472,0,3251,1091,"[315, 125, 363, 246, 0, 113, 242, 363, 100, 1, 78, 8, 41, 104, 77, 179, 187, 296, 244, 104, 252, 38, 78, 2, 254, 97, 221, 22, 198]"
119,4,4169,2851,7790,0,2307,1862,"[307, 212, 620, 340, 0, 144, 132, 620, 421, 181, 155, 27, 170, 48, 116, 286, 82, 335, 83, 36, 154, 102, 512, 410, 380, 490, 93, 595, 549]"
0,5,4562,0,4562,0,627,3935,"[1311, 452, 128, 1291, 1055, 0, 926, 1207, 898, 468, 1007, 671, 949, 528, 1311, 1174, 448, 839, 1028, 1289, 367, 270, 1052, 397, 474, 1280, 618, 50, 883]"
1,5,3561,2297,5826,0,3545,16,"[5, 5, 5, 5, 3, 0, 1, 2, 5, 5, 4, 4, 2, 0, 5, 2, 3, 4, 4, 2, 4, 5, 1, 4, 2, 5, 1, 3, 2]"
2,5,4641,1914,8553,0,1953,2688,"[896, 819, 56, 769, 165, 0, 852, 415, 728, 349, 345, 603, 729, 499, 896, 554, 807, 474, 177, 245, 774, 573, 552, 140, 248, 216, 524, 737, 648]"
3,5,3238,5980,5811,0,21,3217,"[1072, 508, 371, 757, 423, 0, 622, 4, 766, 886, 263, 977, 89, 697, 1072, 121, 686, 741, 1029, 117, 206, 339, 802, 864, 1072, 907, 434, 952, 1011]"
4,5,3127,910,8028,0,37,3090,"[1030, 98, 509, 992, 836, 0, 685, 21, 351, 469, 365, 606, 1022, 39, 1030, 267, 245, 354, 640, 496, 739, 431, 996, 459, 408, 758, 796, 137, 988]"
5,5,3499,6622,4905,0,2009,1490,"[496, 242, 96, 358, 365, 0, 185, 453, 384, 127, 132, 360, 317, 390, 496, 87, 59, 39, 126, 288, 163, 97, 71, 360, 29, 72, 230, 455, 473]"
6,5,3556,3247,5214,0,1604,1952,"[650, 76, 540, 649, 326, 0, 413, 609, 536, 97, 468, 492, 256, 271, 650, 287, 529, 404, 555, 146, 551, 29, 638, 250, 37, 535, 20, 335, 95]"
7,5,4581,1812,7983,0,3095,1486,"[495, 241, 348, 160, 380, 0, 267, 55, 432, 411, 143, 244, 154, 170, 495, 108, 103, 485, 57, 489, 482, 37, 361, 454, 90, 213, 444, 155, 495]"
8,5,3458,5857,5584,0,97,3361,"[1120, 391, 1112, 526, 700, 0, 1102, 23, 366, 361, 4, 306, 321, 706, 1120, 879, 822, 26, 144, 466, 556, 379, 584, 689, 595, 781, 453, 676, 108]"
9,5,4147,619,9112,0,3679,468,"[156, 19, 20, 148, 54, 0, 37, 10, 100, 47, 96, 112, 85, 135, 156, 123, 127, 112, 115, 89, 53, 110, 22, 114, 37, 90, 26, 142, 14]"
10,5,4819,5046,8885,0,718,4101,"[1367, 613, 1350, 979, 324, 0, 728, 926, 174, 358, 1053, 63, 1299, 525, 1367, 532, 419, 718, 1306, 143, 1324, 1270, 1295, 528, 1202, 128, 499, 744, 1016]"
11,5,3554,6556,5883,0,1782,1772,"[590, 188, 498, 266, 100, 0, 29, 187, 126, 131, 552, 377, 63, 346, 590, 375, 261, 302, 11, 558, 255, 433, 406, 400, 283, 192, 403, 89, 165]"
12,5,3364,2700,6547,0,3026,338,"[112, 30, 74, 88, 43, 0, 84, 26, 85, 30, 75, 60, 20, 44, 112, 103, 35, 33, 26, 43, 77, 111, 16, 84, 79, 64, 81, 95, 77]"
13,5,4619,7276,3890,0,906,3713,"[1237, 1160, 1190, 1170, 123, 0, 1174, 574, 763, 173, 640, 731, 348, 52, 1237, 475, 394, 757, 769, 794, 1219, 74, 14, 594, 372, 102, 675, 21, 303]"
14,5,3233,2680,4443,0,2352,881,"[293, 144, 161, 126, 99, 0, 76, 221, 219, 40, 253, 0, 8, 174, 293, 159, 89, 183, 6, 250, 226, 289, 142, 261, 94, 242, 115, 202, 106]"
15,5,3098,1395,6146,0,2718,380,"[126, 1, 107, 2, 107, 0, 84, 60, 59, 68, 10, 57, 15, 106, 126, 77, 84, 78, 62, 43, 36, 2, 0, 54, 51, 22, 92, 29, 78]"
16,5,4141,3996,6291,0,4021,120,"[40, 12, 30, 4, 15, 0, 27, 28, 23, 40, 0, 16, 5, 7, 40, 1, 39, 24, 1, 39, 16, 3, 16, 40, 1, 21, 5, 34, 38]"
17,5,3403,2663,7031,0,113,3290,"[1096, 471, 654, 1088, 412, 0, 590, 644, 504, 174, 1018, 457, 536, 720, 1096, 770, 906, 719, 233, 128, 591, 707, 843, 440, 486, 1019, 617, 396, 923]"
18,5,4004,6835,4200,0,3322,682,"[227, 124, 177, 225, 209, 0, 22, 23, 191, 132, 159, 129, 15, 0, 227, 139, 64, 133, 75, 186, 161, 24, 192, 226, 57, 189, 18, 126, 182]"
19,5,4769,4689,4280,0,656,4113,"[1371, 1312, 1047, 1106, 334, 0, 139, 1235, 855, 708, 304, 1024, 1218, 804, 1371, 275, 383, 1132, 283, 130, 643, 302, 584, 1146, 1123, 72, 1279, 644, 1285]"
20,5,4681,1507,7454,0,3702,979,"[326, 289, 113, 114, 264, 0, 246, 310, 187, 225, 107, 257, 76, 298, 326, 111, 147, 286, 10, 52, 32, 269, 48, 153, 237, 65, 136, 288, 149]"
21,5,3306,1712,9048,0,3121,185,"[61, 44, 27, 49, 46, 0, 16, 42, 22, 21, 22, 15, 36, 9, 61, 22, 51, 13, 26, 23, 54, 10, 21, 51, 4, 39, 60, 10, 9]"
22,5,3663,7215,5496,0,1145,2518,"[839, 834, 764, 62, 277, 0, 678, 597, 455, 450, 803, 303, 619, 745, 839, 217, 13, 500, 740, 818, 596, 603, 189, 486, 337, 439, 585, 27, 181]"
23,5,3019,2741,5774,0,2206,813,"[271, 96, 117, 103, 0, 0, 96, 261, 260, 129, 122, 223, 49, 48, 271, 40, 83, 243, 194, 246, 265, 0, 137, 15, 70, 257, 124, 216, 165]"
24,5,4844,4728,5890,0,4825,19,"[6, 0, 2, 6, 4, 0, 1, 6, 2, 5, 3, 2, 6, 6, 6, 2, 5, 6, 2, 1, 1, 2, 1, 5, 4, 6, 2, 4, 4]"
25,5,3887,1211,8566,0,1592,2295,"[765, 699, 122, 551, 145, 0, 442, 474, 95, 520, 609, 674, 128, 412, 765, 269, 454, 570, 494, 643, 511, 760, 461, 168, 32, 712, 231, 363, 318]"
26,5,3205,6869,4902,0,1182,2023,"[674, 613, 572, 575, 74, 0, 324, 124, 576, 478, 610, 268, 212, 301, 674, 327, 173, 123, 368, 167, 360, 580, 568, 669, 298, 515, 117, 404, 45]"
27,5,4273,1939,7236,0,867,3406,"[1135, 957, 240, 862, 802, 0, 975, 382, 390, 899, 392, 134, 217, 932, 1135, 371, 210, 513, 612, 293, 188, 248, 232, 100, 1046, 8, 972, 1044, 1100]"
28,5,3663,1770,9129,0,2495,1168,"[389, 64, 36, 255, 65, 0, 65, 28, 8, 120, 247, 124, 368, 379, 389, 185, 196, 21, 139, 100, 375, 263, 267, 250, 39, 283, 192, 268, 108]"
29,5,4616,6265,7480,0,3100,1516,"[505, 167, 488, 394, 139, 0, 67, 222, 40, 153, 64, 486, 191, 45, 505, 72, 340, 208, 404, 241, 247, 186, 485, 408, 24, 384, 383, 189, 331]"
30,5,4831,6350,5961,0,797,4034,"[1344, 617, 311, 385, 1122, 0, 1262, 779, 100, 283, 1117, 675, 1190, 538, 1344, 847, 644, 551, 244, 1100, 1195, 1240, 836, 1126, 447, 39, 770, 722, 195]"
31,5,4466,1726,8701,0,3678,788,"[262, 217, 70, 154, 47, 0, 53, 142, 86, 120, 85, 90, 24, 255, 262, 254, 125, 192, 29, 220, 39, 45, 139, 160, 257, 51, 99, 251, 224]"
32,5,3480,5785,6396,0,1993,1487,"[495, 450, 114, 113, 439, 0, 488, 211, 365, 244, 90, 253, 2, 147, 495, 485, 279, 463, 255, 363, 415, 290, 354, 292, 157, 42, 343, 123, 441]"
33,5,3521,54,9863,0,1305,2216,"[738, 27, 74, 413, 455, 0, 440, 423, 486, 651, 507, 236, 582, 726, 738, 395, 93, 85, 706, 655, 270, 341, 167, 399, 278, 202, 677, 563, 50]"
34,5,3027,7328,5562,0,2074,953,"[317, 307, 150, 50, 205, 0, 197, 24, 39, 5, 64, 293, 48, 217, 317, 149, 42, 120, 118, 111, 313, 242, 130, 228, 242, 31, 249, 301, 65]"
35,5,3114,3076,5600,0,645,2469,"[823, 783, 42, 277, 118, 0, 688, 80, 296, 707, 198, 490, 449, 676, 823, 169, 380, 452, 312, 671, 353, 115, 587, 231, 752, 485, 599, 657, 130]"
36,5,4997,338,10000,259,2484,2513,"[837, 388, 634, 461, 730, 0, 80, 695, 688, 133, 697, 521, 546, 691, 837, 605, 668, 737, 519, 127, 375, 522, 581, 451, 597, 458, 472, 380, 25]"
37,5,4987,7106,7881,0,3258,1729,"[576, 508, 15, 258, 87, 0, 205, 57, 498, 429, 456, 204, 414, 138, 576, 141, 311, 180, 244, 522, 234, 561, 331, 428, 303, 166, 165, 75, 42]"
38,5,4789,6641,6029,0,3167,1622,"[540, 31, 512, 38, 259, 0, 95, 340, 215, 374, 243, 288, 429, 5, 540, 115, 121, 496, 27, 443, 174, 18, 452, 251, 90, 273, 196, 110, 474]"
39,5,3612,2427,7214,0,3256,356,"[118, 90, 27, 24, 80, 0, 67, 13, 88, 59, 113, 115, 103, 35, 118, 6, 52, 88, 67, 38, 45, 59, 103, 17, 25, 108, 5, 73, 42]"
40,5,3198,257,10000,155,2278,920,"[306, 244, 243, 52, 180, 0, 291, 183, 251, 91, 178, 298, 62, 106, 306, 55, 251, 204, 293, 14, 109, 149, 236, 91, 41, 165, 226, 35, 298]"
41,5,3632,6904,6728,0,3005,627,"[209, 159, 94, 160, 44, 0, 198, 87, 107, 150, 89, 29, 67, 66, 209, 163, 138, 4, 148, 44, 128, 119, 108, 207, 119, 178, 83, 112, 180]"
42,5,4607,5617,5718,0,1740,2867,"[955, 121, 306, 826, 543, 0, 778, 10, 51, 480, 245, 832, 207, 856, 955, 526, 77, 341, 104, 34, 56, 791, 162, 174, 672, 3, 425, 188, 705]"
43,5,3683,488,8913,0,1616,2067,"[689, 35, 522, 671, 631, 0, 193, 35, 547, 470, 453, 578, 671, 17, 689, 232, 228, 10, 644, 537, 175, 78, 205, 600, 29, 24, 42, 207, 33]"
44,5,4460,5089,8284,0,4303,157,"[52, 12, 43, 19, 38, 0, 36, 20, 51, 33, 22, 32, 34, 26, 52, 48, 52, 36, 31, 10, 3, 8, 20, 22, 34, 42, 17, 21, 52]"
45,5,3675,5799,6160,0,1934,1741,"[580, 141, 484, 62, 241, 0, 284, 55, 152, 68, 13, 394, 323, 185, 580, 436, 238, 463, 105, 150, 150, 309, 92, 129, 553, 264, 487, 170, 198]"
46,5,3055,2870,6345,0,1423,1632,"[544, 449, 461, 120, 397, 0, 57, 520, 120, 130, 293, 306, 530, 122, 544, 62, 324, 41, 30, 446, 290, 89, 258, 311, 90, 470, 276, 121, 485]"
47,5,4413,1355,9403,0,264,4149,"[1383, 706, 678, 489, 49, 0, 240, 358, 1099, 1211, 518, 639, 1055, 0, 1383, 460, 394, 593, 598, 127, 422, 1272, 1237, 1094, 63, 515, 1086, 636, 534]"
48,5,3949,6076,7276,0,3324,625,"[208, 119, 182, 160, 198, 0, 44, 69, 133, 145, 161, 128, 91, 30, 208, 151, 38, 159, 13, 81, 86, 92, 84, 82, 103, 88, 95, 92, 206]"
49,5,4988,6015,6249,0,2823,2165,"[721, 514, 615, 643, 521, 0, 599, 400, 13, 53, 548, 592, 610, 172, 721, 42, 336, 126, 344, 214, 635, 657, 220, 592, 536, 409, 340, 502, 99]"
50,5,3698,1130,8817,0,1167,2531,"[843, 494, 284, 496, 0, 0, 332, 336, 57, 614, 593, 160, 220, 60, 843, 654, 737, 556, 287, 151, 409, 726, 45, 633, 229, 518, 269, 100, 121]"
51,5,4067,5953,6931,0,3097,970,"[323, 104, 14, 46, 315, 0, 197, 270, 157, 158, 120, 287, 90, 281, 323, 20, 262, 210, 40, 260, 206, 244, 39, 189, 28, 95, 0, 28, 17]"
52,5,4946,6210,5667,0,4852,94,"[31, 17, 16, 23, 17, 0, 6, 25, 5, 20, 7, 29, 14, 20, 31, 24, 4, 12, 15, 27, 22, 27, 4, 29, 20, 3, 29, 29, 5]"
53,5,4441,2112,7996,0,615,3826,"[1275, 937, 491, 380, 861, 0, 811, 1060, 156, 1173, 824, 1177, 1237, 704, 1275, 678, 527, 899, 356, 1066, 836, 846, 671, 871, 491, 625, 293, 480, 717]"
54,5,3752,5963,5785,0,2886,866,"[288, 278, 156, 252, 251, 0, 163, 62, 92, 245, 181, 49, 97, 131, 288, 251, 12, 164, 54, 119, 238, 216, 257, 2, 145, 117, 41, 274, 164]"
55,5,3214,322,8677,0,2596,618,"[206, 71, 141, 206, 100, 0, 1, 95, 116, 129, 98, 7, 107, 60, 206, 101, 119, 89, 84, 158, 64, 6, 195, 169, 161, 87, 200, 160, 65]"
56,5,4225,5735,7167,0,4224,1,"[0, 0, 0, 0, 0, 0, 0, 0, 0, 0, 0, 0, 0, 0, 0, 0, 0, 0, 0, 0, 0, 0, 0, 0, 0, 0, 0, 0, 0]"
57,5,3920,5708,5379,0,1949,1971,"[657, 411, 519, 546, 211, 0, 548, 555, 211, 636, 146, 520, 606, 570, 657, 571, 558, 649, 501, 464, 158, 135, 440, 124, 405, 176, 248, 143, 527]"
58,5,3639,2674,6344,0,2149,1490,"[496, 51, 107, 5, 236, 0, 227, 278, 232, 62, 36, 166, 0, 80, 496, 240, 153, 345, 328, 257, 312, 185, 491, 279, 72, 481, 59, 15, 151]"
59,5,3377,319,9402,0,3170,207,"[69, 25, 9, 7, 49, 0, 55, 27, 6, 46, 52, 45, 1, 51, 69, 64, 44, 62, 30, 51, 6, 9, 20, 56, 57, 32, 32, 45, 63]"
60,5,4423,6617,7208,0,3540,883,"[294, 89, 91, 88, 272, 0, 90, 45, 90, 129, 256, 267, 156, 41, 294, 161, 24, 72, 60, 3, 24, 159, 215, 4, 42, 28, 181, 2, 211]"
61,5,4814,6973,5049,0,3802,1012,"[337, 135, 150, 100, 102, 0, 264, 264, 238, 241, 271, 304, 296, 90, 337, 35, 193, 35, 172, 165, 280, 269, 187, 184, 49, 119, 22, 155, 290]"
62,5,4110,2153,7006,0,67,4043,"[1347, 869, 1019, 1192, 952, 0, 1123, 1105, 1311, 726, 183, 515, 320, 1118, 1347, 366, 119, 493, 1214, 646, 496, 399, 1143, 1280, 215, 564, 1272, 795, 1202]"
63,5,4296,5887,5415,0,1251,3045,"[1015, 367, 472, 897, 878, 0, 264, 261, 499, 451, 481, 383, 94, 262, 1015, 318, 821, 84, 555, 780, 316, 497, 790, 533, 344, 675, 75, 532, 692]"
64,5,4763,4644,5534,0,336,4427,"[1475, 552, 298, 738, 1053, 0, 993, 114, 1064, 514, 1053, 46, 65, 757, 1475, 611, 787, 1195, 404, 654, 798, 1154, 1159, 1002, 1385, 482, 964, 305, 915]"
65,5,4734,3358,6910,0,100,4634,"[1544, 392, 1312, 174, 55, 0, 562, 148, 733, 1530, 589, 1413, 143, 116, 1544, 695, 859, 126, 240, 1329, 1132, 59, 343, 1072, 600, 1317, 1361, 1112, 768]"
66,5,3732,771,9871,0,2617,1115,"[371, 46, 48, 127, 108, 0, 350, 1, 171, 180, 87, 7, 33, 112, 371, 200, 12, 218, 82, 331, 237, 131, 197, 31, 213, 164, 164, 91, 78]"
67,5,3807,7332,6346,0,2813,994,"[331, 190, 75, 147, 124, 0, 53, 281, 176, 96, 160, 214, 190, 195, 331, 136, 207, 234, 301, 190, 158, 106, 282, 59, 47, 145, 136, 274, 62]"
68,5,3657,2533,7470,0,2452,1205,"[401, 62, 27, 34, 250, 0, 205, 353, 389, 338, 373, 11, 220, 269, 401, 400, 227, 58, 303, 256, 214, 234, 280, 331, 296, 370, 373, 37, 142]"
69,5,4161,7455,4176,0,2290,1871,"[623, 384, 208, 219, 35, 0, 478, 18, 531, 506, 279, 493, 517, 0, 623, 92, 495, 599, 273, 120, 406, 467, 482, 199, 251, 96, 491, 606, 620]"
70,5,3382,415,7143,0,84,3298,"[1099, 215, 515, 528, 904, 0, 981, 997, 103, 817, 780, 783, 395, 902, 1099, 306, 424, 239, 342, 98, 641, 8, 249, 640, 635, 836, 774, 42, 783]"
71,5,4122,5949,5316,0,728,3394,"[1131, 918, 137, 775, 413, 0, 601, 662, 120, 16, 241, 179, 556, 176, 1131, 259, 863, 1111, 419, 584, 184, 576, 1032, 35, 338, 288, 231, 643, 17]"
72,5,3816,3012,6120,0,2109,1707,"[569, 97, 491, 511, 151, 0, 266, 522, 151, 270, 11, 332, 61, 291, 569, 526, 528, 59, 1, 413, 92, 344, 117, 218, 362, 18, 279, 373, 285]"
73,5,3682,3399,6403,0,3517,165,"[55, 26, 37, 46, 54, 0, 17, 53, 44, 53, 26, 52, 21, 16, 55, 36, 30, 12, 36, 42, 11, 12, 53, 38, 5, 21, 42, 29, 39]"
74,5,4724,7209,3918,0,3615,1109,"[369, 186, 322, 142, 154, 0, 180, 75, 114, 359, 243, 52, 26, 98, 369, 72, 319, 108, 126, 275, 284, 250, 186, 12, 75, 179, 48, 208, 233]"
75,5,4412,1693,6637,0,2598,1814,"[604, 25, 593, 587, 358, 0, 430, 254, 255, 331, 112, 340, 448, 281, 604, 419, 585, 583, 228, 400, 463, 547, 254, 309, 312, 497, 485, 403, 288]"
76,5,4904,5160,6381,0,792,4112,"[1370, 328, 1012, 569, 1244, 0, 601, 1215, 946, 28, 841, 813, 367, 1347, 1370, 1280, 185, 918, 83, 99, 1228, 156, 1046, 648, 580, 770, 5, 441, 1368]"
77,5,4272,411,10000,242,4254,18,"[6, 0, 1, 3, 2, 0, 3, 4, 3, 4, 1, 3, 6, 6, 6, 5, 4, 6, 2, 3, 0, 1, 4, 5, 1, 3, 1, 5, 0]"
78,5,4774,6295,8479,0,1993,2781,"[927, 213, 879, 98, 514, 0, 145, 897, 544, 671, 919, 76, 738, 261, 927, 869, 590, 67, 819, 711, 55, 142, 290, 624, 888, 93, 464, 91, 18]"
79,5,3965,5715,6729,0,15,3950,"[1316, 279, 938, 68, 1033, 0, 152, 838, 552, 121, 570, 1085, 47, 657, 1316, 396, 361, 1035, 532, 211, 1117, 1313, 1309, 66, 38, 112, 883, 194, 1080]"
80,5,3212,2721,7220,0,1435,1777,"[592, 139, 114, 542, 182, 0, 307, 581, 547, 300, 301, 585, 135, 270, 592, 323, 575, 181, 95, 7, 240, 41, 140, 332, 566, 180, 80, 220, 492]"
81,5,3185,2323,8082,0,2293,892,"[297, 33, 139, 36, 219, 0, 204, 89, 83, 262, 151, 3, 93, 32, 297, 250, 295, 77, 222, 4, 212, 77, 140, 158, 42, 226, 148, 113, 258]"
82,5,3394,6787,4689,0,1482,1912,"[637, 416, 468, 185, 161, 0, 548, 275, 273, 307, 417, 191, 587, 160, 637, 433, 71, 632, 106, 166, 48, 514, 496, 251, 346, 466, 417, 403, 616]"
83,5,4975,2584,7080,0,957,4018,"[1339, 1314, 874, 463, 740, 0, 134, 1188, 998, 1178, 584, 42, 693, 793, 1339, 324, 1297, 920, 1039, 981, 376, 138, 447, 622, 30, 832, 354, 756, 509]"
84,5,3812,977,9915,0,2517,1295,"[431, 398, 431, 405, 290, 0, 374, 72, 62, 217, 157, 397, 235, 134, 431, 172, 136, 133, 32, 251, 158, 337, 46, 183, 302, 171, 410, 403, 257]"
85,5,4271,6618,7568,0,2075,2196,"[732, 527, 56, 383, 540, 0, 228, 143, 327, 385, 309, 41, 296, 685, 732, 188, 638, 342, 18, 559, 546, 76, 678, 11, 425, 354, 681, 32, 17]"
86,5,3768,5368,5968,0,3058,710,"[236, 52, 10, 54, 171, 0, 82, 41, 99, 207, 95, 172, 177, 105, 236, 223, 127, 184, 210, 31, 187, 70, 39, 58, 181, 129, 160, 49, 67]"
87,5,3227,630,8565,0,2601,626,"[208, 158, 208, 94, 13, 0, 163, 203, 140, 193, 136, 146, 62, 124, 208, 29, 162, 37, 70, 177, 118, 208, 98, 174, 175, 173, 183, 13, 107]"
88,5,4423,7268,5720,0,755,3668,"[1222, 388, 434, 1193, 852, 0, 707, 491, 399, 1180, 1218, 783, 902, 687, 1222, 26, 1214, 1084, 398, 982, 768, 771, 493, 91, 139, 1019, 1155, 722, 561]"
89,5,3851,3764,5807,0,683,3168,"[1056, 298, 588, 938, 761, 0, 584, 538, 953, 820, 368, 909, 987, 674, 1056, 528, 1044, 893, 158, 1038, 804, 202, 869, 1013, 971, 272, 668, 444, 125]"
90,5,3442,1643,7606,0,2742,700,"[233, 2, 58, 143, 2, 0, 64, 136, 118, 204, 135, 86, 146, 41, 233, 74, 7, 215, 24, 16, 220, 24, 15, 180, 141, 118, 35, 44, 1]"
91,5,3770,5335,6041,0,353,3417,"[1139, 1096, 428, 1139, 847, 0, 712, 983, 84, 948, 800, 96, 997, 21, 1139, 677, 569, 100, 535, 657, 547, 534, 235, 185, 984, 666, 415, 805, 1091]"
92,5,4927,621,10000,347,490,4437,"[1479, 275, 1400, 41, 1170, 0, 789, 104, 948, 1195, 450, 896, 779, 453, 1479, 574, 616, 887, 495, 490, 1466, 855, 366, 868, 1436, 1023, 846, 1318, 1033]"
93,5,4814,5215,9599,0,240,4574,"[1524, 151, 1183, 150, 439, 0, 976, 45, 1142, 1352, 805, 699, 1210, 1417, 1524, 1392, 128, 877, 345, 116, 763, 772, 764, 502, 1031, 292, 1279, 1142, 1130]"
94,5,4155,7162,6592,0,363,3792,"[1264, 905, 1157, 807, 1119, 0, 871, 834, 1065, 846, 1159, 684, 262, 709, 1264, 122, 742, 290, 460, 760, 956, 1209, 0, 199, 905, 243, 214, 465, 10]"
95,5,4098,3183,7507,0,2841,1257,"[419, 374, 178, 385, 4, 0, 379, 98, 356, 289, 75, 18, 222, 27, 419, 231, 107, 236, 62, 282, 60, 175, 411, 413, 256, 169, 354, 176, 312]"
96,5,4880,5723,6664,0,3043,1837,"[612, 201, 447, 416, 196, 0, 31, 157, 135, 550, 528, 378, 136, 383, 612, 602, 391, 16, 66, 202, 412, 148, 306, 33, 80, 452, 99, 40, 489]"
97,5,3209,242,9631,0,876,2333,"[777, 610, 380, 315, 511, 0, 69, 464, 417, 148, 389, 366, 38, 352, 777, 618, 557, 109, 564, 313, 679, 561, 57, 253, 56, 742, 219, 567, 94]"
98,5,4313,5565,8379,0,1592,2721,"[907, 485, 162, 101, 559, 0, 673, 845, 286, 275, 427, 690, 833, 41, 907, 175, 643, 54, 387, 165, 184, 683, 535, 493, 850, 94, 570, 493, 620]"
99,5,4123,6016,6486,0,1774,2349,"[783, 168, 208, 132, 516, 0, 6, 740, 241, 657, 139, 729, 666, 638, 783, 501, 778, 352, 743, 380, 158, 485, 559, 704, 655, 40, 427, 398, 661]"
100,5,3995,240,10000,241,610,3385,"[1128, 153, 510, 901, 653, 0, 1089, 367, 1086, 836, 844, 1015, 429, 322, 1128, 139, 381, 341, 190, 1116, 98, 701, 1099, 147, 991, 825, 221, 526, 891]"
101,5,3526,5012,8514,0,3215,311,"[103, 81, 72, 5, 71, 0, 97, 46, 92, 46, 95, 59, 40, 42, 103, 78, 33, 31, 81, 88, 6, 45, 49, 28, 75, 72, 53, 6, 56]"
102,5,3770,6853,5431,0,3061,709,"[236, 147, 8, 128, 125, 0, 188, 139, 124, 67, 24, 132, 44, 184, 236, 187, 233, 174, 9, 77, 39, 218, 34, 210, 218, 68, 152, 151, 219]"
103,5,3162,1965,6628,0,978,2184,"[728, 410, 129, 219, 557, 0, 716, 1, 515, 117, 309, 538, 407, 341, 728, 39, 83, 321, 701, 428, 176, 146, 563, 346, 622, 319, 267, 728, 569]"
104,5,4887,6096,5419,0,2632,2255,"[751, 603, 458, 473, 114, 0, 81, 582, 745, 637, 240, 576, 485, 375, 751, 517, 509, 501, 587, 62, 652, 44, 160, 735, 86, 461, 486, 459, 390]"
105,5,4605,3929,6095,0,2036,2569,"[856, 794, 567, 335, 615, 0, 194, 436, 423, 526, 684, 440, 83, 308, 856, 633, 747, 144, 166, 487, 815, 532, 638, 413, 195, 271, 160, 531, 833]"
106,5,4898,2998,7995,0,3599,1299,"[433, 37, 110, 151, 421, 0, 50, 120, 223, 175, 274, 224, 248, 275, 433, 401, 211, 355, 224, 345, 192, 243, 326, 211, 306, 380, 424, 139, 175]"
107,5,4180,5004,7171,0,14,4166,"[1388, 462, 309, 1261, 1031, 0, 975, 1166, 756, 444, 289, 122, 930, 1108, 1388, 861, 618, 369, 1061, 938, 26, 921, 903, 222, 92, 34, 17, 748, 502]"
108,5,4629,5504,6296,0,2959,1670,"[556, 218, 432, 75, 184, 0, 382, 116, 330, 136, 471, 243, 230, 40, 556, 522, 268, 455, 550, 158, 303, 336, 314, 262, 397, 100, 539, 530, 493]"
109,5,3766,274,9788,0,2112,1654,"[551, 140, 167, 482, 90, 0, 416, 124, 346, 453, 18, 513, 340, 296, 551, 149, 233, 161, 221, 477, 397, 339, 506, 288, 145, 475, 228, 311, 144]"
110,5,4379,6255,7912,0,227,4152,"[1384, 559, 821, 58, 1346, 0, 166, 701, 1378, 832, 197, 364, 1328, 820, 1384, 654, 1174, 454, 719, 52, 995, 282, 355, 133, 274, 692, 1113, 159, 785]"
111,5,4229,6947,5194,0,1810,2419,"[806, 101, 81, 55, 646, 0, 133, 454, 541, 38, 413, 105, 9, 767, 806, 593, 183, 124, 408, 380, 169, 170, 739, 205, 798, 13, 592, 668, 235]"
112,5,3097,1797,6494,0,282,2815,"[938, 61, 360, 391, 386, 0, 106, 44, 690, 391, 660, 717, 761, 321, 938, 105, 211, 321, 72, 724, 20, 888, 772, 910, 920, 623, 605, 420, 400]"
113,5,3554,723,9325,0,2681,873,"[291, 39, 50, 180, 35, 0, 262, 124, 70, 48, 85, 132, 285, 164, 291, 223, 180, 225, 198, 265, 136, 139, 110, 105, 222, 39, 22, 37, 245]"
114,5,3458,6953,5830,0,3314,144,"[48, 29, 22, 35, 38, 0, 25, 31, 15, 9, 37, 33, 23, 19, 48, 38, 20, 35, 4, 23, 1, 32, 12, 33, 45, 42, 43, 3, 39]"
115,5,4097,847,9080,0,1854,2243,"[747, 69, 689, 501, 371, 0, 523, 609, 140, 694, 654, 54, 302, 190, 747, 147, 636, 211, 635, 420, 233, 640, 536, 467, 638, 230, 641, 540, 62]"
116,5,3459,6613,5926,0,1826,1633,"[544, 515, 210, 333, 162, 0, 112, 332, 482, 55, 120, 217, 430, 367, 544, 77, 433, 94, 179, 186, 268, 114, 99, 42, 150, 415, 66, 347, 410]"
117,5,3431,686,8671,0,1360,2071,"[690, 448, 552, 502, 616, 0, 483, 313, 615, 585, 180, 175, 445, 666, 690, 380, 469, 614, 467, 268, 326, 655, 505, 670, 526, 82, 686, 280, 661]"
118,5,3271,5373,6569,0,1770,1501,"[500, 154, 72, 310, 75, 0, 438, 60, 364, 195, 28, 479, 345, 332, 500, 83, 305, 389, 110, 258, 456, 153, 472, 223, 457, 104, 272, 185, 88]"
119,5,4261,861,9969,0,171,4090,"[1363, 981, 762, 439, 261, 0, 1322, 1113, 152, 1359, 273, 1345, 392, 676, 1363, 201, 404, 97, 1346, 6, 565, 229, 613, 501, 267, 981, 704, 580, 63]"
0,6,5764,0,5764,0,850,4914,"[754, 2457, 2448, 2230, 193, 558, 0, 2037, 1533, 1613, 1879, 2220, 1038, 1846, 1736, 1316, 943, 221, 757, 63, 2354, 2148, 2437, 1969, 855, 2129, 1497, 269, 485]"
1,6,6256,5380,6640,0,5149,1107,"[438, 553, 13, 305, 219, 79, 0, 332, 276, 306, 61, 240, 501, 466, 355, 538, 55, 46, 36, 291, 216, 299, 63, 357, 222, 482, 254, 392, 361]"
2,6,6332,5855,7117,0,1425,4907,"[2336, 2453, 805, 412, 2132, 1147, 0, 1557, 1380, 648, 439, 2320, 1264, 1602, 1257, 1070, 65, 741, 1138, 1282, 605, 2046, 480, 740, 948, 2353, 1769, 1541, 706]"
3,6,6095,6571,6641,0,1667,4428,"[1735, 2214, 2147, 2196, 1688, 926, 0, 2068, 1867, 1754, 1757, 1751, 292, 961, 120, 1347, 994, 793, 441, 2070, 665, 638, 1989, 1024, 1538, 166, 371, 914, 1013]"
4,6,5772,6490,5923,0,5061,711,"[30, 355, 178, 2, 343, 121, 0, 203, 181, 115, 183, 320, 350, 210, 15, 165, 13, 172, 190, 239, 249, 289, 192, 165, 267, 136, 267, 181, 44]"
5,6,5889,7204,4608,0,1808,4081,"[17, 2040, 130, 1821, 781, 598, 0, 1831, 1061, 1583, 383, 1832, 1298, 876, 1723, 1813, 17, 1783, 1423, 1107, 1938, 2039, 1232, 780, 775, 698, 1682, 298, 1543]"
6,6,5370,4528,5450,0,1248,4122,"[21, 2061, 2029, 1139, 1592, 1648, 0, 1374, 1358, 1102, 709, 672, 1787, 685, 364, 169, 1487, 349, 556, 1210, 1991, 188, 1078, 890, 905, 1579, 1556, 37, 389]"
7,6,5829,6382,4897,0,792,5037,"[310, 2518, 866, 709, 1054, 38, 0, 1248, 1532, 1160, 1233, 737, 1508, 503, 32, 2366, 297, 2205, 2152, 1208, 1910, 1405, 2051, 106, 1772, 1086, 2397, 1094, 929]"
8,6,5693,1188,9402,0,2874,2819,"[255, 1409, 69, 244, 564, 827, 0, 533, 446, 484, 69, 1078, 1366, 1081, 1199, 596, 667, 312, 770, 798, 237, 213, 783, 951, 643, 1098, 422, 1176, 1077]"
9,6,5780,5581,9601,0,4339,1441,"[19, 720, 714, 718, 607, 226, 0, 246, 313, 121, 489, 111, 136, 265, 523, 553, 281, 623, 590, 72, 569, 71, 383, 315, 317, 428, 432, 447, 716]"
10,6,5545,6392,8754,0,1950,3595,"[297, 1797, 468, 490, 1135, 462, 0, 977, 715, 1608, 1650, 1307, 449, 1128, 1151, 891, 190, 1606, 688, 438, 370, 1363, 1652, 1000, 1492, 1769, 46, 1626, 1090]"
11,6,6010,7038,7726,0,3114,2896,"[661, 1448, 1001, 1038, 102, 1390, 0, 1370, 1391, 899, 17, 1330, 282, 488, 178, 5, 643, 1107, 330, 921, 181, 1161, 209, 31, 157, 90, 1388, 1130, 778]"
12,6,5025,5984,6767,0,1422,3603,"[1132, 1801, 1251, 1632, 638, 1386, 0, 1796, 441, 1162, 166, 40, 1190, 896, 977, 639, 1492, 369, 755, 345, 1407, 1254, 1319, 1613, 704, 1005, 300, 128, 537]"
13,6,5902,6923,5746,0,391,5511,"[1174, 2755, 460, 1342, 2733, 1877, 0, 1504, 1714, 375, 1613, 654, 1512, 685, 698, 1224, 1989, 533, 37, 2669, 2505, 557, 1068, 78, 2058, 611, 368, 1295, 1560]"
14,6,6302,7272,4776,0,4224,2078,"[0, 1039, 995, 494, 579, 287, 0, 599, 477, 195, 674, 555, 887, 695, 893, 713, 530, 636, 500, 24, 1028, 715, 745, 19, 57, 159, 986, 871, 375]"
15,6,6948,7244,4480,0,5018,1930,"[423, 965, 896, 573, 859, 668, 0, 792, 952, 70, 603, 484, 767, 538, 884, 924, 525, 470, 208, 770, 679, 900, 674, 765, 300, 165, 44, 224, 503]"
16,6,5692,5057,5115,0,2137,3555,"[1713, 1777, 1585, 642, 450, 1365, 0, 436, 1312, 282, 1225, 1006, 1099, 1400, 946, 1387, 68, 1356, 1599, 1426, 1193, 144, 1726, 1361, 1303, 1448, 1635, 65, 209]"
17,6,5047,2684,7478,0,1120,3927,"[602, 1963, 100, 1293, 829, 731, 0, 1613, 143, 523, 562, 902, 213, 497, 303, 697, 1626, 1415, 1827, 778, 1921, 1760, 879, 1880, 467, 252, 1804, 1381, 1664]"
18,6,6381,5328,8531,0,4439,1942,"[414, 971, 698, 49, 741, 83, 0, 296, 36, 43, 693, 757, 746, 216, 32, 135, 446, 693, 538, 769, 69, 10, 860, 736, 149, 549, 281, 669, 325]"
19,6,5761,6902,7390,0,5261,500,"[227, 250, 193, 233, 98, 169, 0, 202, 35, 137, 6, 201, 23, 176, 191, 114, 33, 134, 105, 89, 166, 155, 216, 83, 10, 137, 227, 154, 202]"
20,6,6451,5208,8633,0,5214,1237,"[488, 618, 336, 444, 178, 93, 0, 245, 96, 58, 92, 385, 241, 566, 539, 575, 81, 471, 21, 15, 254, 168, 370, 493, 590, 398, 199, 188, 323]"
21,6,5636,7099,7170,0,140,5496,"[247, 2748, 2226, 1679, 1271, 2411, 0, 1746, 1947, 421, 982, 923, 1352, 1979, 946, 1652, 1984, 1635, 745, 1635, 1159, 1669, 431, 2037, 149, 1678, 348, 1211, 1000]"
22,6,5778,6645,6303,0,4744,1034,"[11, 517, 57, 408, 192, 200, 0, 326, 436, 10, 211, 486, 129, 126, 423, 272, 289, 364, 496, 42, 443, 164, 509, 165, 476, 457, 336, 402, 96]"
23,6,5382,6893,4792,0,5240,142,"[15, 71, 55, 41, 33, 45, 0, 38, 63, 53, 23, 53, 22, 45, 62, 7, 14, 62, 52, 14, 12, 53, 0, 45, 12, 61, 31, 26, 65]"
24,6,6468,7131,4129,0,2049,4419,"[1719, 2209, 1931, 1659, 69, 320, 0, 1246, 164, 52, 1014, 535, 523, 1260, 747, 1523, 1200, 44, 761, 658, 1146, 2131, 1024, 1621, 691, 507, 1013, 477, 1383]"
25,6,5312,12,9429,0,5162,150,"[58, 75, 33, 55, 40, 28, 0, 9, 75, 66, 39, 6, 31, 6, 6, 44, 9, 51, 46, 44, 52, 5, 51, 60, 47, 58, 70, 40, 8]"
26,6,5680,5460,9649,0,1199,4481,"[1556, 2240, 893, 1493, 1903, 1502, 0, 543, 1900, 1010, 864, 1010, 2085, 1951, 1128, 610, 313, 1372, 1118, 1781, 1455, 1044, 2198, 1051, 132, 839, 1541, 1202, 1891]"
27,6,5582,5847,9384,0,2371,3211,"[1219, 1605, 204, 126, 1308, 1361, 0, 97, 909, 367, 1322, 318, 1514, 207, 950, 704, 698, 1231, 745, 1353, 700, 117, 981, 153, 711, 683, 1285, 728, 195]"
28,6,6893,5293,10000,984,2482,4411,"[1323, 2205, 2114, 1878, 763, 178, 0, 1427, 1630, 1800, 154, 1381, 1743, 695, 1478, 936, 1138, 1030, 2105, 174, 1206, 1503, 193, 746, 1694, 1776, 1506, 552, 1535]"
29,6,6559,5910,10000,649,1945,4614,"[1888, 2307, 1086, 2133, 519, 2029, 0, 74, 857, 2291, 535, 1229, 2251, 1996, 676, 410, 725, 1353, 1904, 1769, 727, 2242, 1273, 2077, 1633, 238, 1081, 167, 1083]"
30,6,6579,5254,10000,1325,702,5877,"[1757, 2938, 1276, 1693, 2595, 2745, 0, 36, 434, 2644, 748, 1127, 374, 2249, 116, 588, 2340, 644, 2600, 463, 614, 2876, 1237, 1586, 1952, 2452, 2487, 2836, 1318]"
31,6,5009,5214,9795,0,4051,958,"[147, 479, 349, 479, 409, 261, 0, 373, 67, 111, 309, 463, 172, 215, 341, 114, 405, 76, 432, 27, 28, 60, 43, 202, 164, 257, 434, 118, 341]"
32,6,5287,6791,8291,0,1858,3429,"[1299, 1714, 398, 1192, 96, 1456, 0, 585, 794, 1508, 1663, 429, 67, 208, 1597, 103, 1228, 1554, 1559, 1239, 1692, 761, 1330, 257, 477, 168, 1312, 400, 1035]"
33,6,6035,7057,7269,0,531,5504,"[1442, 2752, 1514, 2466, 2340, 1308, 0, 806, 20, 425, 76, 1669, 1458, 1623, 574, 2527, 726, 96, 1944, 1040, 659, 1604, 1871, 1657, 1459, 752, 2675, 1693, 2293]"
34,6,5871,7068,6072,0,862,5009,"[1794, 2504, 2299, 2138, 15, 398, 0, 950, 257, 2161, 476, 1295, 979, 718, 969, 1216, 1380, 922, 1673, 2156, 1323, 951, 2091, 163, 643, 1659, 1300, 783, 1410]"
35,6,6542,5677,6937,0,4067,2475,"[496, 1237, 706, 1221, 331, 747, 0, 385, 824, 59, 1168, 901, 618, 807, 508, 722, 690, 566, 109, 397, 561, 198, 1001, 200, 901, 413, 269, 812, 23]"
36,6,6675,6396,7216,0,1350,5325,"[2148, 2662, 623, 1774, 513, 1803, 0, 1830, 1583, 1753, 2628, 1538, 2424, 691, 1167, 2404, 352, 2541, 870, 284, 1506, 2142, 287, 1705, 2339, 163, 1007, 1850, 594]"
37,6,6263,5302,8177,0,142,6121,"[346, 3060, 586, 1459, 850, 1738, 0, 2391, 1525, 2971, 1924, 1225, 1802, 1788, 1387, 1070, 2420, 2821, 2570, 157, 2135, 487, 1721, 96, 165, 2462, 852, 2344, 568]"
38,6,5111,7351,5937,0,987,4124,"[1994, 2062, 1930, 843, 888, 558, 0, 1755, 425, 1157, 366, 120, 65, 389, 1443, 1876, 552, 1016, 1801, 187, 42, 287, 1298, 970, 131, 399, 1578, 995, 753]"
39,6,5406,5109,6234,0,3360,2046,"[173, 1023, 350, 801, 203, 979, 0, 948, 199, 918, 691, 423, 292, 667, 451, 549, 41, 527, 430, 995, 33, 105, 503, 401, 716, 785, 657, 387, 454]"
40,6,5161,5888,5507,0,454,4707,"[2219, 2353, 1014, 1737, 345, 47, 0, 227, 162, 1941, 826, 1482, 1016, 1260, 1143, 1025, 510, 2027, 2116, 288, 1062, 1294, 1019, 2220, 1322, 1569, 1699, 253, 79]"
41,6,5920,6574,4853,0,3553,2367,"[606, 1183, 970, 445, 488, 917, 0, 955, 206, 2, 715, 1045, 993, 465, 649, 680, 977, 424, 300, 1142, 770, 505, 731, 237, 553, 571, 15, 330, 566]"
42,6,6406,5381,5878,0,5237,1169,"[179, 584, 288, 235, 151, 391, 0, 426, 18, 375, 135, 130, 79, 560, 226, 164, 336, 240, 462, 281, 47, 35, 533, 198, 330, 469, 323, 504, 114]"
43,6,6887,6896,5869,0,702,6185,"[899, 3092, 2865, 2595, 872, 1880, 0, 2379, 3073, 1114, 1118, 2513, 444, 1221, 2145, 1134, 1425, 782, 2885, 70, 2389, 149, 2981, 1326, 2355, 831, 1184, 505, 1647]"
44,6,5737,6400,5206,0,5623,114,"[44, 57, 41, 29, 16, 49, 0, 40, 47, 23, 26, 32, 49, 7, 47, 48, 49, 45, 55, 22, 34, 6, 24, 27, 10, 14, 14, 40, 38]"
45,6,5952,6611,4547,0,258,5694,"[2094, 2847, 2142, 989, 490, 1855, 0, 1439, 1236, 1512, 1891, 356, 90, 1688, 1054, 1653, 2292, 2156, 2845, 1295, 1485, 819, 481, 2253, 1952, 1816, 65, 82, 1442]"
46,6,5460,2722,7285,0,5385,75,"[31, 37, 11, 30, 25, 22, 0, 6, 35, 2, 19, 3, 36, 21, 7, 14, 10, 30, 33, 12, 19, 20, 17, 34, 4, 6, 28, 14, 0]"
47,6,6385,6312,7358,0,1275,5110,"[1775, 2555, 2284, 524, 1644, 1909, 0, 1945, 1907, 1957, 1966, 1671, 554, 745, 499, 1432, 1255, 1877, 1251, 960, 603, 1607, 989, 1730, 2481, 1810, 1818, 2512, 1525]"
48,6,6063,6422,6999,0,393,5670,"[1975, 2835, 1926, 1108, 1795, 704, 0, 122, 754, 400, 784, 2237, 1684, 1664, 13, 2090, 1122, 1903, 761, 1462, 2410, 1545, 190, 2812, 810, 1323, 2112, 2674, 376]"
49,6,6770,6096,7673,0,2838,3932,"[1095, 1966, 759, 613, 320, 68, 0, 287, 185, 158, 927, 331, 614, 40, 1668, 126, 1126, 157, 1714, 625, 1873, 1771, 537, 1011, 1672, 408, 167, 836, 604]"
50,6,5902,6549,7026,0,599,5303,"[130, 2651, 2601, 4, 1759, 2330, 0, 270, 253, 1374, 94, 2606, 1955, 586, 1207, 2012, 977, 1254, 1495, 1851, 1183, 493, 2644, 234, 1256, 1734, 461, 1331, 580]"
51,6,5403,7289,5140,0,662,4741,"[816, 2370, 1303, 515, 2090, 428, 0, 2304, 934, 2105, 207, 1801, 1034, 1158, 1565, 2223, 2109, 1335, 1359, 890, 1681, 1828, 1749, 1042, 2097, 794, 22, 899, 2241]"
52,6,6179,6517,4802,0,5375,804,"[326, 402, 237, 107, 383, 388, 0, 187, 149, 67, 76, 112, 386, 234, 90, 21, 21, 210, 187, 324, 35, 116, 200, 86, 83, 45, 116, 22, 184]"
53,6,6445,5222,6025,0,2896,3549,"[242, 1774, 1204, 1237, 649, 583, 0, 1199, 68, 256, 1179, 485, 747, 852, 246, 296, 571, 522, 749, 932, 217, 1497, 1275, 869, 1018, 1047, 1713, 997, 685]"
54,6,6397,6533,5889,0,3881,2516,"[524, 1258, 1006, 938, 1034, 81, 0, 944, 1077, 1236, 374, 377, 759, 936, 677, 526, 746, 662, 890, 550, 477, 430, 1230, 1190, 904, 8, 0, 291, 367]"
55,6,5620,5451,6058,0,4355,1265,"[26, 632, 148, 547, 605, 370, 0, 389, 333, 71, 294, 204, 527, 314, 374, 231, 68, 215, 150, 560, 591, 382, 120, 383, 289, 554, 480, 544, 437]"
56,6,6709,7190,5577,0,2824,3885,"[5, 1942, 409, 464, 1436, 557, 0, 1412, 585, 1099, 499, 360, 983, 1563, 1097, 941, 971, 191, 1263, 1733, 285, 497, 681, 422, 873, 1580, 1596, 1296, 628]"
57,6,6546,5190,6933,0,4759,1787,"[374, 893, 9, 455, 509, 507, 0, 228, 199, 500, 258, 631, 498, 275, 783, 174, 30, 851, 466, 44, 549, 390, 612, 240, 253, 386, 218, 166, 513]"
58,6,6011,7254,5690,0,51,5960,"[1227, 2980, 1020, 755, 2962, 1645, 0, 2524, 2797, 561, 1237, 953, 795, 2158, 2801, 2009, 757, 516, 630, 1867, 2436, 752, 2441, 780, 2957, 344, 587, 2952, 2748]"
59,6,6275,6169,5796,0,3975,2300,"[342, 1150, 929, 826, 672, 791, 0, 246, 37, 860, 559, 864, 1026, 108, 26, 96, 328, 423, 975, 826, 484, 681, 99, 1122, 304, 570, 33, 661, 966]"
60,6,6500,5579,6717,0,3670,2830,"[200, 1415, 617, 387, 750, 211, 0, 119, 231, 524, 124, 152, 1262, 404, 146, 894, 77, 1384, 486, 1115, 352, 76, 533, 864, 1153, 1144, 741, 229, 967]"
61,6,5187,7192,4712,0,1070,4117,"[40, 2058, 1988, 1935, 1774, 1867, 0, 265, 1649, 4, 564, 1984, 1092, 1876, 1198, 1584, 1330, 905, 757, 1388, 617, 42, 441, 79, 890, 1679, 1601, 613, 638]"
62,6,6747,6310,5149,0,6298,449,"[165, 224, 211, 105, 92, 65, 0, 72, 105, 70, 53, 3, 31, 170, 119, 68, 95, 58, 79, 224, 26, 94, 35, 3, 84, 188, 40, 21, 146]"
63,6,5506,829,9826,0,1741,3765,"[1400, 1882, 1246, 231, 667, 1287, 0, 1602, 267, 1841, 777, 704, 450, 1084, 1667, 296, 107, 50, 1162, 1882, 1431, 1325, 1207, 563, 260, 329, 66, 316, 1374]"
64,6,5932,5923,9835,0,4228,1704,"[276, 852, 275, 766, 70, 609, 0, 416, 347, 178, 199, 698, 536, 642, 651, 337, 329, 313, 811, 291, 120, 100, 685, 391, 542, 365, 159, 271, 365]"
65,6,5511,7115,8231,0,5097,414,"[0, 207, 124, 40, 162, 8, 0, 149, 26, 174, 101, 199, 51, 62, 140, 113, 92, 142, 188, 116, 98, 187, 178, 112, 63, 129, 112, 146, 78]"
66,6,6381,6347,8265,0,3785,2596,"[101, 1298, 140, 604, 19, 469, 0, 738, 243, 773, 1098, 174, 798, 1024, 422, 933, 618, 1122, 646, 548, 538, 43, 1196, 932, 453, 1219, 307, 340, 679]"
67,6,6572,6155,8682,0,3066,3506,"[1302, 1753, 857, 861, 656, 509, 0, 234, 558, 252, 381, 257, 787, 602, 1122, 1312, 1665, 541, 1424, 123, 1377, 267, 141, 1090, 14, 1655, 106, 1192, 749]"
68,6,5999,5906,8775,0,4811,1188,"[401, 594, 351, 83, 502, 301, 0, 2, 337, 4, 101, 524, 198, 509, 32, 401, 285, 168, 205, 140, 337, 466, 387, 252, 354, 187, 262, 75, 36]"
69,6,5073,6262,7586,0,949,4124,"[238, 2062, 1516, 745, 19, 444, 0, 1331, 1917, 968, 1182, 1802, 1600, 1913, 1805, 44, 1525, 968, 944, 315, 1848, 411, 633, 45, 1682, 1371, 259, 1683, 1344]"
70,6,6536,6307,7815,0,6452,84,"[37, 42, 0, 26, 7, 40, 0, 33, 11, 5, 12, 15, 26, 42, 31, 32, 0, 15, 19, 24, 13, 26, 33, 24, 36, 21, 40, 40, 5]"
71,6,6082,6542,7355,0,2397,3685,"[942, 1842, 82, 1330, 925, 514, 0, 1549, 1540, 943, 158, 688, 1168, 1120, 1124, 1429, 1354, 1620, 230, 38, 550, 1082, 472, 318, 1491, 265, 1618, 1495, 1392]"
72,6,5412,6031,6736,0,1725,3687,"[1129, 1843, 576, 501, 1383, 163, 0, 1714, 1600, 1774, 1033, 1760, 1226, 744, 21, 761, 348, 168, 1818, 1393, 176, 1843, 821, 464, 176, 1587, 496, 671, 452]"
73,6,5716,5054,7398,0,101,5615,"[1606, 2807, 2677, 1876, 1437, 1160, 0, 1757, 480, 1351, 202, 2261, 1999, 2192, 985, 733, 774, 700, 1654, 2665, 493, 14, 565, 1614, 2086, 2031, 29, 1280, 2476]"
74,6,6670,6115,7953,0,2457,4213,"[1381, 2106, 23, 1550, 545, 1492, 0, 2079, 1921, 1974, 1782, 1954, 500, 1940, 835, 115, 191, 1964, 1721, 636, 1380, 497, 1426, 2088, 1102, 876, 1190, 1235, 842]"
75,6,5314,6219,7048,0,314,5000,"[679, 2500, 329, 129, 2355, 2009, 0, 885, 1156, 1647, 1459, 1103, 1104, 117, 954, 1618, 2462, 1217, 1055, 1356, 2200, 2187, 1622, 232, 2351, 188, 746, 1268, 2424]"
76,6,6742,5435,8355,0,4661,2081,"[467, 1040, 412, 857, 300, 417, 0, 385, 269, 322, 251, 367, 318, 278, 630, 476, 772, 369, 160, 364, 289, 553, 1021, 624, 905, 119, 202, 22, 553]"
77,6,6979,6729,8605,0,67,6912,"[319, 3456, 1016, 2263, 2451, 1071, 0, 1271, 1816, 3091, 2649, 251, 2092, 1672, 1382, 1892, 2660, 1137, 286, 525, 2475, 762, 3453, 433, 1037, 1551, 804, 30, 876]"
78,6,5617,6814,7408,0,2310,3307,"[535, 1653, 450, 1175, 694, 1361, 0, 1106, 1232, 1190, 1044, 835, 3, 961, 1380, 628, 505, 1282, 1538, 101, 1002, 570, 1181, 766, 320, 732, 481, 1001, 1027]"
79,6,5792,5081,8119,0,3970,1822,"[630, 911, 748, 346, 337, 546, 0, 497, 207, 71, 769, 437, 229, 750, 577, 553, 509, 845, 679, 132, 322, 792, 749, 312, 458, 319, 719, 256, 407]"
80,6,6904,6745,8278,0,2711,4193,"[934, 2096, 1238, 1490, 1568, 1828, 0, 1767, 789, 147, 1108, 142, 867, 1897, 1129, 1656, 233, 947, 220, 1218, 17, 208, 1975, 1347, 1537, 1477, 747, 198, 843]"
81,6,5477,6302,7453,0,3414,2063,"[500, 1031, 690, 358, 45, 760, 0, 907, 647, 306, 36, 507, 568, 894, 728, 617, 910, 238, 151, 336, 607, 188, 60, 585, 779, 793, 295, 567, 956]"
82,6,5301,7120,5634,0,1241,4060,"[461, 2030, 437, 1139, 1856, 898, 0, 453, 1856, 1724, 638, 1910, 271, 347, 1703, 1857, 708, 2014, 428, 540, 204, 1800, 1129, 1169, 550, 1976, 33, 1589, 607]"
83,6,5777,7420,3991,0,4190,1587,"[26, 793, 473, 489, 693, 282, 0, 204, 680, 75, 69, 390, 181, 547, 353, 778, 182, 697, 110, 657, 683, 253, 705, 427, 378, 445, 429, 37, 268]"
84,6,5757,1235,8513,0,1814,3943,"[476, 1971, 1080, 1747, 1378, 26, 0, 777, 1094, 1935, 1456, 768, 782, 104, 276, 850, 1024, 1097, 1953, 659, 123, 1729, 394, 685, 723, 1734, 50, 1938, 144]"
85,6,5401,6180,7734,0,3302,2099,"[698, 1049, 159, 1033, 736, 898, 0, 866, 807, 500, 518, 313, 250, 108, 585, 656, 269, 737, 514, 388, 934, 821, 852, 880, 178, 456, 1011, 736, 21]"
86,6,5579,5311,8002,0,2236,3343,"[32, 1671, 1361, 160, 1258, 961, 0, 1310, 162, 3, 1021, 872, 1103, 75, 1487, 1352, 1212, 404, 919, 1532, 202, 61, 605, 1160, 1363, 580, 291, 27, 1112]"
87,6,5432,6662,6772,0,1928,3504,"[321, 1752, 1119, 1242, 583, 1314, 0, 1080, 670, 1366, 448, 1679, 1515, 1640, 641, 1022, 723, 1738, 1193, 1281, 968, 1059, 263, 478, 527, 1136, 1502, 1260, 348]"
88,6,6986,7175,6583,0,5870,1116,"[552, 558, 259, 402, 144, 330, 0, 264, 116, 491, 434, 116, 263, 263, 237, 530, 145, 143, 504, 327, 45, 510, 73, 420, 229, 251, 522, 324, 251]"
89,6,5161,5555,6189,0,2216,2945,"[450, 1472, 1260, 503, 1082, 453, 0, 1273, 821, 1469, 205, 1311, 38, 1262, 1274, 1133, 664, 1264, 467, 350, 1052, 630, 270, 1314, 1182, 1173, 1008, 435, 456]"
90,6,6615,5751,7053,0,4419,2196,"[326, 1098, 597, 438, 505, 94, 0, 964, 1054, 630, 856, 37, 246, 670, 717, 736, 355, 67, 412, 522, 1048, 859, 351, 821, 475, 746, 732, 900, 177]"
91,6,5912,5203,7762,0,254,5658,"[1243, 2829, 2180, 1421, 2126, 1704, 0, 687, 2398, 734, 2105, 1991, 1248, 468, 544, 1314, 1823, 1624, 1639, 65, 1649, 1968, 1659, 1749, 2469, 416, 1236, 617, 1725]"
92,6,6413,6967,7208,0,5602,811,"[5, 405, 319, 371, 392, 251, 0, 149, 49, 281, 24, 311, 131, 108, 7, 299, 231, 69, 348, 119, 295, 327, 35, 265, 156, 233, 279, 345, 11]"
93,6,5646,6863,5991,0,4208,1438,"[169, 719, 495, 587, 207, 120, 0, 687, 282, 76, 665, 479, 377, 433, 274, 269, 360, 315, 5, 233, 664, 461, 288, 38, 636, 626, 692, 121, 533]"
94,6,6278,5809,6460,0,3896,2382,"[330, 1191, 1160, 962, 14, 978, 0, 579, 1156, 389, 871, 1147, 586, 79, 55, 747, 661, 285, 220, 908, 699, 999, 882, 958, 1026, 333, 669, 1142, 548]"
95,6,6382,7261,5581,0,5479,903,"[305, 451, 286, 121, 10, 376, 0, 244, 230, 138, 131, 115, 76, 240, 142, 75, 164, 380, 100, 219, 203, 246, 417, 403, 266, 327, 94, 324, 179]"
96,6,6837,6511,5907,0,1001,5836,"[510, 2918, 664, 2292, 1736, 2604, 0, 1470, 579, 2461, 1240, 1914, 2537, 232, 1417, 2514, 1183, 2812, 338, 2258, 834, 61, 515, 2371, 2885, 1312, 2310, 911, 2891]"
97,6,6792,5190,7509,0,5752,1040,"[291, 520, 508, 147, 21, 235, 0, 51, 269, 217, 45, 263, 364, 369, 212, 421, 392, 54, 73, 49, 259, 286, 450, 301, 130, 114, 128, 8, 264]"
98,6,5362,5283,7588,0,133,5229,"[801, 2614, 147, 209, 1856, 2114, 0, 2274, 1396, 2189, 2127, 2599, 176, 933, 2443, 2066, 1069, 2233, 1200, 2165, 1, 2497, 524, 1986, 1772, 2558, 676, 1842, 1057]"
99,6,5280,5167,7701,0,3913,1367,"[632, 683, 217, 27, 15, 35, 0, 376, 12, 216, 90, 197, 164, 571, 296, 398, 136, 31, 326, 54, 575, 610, 618, 417, 200, 341, 19, 337, 297]"
100,6,5119,6447,6373,0,2465,2654,"[1170, 1327, 707, 822, 922, 1160, 0, 927, 63, 19, 875, 1287, 517, 901, 1034, 488, 297, 50, 1122, 946, 824, 205, 110, 918, 611, 1002, 241, 1123, 831]"
101,6,6299,6231,6441,0,1008,5291,"[29, 2645, 1050, 2072, 2635, 2524, 0, 1122, 142, 151, 612, 258, 2488, 2175, 1874, 2546, 1830, 2529, 848, 251, 1781, 1431, 50, 2413, 2237, 1489, 279, 961, 483]"
102,6,5794,5472,6763,0,4327,1467,"[3, 733, 499, 479, 214, 224, 0, 265, 231, 702, 328, 687, 240, 603, 169, 709, 701, 658, 98, 200, 642, 601, 636, 724, 21, 611, 682, 581, 155]"
103,6,6488,5446,7805,0,3311,3177,"[590, 1588, 360, 1071, 463, 1034, 0, 526, 209, 1459, 919, 739, 622, 1099, 1007, 587, 1255, 1151, 1250, 1292, 907, 50, 1252, 922, 948, 1086, 796, 405, 913]"
104,6,6592,5312,9085,0,2544,4048,"[681, 2024, 884, 511, 931, 568, 0, 142, 1764, 1165, 347, 1638, 347, 2011, 45, 39, 90, 1452, 613, 60, 1674, 1050, 237, 543, 766, 153, 1906, 706, 1479]"
105,6,5336,5773,8648,0,4399,937,"[338, 468, 78, 61, 17, 188, 0, 175, 113, 449, 75, 431, 464, 73, 369, 102, 357, 127, 117, 468, 186, 331, 231, 224, 171, 296, 275, 114, 280]"
106,6,5576,6638,7586,0,4335,1241,"[142, 620, 144, 156, 620, 257, 0, 411, 289, 498, 471, 555, 602, 533, 39, 341, 556, 77, 177, 198, 79, 604, 410, 293, 511, 311, 226, 562, 559]"
107,6,5820,5702,7704,0,3739,2081,"[839, 1040, 975, 443, 502, 992, 0, 541, 760, 369, 403, 137, 742, 752, 594, 216, 328, 894, 485, 914, 891, 900, 1003, 612, 829, 967, 354, 180, 443]"
108,6,5182,6537,6349,0,3033,2149,"[20, 1074, 972, 762, 710, 480, 0, 892, 962, 141, 645, 204, 1060, 913, 587, 1059, 757, 707, 451, 16, 651, 980, 364, 372, 56, 211, 547, 126, 625]"
109,6,6957,5177,8129,0,4990,1967,"[366, 983, 898, 764, 614, 121, 0, 349, 781, 607, 924, 342, 655, 752, 577, 181, 174, 424, 970, 358, 202, 265, 551, 47, 365, 941, 429, 630, 360]"
110,6,6084,7429,6784,0,839,5245,"[1797, 2622, 1941, 1627, 148, 1344, 0, 2439, 1665, 237, 2578, 1089, 468, 230, 26, 2350, 1832, 1507, 2414, 2437, 2026, 2233, 1297, 1968, 793, 1836, 1235, 2228, 2309]"
111,6,5862,7213,5433,0,4459,1403,"[680, 701, 31, 645, 250, 472, 0, 180, 342, 516, 114, 216, 64, 93, 428, 441, 42, 548, 486, 86, 162, 342, 377, 617, 82, 650, 617, 510, 472]"
112,6,6219,5096,6556,0,2787,3432,"[755, 1716, 1294, 430, 1152, 1382, 0, 1554, 209, 68, 1580, 1584, 202, 205, 632, 976, 632, 1207, 1152, 439, 317, 97, 736, 827, 93, 1298, 536, 1350, 1408]"
113,6,6860,6257,7159,0,6075,785,"[115, 392, 181, 292, 98, 24, 0, 77, 174, 93, 148, 193, 367, 41, 168, 313, 116, 0, 307, 285, 99, 157, 62, 103, 298, 131, 86, 81, 217]"
114,6,6043,6560,6642,0,1469,4574,"[517, 2287, 433, 213, 1331, 237, 0, 400, 1163, 1478, 569, 1790, 1151, 316, 979, 2229, 1615, 1026, 1960, 2012, 1117, 1370, 582, 696, 686, 1198, 1955, 1937, 842]"
115,6,5471,6157,5956,0,3121,2350,"[1021, 1175, 659, 469, 886, 338, 0, 362, 1016, 416, 479, 956, 415, 209, 561, 542, 288, 770, 610, 163, 48, 652, 1106, 977, 774, 577, 770, 1094, 550]"
116,6,5994,6372,5578,0,4831,1163,"[85, 581, 319, 290, 555, 488, 0, 192, 526, 439, 287, 21, 89, 326, 505, 574, 540, 482, 309, 474, 434, 178, 83, 250, 48, 536, 464, 410, 272]"
117,6,5985,7488,4075,0,908,5077,"[1663, 2538, 2152, 2515, 1527, 289, 0, 332, 342, 937, 571, 688, 80, 973, 2534, 555, 114, 57, 1310, 9, 207, 297, 454, 529, 2378, 504, 361, 1697, 1750]"
118,6,6805,3757,7123,0,4228,2577,"[575, 1288, 111, 212, 464, 891, 0, 1081, 318, 799, 105, 662, 1217, 1081, 540, 771, 832, 655, 370, 1286, 290, 1024, 290, 179, 238, 744, 124, 152, 462]"
119,6,6181,5980,7324,0,5754,427,"[161, 213, 208, 125, 13, 35, 0, 41, 87, 39, 33, 95, 128, 212, 54, 155, 190, 172, 30, 96, 158, 179, 25, 34, 90, 199, 161, 132, 65]"
0,7,3257,0,3257,0,2235,1022,"[318, 157, 340, 29, 340, 194, 135, 0, 193, 279, 301, 73, 49, 201, 142, 137, 338, 1, 52, 177, 271, 98, 51, 212, 332, 125, 332, 32, 65]"
1,7,4559,3107,4709,0,4338,221,"[23, 20, 73, 1, 73, 47, 19, 0, 16, 67, 24, 4, 14, 61, 10, 14, 9, 0, 26, 16, 30, 7, 71, 48, 67, 58, 16, 59, 50]"
2,7,4447,3405,5751,0,1149,3298,"[883, 555, 1099, 418, 1099, 692, 119, 0, 23, 945, 4, 1029, 421, 120, 275, 471, 46, 485, 860, 275, 98, 908, 589, 1017, 952, 1007, 420, 313, 308]"
3,7,3044,253,8542,0,1574,1470,"[476, 164, 490, 392, 490, 438, 471, 0, 308, 303, 3, 145, 386, 428, 45, 252, 86, 349, 112, 457, 390, 357, 335, 270, 366, 468, 132, 160, 140]"
4,7,3749,7336,4955,0,728,3021,"[278, 698, 1007, 59, 1007, 974, 879, 0, 629, 934, 102, 572, 1, 568, 1002, 544, 366, 923, 174, 832, 862, 852, 25, 563, 946, 90, 772, 401, 358]"
5,7,4911,4893,4973,0,63,4848,"[805, 1425, 1616, 677, 1616, 1039, 372, 0, 181, 1334, 1276, 816, 1570, 1279, 700, 1295, 599, 308, 1344, 343, 1604, 40, 1573, 106, 1163, 914, 41, 774, 828]"
6,7,3285,1936,6322,0,1974,1311,"[17, 265, 437, 316, 437, 311, 278, 0, 425, 351, 338, 202, 61, 406, 72, 322, 198, 171, 324, 375, 260, 360, 200, 259, 141, 116, 281, 264, 232]"
7,7,3477,3000,6799,0,3203,274,"[3, 80, 91, 5, 91, 22, 53, 0, 74, 27, 1, 71, 85, 49, 9, 64, 5, 57, 40, 35, 75, 7, 32, 61, 13, 8, 63, 67, 49]"
8,7,3496,2907,7388,0,2986,510,"[0, 19, 170, 140, 170, 24, 130, 0, 2, 135, 170, 158, 109, 125, 160, 60, 118, 79, 160, 52, 92, 27, 41, 40, 158, 9, 70, 110, 144]"
9,7,4186,7418,4156,0,1958,2228,"[138, 216, 742, 689, 742, 629, 725, 0, 712, 97, 401, 67, 26, 589, 43, 227, 334, 694, 80, 272, 210, 633, 577, 548, 145, 181, 7, 684, 341]"
10,7,3170,2324,5002,0,244,2926,"[770, 382, 975, 137, 975, 795, 35, 0, 637, 34, 370, 360, 91, 524, 521, 778, 821, 126, 742, 260, 226, 94, 517, 160, 599, 632, 442, 31, 248]"
11,7,3194,853,7343,0,428,2766,"[530, 559, 922, 130, 922, 506, 338, 0, 701, 202, 553, 701, 748, 103, 33, 229, 17, 377, 437, 177, 708, 808, 289, 412, 653, 120, 206, 617, 469]"
12,7,3599,168,10000,774,1998,1601,"[496, 61, 533, 63, 533, 471, 267, 0, 414, 301, 225, 181, 406, 433, 140, 231, 480, 517, 179, 259, 182, 237, 322, 155, 343, 311, 42, 241, 79]"
13,7,3035,7035,6000,0,1999,1036,"[268, 165, 345, 332, 345, 338, 328, 0, 91, 4, 205, 45, 257, 216, 260, 283, 185, 189, 70, 211, 279, 314, 314, 60, 47, 246, 147, 338, 122]"
14,7,4249,4002,6247,0,3110,1139,"[166, 271, 379, 160, 379, 288, 352, 0, 220, 54, 358, 22, 302, 252, 147, 214, 193, 336, 266, 297, 9, 208, 363, 112, 118, 239, 369, 96, 211]"
15,7,4380,793,9834,0,3903,477,"[64, 47, 159, 145, 159, 142, 126, 0, 74, 7, 11, 99, 122, 54, 101, 44, 87, 22, 3, 115, 45, 6, 47, 155, 1, 39, 129, 98, 152]"
16,7,4452,5566,8720,0,2053,2399,"[423, 30, 799, 591, 799, 438, 595, 0, 469, 643, 671, 459, 424, 702, 500, 722, 402, 716, 409, 114, 789, 514, 139, 201, 334, 761, 105, 138, 452]"
17,7,3889,5094,7515,0,458,3431,"[818, 444, 1143, 1029, 1143, 278, 957, 0, 277, 272, 574, 794, 184, 936, 1073, 207, 767, 416, 246, 150, 976, 425, 388, 692, 814, 228, 243, 869, 654]"
18,7,4753,7116,5152,0,2643,2110,"[66, 239, 703, 39, 703, 14, 414, 0, 628, 420, 339, 655, 561, 393, 645, 594, 655, 435, 288, 467, 112, 531, 225, 134, 299, 546, 418, 110, 41]"
19,7,3753,1885,7020,0,567,3186,"[243, 737, 1062, 896, 1062, 4, 283, 0, 536, 236, 298, 589, 193, 112, 185, 567, 411, 140, 747, 781, 266, 839, 299, 165, 1034, 856, 408, 332, 984]"
20,7,4331,5146,6205,0,3205,1126,"[121, 183, 375, 340, 375, 94, 149, 0, 215, 281, 141, 135, 222, 233, 248, 34, 48, 53, 47, 247, 265, 75, 356, 140, 126, 135, 80, 154, 8]"
21,7,4832,5054,5983,0,2890,1942,"[476, 64, 647, 526, 647, 602, 133, 0, 292, 413, 365, 337, 390, 408, 297, 50, 328, 587, 334, 186, 173, 611, 535, 369, 486, 221, 416, 126, 388]"
22,7,3756,232,9507,0,3046,710,"[127, 151, 236, 100, 236, 159, 84, 0, 60, 221, 231, 159, 166, 94, 166, 192, 147, 180, 190, 54, 106, 197, 102, 187, 113, 125, 202, 60, 89]"
23,7,4362,6195,7674,0,2898,1464,"[476, 238, 488, 447, 488, 71, 126, 0, 39, 44, 116, 121, 313, 20, 357, 312, 30, 133, 372, 312, 246, 430, 132, 189, 394, 287, 267, 142, 87]"
24,7,4953,6981,5646,0,1345,3608,"[768, 691, 1202, 557, 1202, 172, 127, 0, 812, 413, 1018, 145, 877, 118, 871, 785, 1152, 55, 915, 1117, 211, 656, 550, 431, 946, 626, 1001, 464, 722]"
25,7,4127,1034,8739,0,2057,2070,"[268, 556, 690, 688, 690, 322, 482, 0, 493, 272, 626, 571, 620, 672, 386, 538, 649, 53, 307, 100, 51, 67, 367, 128, 285, 372, 654, 230, 389]"
26,7,4657,6556,6840,0,3397,1260,"[127, 82, 420, 325, 420, 59, 310, 0, 66, 340, 373, 340, 394, 163, 383, 55, 30, 244, 169, 28, 385, 345, 266, 196, 288, 232, 65, 191, 391]"
27,7,4391,5797,5434,0,2176,2215,"[277, 348, 738, 485, 738, 301, 291, 0, 284, 298, 366, 450, 252, 308, 226, 389, 144, 567, 294, 527, 63, 579, 38, 534, 340, 368, 82, 22, 526]"
28,7,4079,1122,8391,0,1918,2161,"[9, 464, 720, 122, 720, 23, 198, 0, 217, 283, 241, 608, 499, 567, 438, 225, 308, 578, 714, 264, 644, 462, 511, 209, 475, 363, 356, 163, 444]"
29,7,3422,7283,4530,0,2252,1170,"[118, 266, 390, 42, 390, 325, 217, 0, 134, 137, 352, 247, 360, 154, 193, 303, 170, 351, 207, 79, 105, 292, 199, 289, 0, 344, 299, 107, 103]"
30,7,3960,3061,5429,0,319,3641,"[541, 500, 1213, 413, 1213, 773, 1013, 0, 954, 700, 442, 1049, 849, 580, 1015, 714, 493, 181, 655, 120, 1206, 885, 523, 843, 39, 652, 446, 926, 1193]"
31,7,4912,2047,8294,0,3668,1244,"[10, 82, 414, 200, 414, 40, 259, 0, 394, 311, 101, 60, 275, 258, 67, 233, 154, 101, 291, 372, 264, 406, 138, 308, 361, 149, 370, 169, 354]"
32,7,4976,5985,7285,0,909,4067,"[979, 592, 1355, 1333, 1355, 437, 1030, 0, 504, 385, 260, 123, 1212, 815, 1152, 1309, 932, 1167, 370, 357, 617, 323, 1011, 1341, 419, 1206, 893, 38, 167]"
33,7,3616,3486,7415,0,1680,1936,"[538, 124, 645, 153, 645, 525, 12, 0, 63, 643, 463, 198, 518, 286, 431, 221, 476, 451, 453, 57, 358, 157, 457, 455, 411, 42, 412, 288, 419]"
34,7,4389,6829,4975,0,3140,1249,"[72, 322, 416, 107, 416, 199, 49, 0, 279, 326, 218, 185, 191, 373, 33, 251, 316, 316, 188, 174, 288, 45, 259, 60, 55, 167, 272, 270, 21]"
35,7,3404,2270,6109,0,2146,1258,"[150, 126, 419, 14, 419, 274, 301, 0, 210, 370, 66, 266, 18, 351, 336, 50, 93, 331, 69, 39, 101, 185, 321, 148, 394, 173, 13, 82, 4]"
36,7,3714,2412,7411,0,1607,2107,"[168, 515, 702, 263, 702, 578, 224, 0, 75, 422, 442, 566, 604, 335, 561, 162, 210, 210, 450, 382, 236, 215, 597, 422, 30, 612, 692, 36, 55]"
37,7,4148,6164,5395,0,485,3663,"[383, 1187, 1221, 178, 1221, 724, 680, 0, 297, 386, 1117, 427, 176, 494, 775, 1217, 971, 67, 264, 104, 1088, 773, 564, 422, 545, 536, 287, 128, 289]"
38,7,3243,616,8022,0,16,3227,"[783, 83, 1075, 1043, 1075, 222, 527, 0, 826, 1058, 379, 875, 53, 752, 440, 761, 664, 873, 372, 628, 137, 763, 793, 319, 433, 541, 667, 397, 777]"
39,7,4776,6692,6106,0,2026,2750,"[906, 842, 916, 805, 916, 794, 803, 0, 552, 72, 420, 85, 56, 273, 271, 844, 818, 188, 524, 164, 201, 643, 469, 592, 502, 747, 78, 865, 834]"
40,7,4670,4,10000,772,3705,965,"[113, 316, 321, 312, 321, 204, 286, 0, 147, 128, 91, 266, 266, 134, 279, 232, 62, 103, 118, 171, 316, 108, 253, 34, 151, 88, 84, 291, 119]"
41,7,3668,7035,6633,0,2280,1388,"[182, 166, 462, 420, 462, 135, 173, 0, 48, 60, 298, 195, 109, 210, 49, 86, 20, 104, 294, 336, 460, 24, 422, 135, 299, 375, 410, 288, 19]"
42,7,3267,2738,7162,0,608,2659,"[851, 296, 886, 874, 886, 652, 545, 0, 199, 344, 610, 543, 560, 854, 876, 317, 886, 426, 446, 64, 4, 694, 361, 171, 229, 417, 10, 632, 357]"
43,7,4491,6418,5235,0,3507,984,"[13, 20, 328, 267, 328, 79, 60, 0, 311, 18, 141, 142, 314, 165, 27, 43, 134, 307, 66, 151, 274, 73, 301, 146, 162, 291, 264, 41, 171]"
44,7,4853,1911,8177,0,3986,867,"[223, 67, 289, 21, 289, 118, 186, 0, 153, 289, 18, 204, 149, 260, 8, 55, 286, 114, 26, 258, 0, 12, 33, 203, 15, 23, 248, 57, 80]"
45,7,4488,6698,5967,0,4177,311,"[14, 63, 103, 98, 103, 90, 87, 0, 103, 77, 87, 82, 95, 22, 97, 97, 6, 61, 75, 58, 13, 4, 85, 13, 47, 35, 20, 15, 68]"
46,7,3925,3268,6624,0,2923,1002,"[13, 316, 334, 321, 334, 42, 296, 0, 106, 184, 261, 25, 107, 100, 125, 15, 75, 255, 148, 311, 152, 309, 146, 111, 317, 7, 248, 216, 179]"
47,7,3276,287,9613,0,3056,220,"[67, 72, 73, 33, 73, 34, 49, 0, 7, 11, 14, 58, 66, 35, 30, 36, 43, 21, 52, 36, 49, 60, 5, 13, 24, 60, 1, 34, 26]"
48,7,4624,5066,9171,0,1666,2958,"[229, 914, 986, 440, 986, 601, 318, 0, 606, 120, 518, 673, 696, 817, 641, 671, 646, 751, 750, 746, 915, 687, 40, 951, 556, 368, 554, 898, 523]"
49,7,4524,5216,8479,0,3545,979,"[272, 230, 326, 291, 326, 204, 1, 0, 198, 98, 270, 216, 38, 269, 62, 273, 296, 147, 143, 200, 20, 38, 62, 244, 139, 131, 316, 147, 294]"
50,7,4494,6151,6822,0,3663,831,"[99, 10, 277, 101, 277, 196, 90, 0, 98, 32, 128, 179, 122, 10, 204, 97, 120, 199, 75, 17, 76, 82, 74, 96, 173, 18, 186, 28, 127]"
51,7,3677,3499,7000,0,536,3141,"[877, 558, 1047, 128, 1047, 397, 723, 0, 81, 916, 277, 992, 122, 615, 944, 373, 903, 983, 799, 568, 973, 398, 994, 435, 183, 1044, 774, 448, 1020]"
52,7,3561,1400,9161,0,254,3307,"[893, 714, 1102, 266, 1102, 494, 363, 0, 191, 1004, 401, 740, 498, 528, 584, 669, 154, 582, 394, 162, 761, 640, 90, 421, 764, 336, 412, 1072, 175]"
53,7,4799,6316,7644,0,3311,1488,"[64, 214, 496, 198, 496, 182, 267, 0, 255, 347, 197, 403, 389, 317, 187, 148, 188, 284, 98, 471, 181, 455, 416, 493, 172, 289, 61, 280, 119]"
54,7,4147,5984,5807,0,3654,493,"[140, 9, 164, 44, 164, 100, 119, 0, 126, 151, 78, 38, 123, 66, 26, 30, 117, 160, 56, 58, 65, 108, 28, 39, 138, 113, 55, 29, 115]"
55,7,3077,738,8146,0,1873,1204,"[102, 39, 401, 221, 401, 248, 237, 0, 209, 158, 397, 145, 174, 247, 387, 42, 274, 30, 125, 82, 240, 128, 328, 258, 189, 208, 316, 111, 305]"
56,7,3108,5392,5862,0,2693,415,"[116, 93, 138, 56, 138, 66, 0, 0, 33, 103, 20, 78, 57, 107, 80, 108, 11, 111, 62, 45, 118, 121, 58, 63, 60, 49, 110, 100, 46]"
57,7,4683,3757,6788,0,623,4060,"[164, 866, 1353, 314, 1353, 1110, 394, 0, 1059, 888, 785, 1064, 354, 67, 602, 856, 449, 788, 839, 74, 316, 828, 617, 594, 479, 516, 24, 1143, 73]"
58,7,4598,7098,4288,0,4204,394,"[130, 36, 131, 75, 131, 91, 44, 0, 15, 107, 97, 43, 110, 21, 123, 19, 40, 13, 109, 59, 17, 55, 0, 84, 64, 103, 43, 87, 113]"
59,7,3746,2819,5215,0,1103,2643,"[341, 656, 881, 528, 881, 101, 564, 0, 778, 86, 763, 543, 67, 299, 171, 768, 117, 745, 110, 80, 560, 354, 506, 154, 661, 575, 11, 144, 842]"
60,7,3381,3289,5307,0,3287,94,"[27, 12, 31, 26, 31, 28, 13, 0, 26, 7, 1, 22, 12, 2, 25, 29, 17, 9, 20, 4, 10, 16, 20, 7, 2, 29, 16, 28, 25]"
61,7,4413,4059,5661,0,2501,1912,"[171, 498, 637, 505, 637, 511, 556, 0, 473, 343, 220, 203, 93, 265, 97, 387, 283, 593, 437, 102, 271, 478, 234, 581, 535, 625, 49, 534, 540]"
62,7,4779,420,10000,20,398,4381,"[903, 633, 1460, 59, 1460, 634, 584, 0, 224, 568, 1421, 725, 307, 604, 505, 658, 818, 1113, 441, 15, 1443, 1143, 291, 1199, 1211, 302, 572, 84, 1111]"
63,7,3612,6648,6964,0,1125,2487,"[731, 748, 829, 389, 829, 105, 481, 0, 33, 818, 505, 625, 449, 79, 25, 727, 537, 593, 219, 438, 603, 172, 215, 457, 284, 451, 467, 117, 418]"
64,7,4290,6528,4726,0,1503,2787,"[229, 680, 929, 566, 929, 603, 185, 0, 848, 679, 422, 271, 228, 326, 889, 675, 727, 371, 52, 55, 269, 788, 328, 485, 102, 24, 243, 152, 489]"
65,7,3767,2459,6034,0,1884,1883,"[556, 596, 627, 133, 627, 272, 346, 0, 404, 382, 547, 616, 13, 55, 45, 490, 531, 476, 329, 202, 305, 404, 556, 186, 365, 454, 408, 618, 347]"
66,7,3598,3460,6172,0,723,2875,"[151, 136, 958, 180, 958, 436, 803, 0, 608, 779, 639, 654, 148, 876, 424, 552, 278, 599, 480, 886, 169, 55, 643, 875, 870, 291, 109, 410, 382]"
67,7,4917,6898,4191,0,4714,203,"[60, 46, 67, 39, 67, 31, 60, 0, 25, 14, 5, 24, 26, 65, 55, 42, 19, 36, 50, 8, 65, 6, 35, 25, 3, 61, 59, 39, 50]"
68,7,3624,2369,5446,0,1213,2411,"[43, 615, 803, 79, 803, 12, 11, 0, 752, 91, 761, 85, 209, 405, 169, 21, 687, 299, 334, 689, 590, 621, 320, 356, 636, 131, 96, 431, 791]"
69,7,3051,2687,5810,0,816,2235,"[405, 621, 745, 139, 745, 387, 534, 0, 518, 481, 196, 166, 228, 364, 2, 65, 628, 373, 306, 452, 85, 717, 412, 127, 343, 257, 35, 614, 50]"
70,7,3001,0,8811,0,2172,829,"[258, 260, 276, 187, 276, 166, 8, 0, 203, 204, 165, 60, 269, 43, 132, 15, 206, 193, 159, 11, 52, 215, 247, 116, 35, 151, 14, 208, 13]"
71,7,3683,6667,5827,0,759,2924,"[294, 754, 974, 809, 974, 742, 666, 0, 125, 63, 318, 426, 375, 623, 588, 568, 304, 289, 847, 263, 165, 922, 696, 100, 853, 572, 318, 909, 892]"
72,7,4314,3704,6437,0,2649,1665,"[204, 222, 555, 29, 555, 22, 447, 0, 306, 204, 127, 291, 551, 106, 141, 320, 535, 49, 152, 147, 337, 38, 222, 209, 543, 207, 241, 144, 2]"
73,7,3120,1977,7580,0,111,3009,"[329, 484, 1003, 359, 1003, 150, 943, 0, 245, 465, 130, 375, 730, 720, 941, 277, 757, 58, 123, 39, 606, 574, 453, 969, 197, 979, 675, 802, 772]"
74,7,3087,296,10000,371,399,2688,"[702, 803, 896, 108, 896, 446, 19, 0, 331, 66, 181, 649, 860, 502, 85, 27, 886, 319, 700, 852, 560, 806, 804, 390, 821, 871, 67, 228, 240]"
75,7,3132,7238,5894,0,1714,1418,"[264, 113, 472, 413, 472, 275, 23, 0, 307, 137, 342, 283, 454, 239, 395, 65, 101, 197, 158, 179, 266, 64, 173, 192, 131, 360, 11, 302, 406]"
76,7,4557,2793,7658,0,2345,2212,"[510, 651, 737, 441, 737, 672, 516, 0, 523, 390, 388, 409, 664, 31, 310, 159, 660, 724, 390, 637, 594, 333, 14, 710, 381, 123, 422, 444, 155]"
77,7,3389,7203,3844,0,409,2980,"[250, 612, 993, 12, 993, 798, 615, 0, 618, 268, 985, 319, 915, 237, 713, 803, 877, 65, 791, 957, 88, 452, 254, 607, 682, 603, 751, 483, 611]"
78,7,4788,1093,7539,0,1448,3340,"[149, 1056, 1113, 149, 1113, 325, 366, 0, 411, 247, 302, 167, 745, 56, 964, 1047, 75, 638, 455, 473, 288, 936, 1075, 800, 1067, 1093, 333, 609, 234]"
79,7,4901,6034,6406,0,3765,1136,"[343, 348, 378, 134, 378, 124, 242, 0, 223, 133, 265, 102, 23, 358, 37, 102, 224, 104, 319, 48, 200, 133, 243, 191, 107, 113, 240, 177, 139]"
80,7,3153,2217,7342,0,2921,232,"[19, 73, 77, 12, 77, 76, 40, 0, 56, 66, 35, 27, 69, 26, 35, 39, 3, 73, 65, 48, 2, 57, 26, 11, 44, 69, 37, 41, 39]"
81,7,4758,6944,5156,0,4089,669,"[165, 185, 223, 75, 223, 98, 211, 0, 121, 42, 182, 168, 212, 77, 210, 34, 111, 99, 172, 161, 73, 171, 154, 35, 116, 186, 102, 87, 128]"
82,7,4326,2491,6991,0,156,4170,"[1330, 117, 1390, 302, 1390, 475, 453, 0, 414, 191, 1233, 568, 586, 341, 986, 1331, 1307, 988, 139, 1375, 782, 727, 898, 1354, 90, 28, 757, 512, 507]"
83,7,4242,6556,4677,0,4207,35,"[5, 0, 11, 0, 11, 0, 4, 0, 2, 6, 8, 7, 0, 11, 8, 10, 1, 2, 2, 5, 4, 4, 0, 8, 10, 4, 1, 4, 1]"
84,7,3879,1889,6667,0,3488,391,"[103, 124, 130, 67, 130, 63, 86, 0, 33, 44, 66, 9, 65, 24, 31, 112, 130, 126, 89, 119, 59, 114, 96, 100, 93, 52, 15, 53, 112]"
85,7,3333,1450,8550,0,492,2841,"[277, 44, 947, 730, 947, 619, 22, 0, 562, 434, 497, 750, 473, 283, 464, 854, 916, 115, 352, 751, 404, 673, 902, 118, 35, 541, 481, 632, 827]"
86,7,3439,5007,6982,0,3312,127,"[24, 7, 42, 33, 42, 20, 14, 0, 18, 24, 14, 8, 37, 30, 28, 7, 23, 6, 20, 40, 29, 20, 1, 16, 16, 6, 36, 2, 41]"
87,7,4080,5868,5194,0,3740,340,"[70, 70, 113, 75, 113, 37, 12, 0, 103, 80, 77, 46, 74, 31, 45, 49, 92, 73, 29, 91, 25, 1, 33, 5, 108, 83, 18, 88, 33]"
88,7,3084,680,7598,0,2093,991,"[38, 61, 330, 161, 330, 152, 320, 0, 255, 48, 220, 245, 9, 237, 92, 249, 199, 215, 316, 134, 90, 105, 124, 47, 164, 88, 182, 272, 247]"
89,7,3417,7394,3621,0,2878,539,"[160, 92, 179, 34, 179, 94, 42, 0, 161, 159, 153, 174, 75, 29, 52, 97, 37, 41, 109, 10, 11, 23, 97, 165, 166, 159, 141, 175, 33]"
90,7,4991,3475,5137,0,3267,1724,"[478, 54, 574, 125, 574, 414, 103, 0, 42, 180, 505, 330, 226, 416, 352, 275, 287, 302, 445, 516, 109, 115, 118, 265, 541, 541, 412, 186, 434]"
91,7,4034,1912,7259,0,2725,1309,"[286, 314, 436, 154, 436, 164, 249, 0, 284, 184, 218, 257, 302, 238, 320, 56, 324, 332, 312, 26, 399, 107, 42, 389, 246, 350, 197, 230, 203]"
92,7,4994,7474,4779,0,2316,2678,"[112, 123, 892, 661, 892, 374, 1, 0, 654, 705, 590, 174, 654, 779, 148, 237, 562, 814, 202, 630, 93, 433, 44, 361, 887, 507, 876, 28, 191]"
93,7,3479,227,8031,0,2275,1204,"[302, 368, 401, 166, 401, 361, 249, 0, 288, 68, 297, 217, 24, 364, 358, 190, 0, 117, 243, 262, 119, 109, 308, 42, 161, 292, 65, 3, 289]"
94,7,4939,6459,6511,0,4780,159,"[42, 2, 53, 28, 53, 12, 14, 0, 17, 8, 43, 1, 32, 5, 5, 50, 14, 20, 36, 30, 33, 28, 43, 13, 38, 25, 35, 50, 37]"
95,7,4196,2216,8491,0,1143,3053,"[603, 627, 1017, 245, 1017, 798, 118, 0, 853, 774, 650, 131, 152, 323, 371, 842, 338, 13, 129, 118, 76, 490, 661, 89, 511, 276, 633, 1002, 128]"
96,7,3496,6801,5186,0,61,3435,"[547, 166, 1145, 684, 1145, 140, 75, 0, 833, 1075, 87, 304, 121, 544, 383, 567, 266, 312, 780, 829, 632, 840, 274, 830, 110, 1089, 892, 716, 338]"
97,7,4887,2086,7987,0,2491,2396,"[394, 713, 798, 358, 798, 178, 178, 0, 754, 189, 653, 318, 759, 116, 596, 501, 464, 675, 425, 103, 661, 540, 400, 450, 5, 600, 633, 765, 726]"
98,7,4909,6561,6335,0,3693,1216,"[278, 161, 405, 28, 405, 275, 140, 0, 137, 343, 152, 197, 120, 332, 295, 130, 281, 366, 252, 246, 8, 158, 13, 94, 377, 346, 72, 103, 360]"
99,7,4561,936,9960,0,426,4135,"[1242, 815, 1378, 1298, 1378, 553, 759, 0, 990, 792, 448, 834, 387, 709, 990, 484, 459, 264, 1264, 171, 789, 1060, 313, 125, 674, 669, 715, 503, 1070]"
100,7,4134,7114,6980,0,3261,873,"[167, 78, 291, 2, 291, 279, 268, 0, 100, 254, 116, 60, 18, 178, 29, 57, 104, 118, 73, 229, 71, 136, 19, 194, 290, 36, 217, 59, 50]"
101,7,4266,7412,3834,0,183,4083,"[249, 133, 1361, 111, 1361, 554, 988, 0, 908, 127, 3, 274, 1210, 937, 1129, 1212, 898, 114, 281, 982, 1308, 734, 1271, 853, 842, 263, 605, 961, 110]"
102,7,4504,2348,5990,0,1774,2730,"[265, 735, 910, 849, 910, 865, 373, 0, 822, 114, 702, 115, 868, 538, 536, 650, 69, 422, 832, 836, 411, 640, 214, 58, 755, 462, 672, 74, 164]"
103,7,3746,162,9574,0,896,2850,"[845, 816, 950, 106, 950, 893, 204, 0, 235, 311, 634, 194, 607, 665, 426, 379, 282, 154, 198, 660, 624, 787, 885, 92, 68, 542, 263, 775, 524]"
104,7,4320,6822,7072,0,2530,1790,"[147, 368, 596, 501, 596, 516, 509, 0, 223, 582, 596, 474, 470, 470, 235, 489, 427, 466, 175, 339, 462, 179, 66, 364, 567, 313, 89, 106, 141]"
105,7,4019,5496,5595,0,1221,2798,"[187, 193, 932, 606, 932, 312, 396, 0, 399, 66, 401, 780, 491, 366, 395, 697, 587, 828, 323, 618, 256, 477, 31, 52, 607, 840, 231, 643, 927]"
106,7,4618,483,9730,0,2886,1732,"[546, 23, 577, 156, 577, 536, 302, 0, 390, 222, 206, 352, 148, 509, 130, 12, 102, 430, 49, 302, 237, 436, 427, 506, 345, 318, 247, 477, 279]"
107,7,4767,6686,7811,0,2530,2237,"[710, 669, 745, 419, 745, 524, 431, 0, 479, 252, 27, 552, 182, 332, 102, 398, 284, 249, 238, 387, 18, 57, 362, 94, 30, 499, 307, 105, 25]"
108,7,4277,5026,7062,0,1825,2452,"[630, 713, 817, 510, 817, 533, 34, 0, 240, 462, 441, 267, 470, 182, 456, 191, 301, 389, 479, 309, 794, 168, 728, 364, 86, 69, 580, 451, 292]"
109,7,4058,5136,5984,0,3477,581,"[52, 105, 193, 126, 193, 174, 188, 0, 193, 51, 38, 126, 182, 118, 174, 54, 123, 98, 60, 0, 99, 16, 20, 50, 35, 1, 6, 17, 33]"
110,7,3564,3134,6414,0,549,3015,"[560, 957, 1005, 193, 1005, 364, 208, 0, 320, 542, 297, 201, 848, 13, 648, 26, 853, 340, 195, 725, 124, 677, 196, 139, 433, 242, 321, 205, 48]"
111,7,3323,896,8841,0,1816,1507,"[420, 352, 502, 350, 502, 343, 341, 0, 494, 393, 125, 347, 282, 45, 185, 425, 284, 443, 378, 171, 382, 124, 53, 188, 215, 399, 183, 267, 332]"
112,7,4217,6684,6374,0,2182,2035,"[478, 39, 678, 500, 678, 274, 95, 0, 316, 408, 212, 406, 133, 175, 205, 263, 503, 118, 73, 360, 448, 574, 379, 25, 314, 237, 411, 49, 150]"
113,7,4218,3747,6845,0,2326,1892,"[16, 441, 630, 422, 630, 359, 41, 0, 188, 3, 53, 502, 443, 276, 378, 272, 614, 420, 404, 375, 562, 326, 577, 476, 149, 158, 88, 439, 626]"
114,7,3072,2350,7567,0,296,2776,"[491, 338, 925, 864, 925, 295, 823, 0, 480, 418, 357, 363, 44, 191, 665, 682, 269, 720, 748, 562, 266, 552, 776, 529, 548, 14, 903, 789, 561]"
115,7,4468,6924,5111,0,3593,875,"[255, 128, 291, 168, 291, 121, 135, 0, 91, 127, 35, 10, 140, 118, 91, 59, 15, 183, 116, 275, 164, 207, 79, 79, 50, 179, 266, 45, 217]"
116,7,3678,2377,6412,0,3060,618,"[170, 126, 206, 68, 206, 18, 75, 0, 55, 118, 80, 95, 39, 122, 168, 41, 171, 178, 25, 66, 162, 96, 3, 120, 194, 137, 77, 56, 25]"
117,7,4172,980,9604,0,3101,1071,"[115, 275, 357, 196, 357, 340, 91, 0, 234, 34, 185, 67, 148, 309, 126, 209, 330, 134, 73, 5, 147, 331, 325, 301, 256, 19, 42, 47, 286]"
118,7,4624,6737,7491,0,1677,2947,"[225, 691, 982, 941, 982, 182, 636, 0, 847, 68, 751, 25, 754, 807, 781, 244, 506, 180, 307, 390, 596, 695, 802, 236, 539, 246, 634, 875, 273]"
119,7,4002,6423,5070,0,3398,604,"[104, 27, 201, 133, 201, 14, 176, 0, 61, 12, 111, 80, 104, 153, 46, 70, 38, 115, 3, 201, 94, 94, 63, 153, 194, 135, 168, 149, 197]"
0,8,5372,0,5372,0,3053,2319,"[205, 508, 753, 154, 295, 333, 150, 349, 0, 773, 470, 28, 57, 664, 621, 773, 109, 194, 660, 198, 52, 550, 340, 185, 744, 294, 309, 439, 539]"
1,8,6619,6124,5867,0,1649,4970,"[1577, 1267, 42, 813, 1040, 999, 885, 774, 0, 1656, 687, 1024, 665, 897, 235, 1656, 317, 1229, 449, 162, 354, 1350, 864, 502, 834, 283, 1635, 414, 372]"
2,8,5138,7466,3539,0,4252,886,"[68, 263, 43, 273, 38, 201, 197, 164, 0, 295, 230, 206, 115, 178, 287, 295, 47, 2, 193, 193, 6, 221, 228, 67, 264, 160, 16, 201, 71]"
3,8,6242,5049,4732,0,5421,821,"[254, 207, 220, 23, 228, 144, 41, 118, 0, 273, 152, 262, 254, 1, 101, 273, 186, 90, 20, 216, 67, 257, 253, 6, 163, 82, 109, 22, 35]"
4,8,5120,660,9192,0,1132,3988,"[480, 824, 347, 469, 613, 81, 749, 680, 0, 1329, 399, 834, 1289, 490, 1293, 1329, 469, 225, 716, 456, 650, 896, 361, 88, 875, 457, 201, 1000, 936]"
5,8,6741,5312,10000,621,3587,3154,"[1017, 766, 884, 448, 482, 516, 362, 286, 0, 1051, 1038, 461, 758, 347, 526, 1051, 20, 398, 678, 820, 711, 18, 760, 772, 667, 990, 861, 608, 972]"
6,8,6234,5975,10000,259,2006,4228,"[277, 944, 743, 134, 432, 1091, 1389, 953, 0, 1409, 1210, 967, 840, 1142, 460, 1409, 1152, 947, 788, 858, 384, 190, 1011, 1179, 1298, 1162, 902, 282, 1359]"
7,8,6198,6657,9541,0,5028,1170,"[372, 12, 127, 342, 212, 164, 45, 207, 0, 390, 208, 363, 150, 18, 348, 390, 309, 119, 120, 79, 195, 130, 4, 82, 1, 264, 166, 205, 14]"
8,8,5963,6827,8677,0,79,5884,"[580, 193, 173, 568, 472, 727, 1091, 1672, 0, 1961, 723, 1618, 889, 1648, 527, 1961, 240, 7, 354, 154, 794, 51, 1244, 1061, 1034, 1365, 588, 374, 157]"
9,8,6165,6150,8692,0,510,5655,"[1267, 203, 309, 1389, 411, 200, 89, 285, 0, 1885, 589, 1292, 1276, 27, 390, 1885, 672, 935, 1844, 128, 905, 712, 1302, 176, 608, 475, 543, 1599, 42]"
10,8,5036,5282,8446,0,3726,1310,"[340, 399, 428, 350, 283, 395, 262, 130, 0, 436, 35, 410, 384, 218, 201, 436, 2, 63, 112, 248, 32, 309, 128, 383, 393, 266, 341, 95, 14]"
11,8,5805,6696,7555,0,5203,602,"[21, 23, 57, 21, 54, 156, 107, 169, 0, 200, 165, 44, 28, 169, 181, 200, 135, 105, 9, 60, 49, 72, 34, 45, 189, 194, 156, 90, 198]"
12,8,5183,5873,6865,0,79,5104,"[820, 544, 812, 143, 1306, 1249, 1653, 831, 0, 1701, 1353, 1125, 854, 348, 912, 1701, 1666, 189, 612, 693, 1021, 883, 918, 1250, 666, 781, 774, 202, 1687]"
13,8,5299,5669,6495,0,1811,3488,"[142, 743, 130, 1001, 349, 318, 32, 1032, 0, 1162, 109, 338, 522, 777, 924, 1162, 37, 626, 455, 404, 758, 264, 824, 176, 617, 805, 6, 739, 224]"
14,8,5875,5933,6437,0,4202,1673,"[392, 64, 409, 510, 231, 507, 332, 517, 0, 557, 526, 235, 39, 521, 432, 557, 228, 41, 389, 423, 66, 157, 363, 312, 539, 273, 72, 380, 315]"
15,8,6468,5435,7470,0,1805,4663,"[559, 1241, 247, 45, 767, 561, 534, 1532, 0, 1554, 50, 798, 605, 977, 1228, 1554, 1336, 89, 372, 1468, 245, 149, 1459, 1333, 949, 80, 708, 706, 926]"
16,8,6944,5015,9399,0,2604,4340,"[1399, 110, 768, 230, 1321, 1349, 1134, 803, 0, 1446, 1173, 388, 376, 662, 1314, 1446, 154, 66, 976, 253, 294, 622, 65, 914, 182, 7, 1111, 58, 325]"
17,8,6472,5283,10000,588,4617,1855,"[33, 29, 390, 468, 141, 345, 83, 89, 0, 618, 15, 351, 514, 322, 208, 618, 458, 263, 333, 185, 610, 51, 409, 576, 376, 587, 225, 604, 495]"
18,8,6201,5885,10000,316,1922,4279,"[915, 1044, 542, 1363, 155, 697, 79, 1334, 0, 1426, 1372, 1043, 300, 610, 966, 1426, 140, 665, 1363, 169, 634, 382, 360, 915, 375, 420, 1280, 1358, 273]"
19,8,5898,6745,9153,0,685,5213,"[715, 1002, 506, 1223, 884, 1324, 1330, 657, 0, 1737, 1412, 1433, 201, 177, 397, 1737, 932, 1697, 612, 607, 442, 664, 1371, 1201, 1485, 839, 1281, 675, 462]"
20,8,5414,6828,7739,0,4791,623,"[24, 123, 14, 23, 46, 80, 65, 45, 0, 207, 8, 130, 91, 114, 112, 207, 157, 77, 139, 37, 206, 15, 174, 157, 4, 127, 171, 155, 46]"
21,8,5458,5549,7648,0,4366,1092,"[261, 99, 111, 121, 32, 358, 364, 103, 0, 364, 344, 257, 263, 113, 350, 364, 181, 176, 302, 38, 30, 342, 31, 190, 97, 86, 150, 108, 168]"
22,8,5014,5563,7099,0,2018,2996,"[71, 587, 109, 558, 672, 929, 397, 905, 0, 998, 173, 945, 607, 853, 790, 998, 346, 37, 875, 905, 208, 695, 586, 931, 228, 31, 771, 751, 97]"
23,8,5860,6703,6256,0,2038,3822,"[912, 433, 1172, 79, 1182, 14, 421, 837, 0, 1274, 890, 232, 179, 924, 837, 1274, 144, 436, 988, 1022, 1265, 404, 802, 976, 1142, 187, 1093, 180, 1016]"
24,8,6513,6741,6028,0,5839,674,"[119, 59, 107, 162, 36, 134, 163, 141, 0, 224, 17, 167, 171, 109, 111, 224, 33, 7, 137, 211, 45, 132, 115, 154, 100, 32, 54, 218, 220]"
25,8,5087,7043,4072,0,2311,2776,"[703, 470, 341, 39, 771, 293, 388, 562, 0, 925, 363, 277, 585, 376, 768, 925, 669, 390, 150, 911, 148, 106, 718, 455, 633, 387, 742, 251, 448]"
26,8,5589,1325,8336,0,2885,2704,"[596, 446, 205, 833, 459, 592, 829, 523, 0, 901, 723, 104, 434, 570, 407, 901, 245, 106, 721, 116, 149, 764, 707, 119, 338, 826, 499, 817, 656]"
27,8,5723,5395,8664,0,4179,1544,"[148, 136, 189, 460, 11, 414, 274, 196, 0, 514, 346, 111, 91, 487, 308, 514, 138, 326, 209, 48, 219, 130, 466, 233, 125, 499, 359, 449, 416]"
28,8,6904,7490,8078,0,3653,3251,"[265, 544, 280, 1005, 83, 584, 355, 743, 0, 1083, 158, 775, 449, 534, 1024, 1083, 961, 1011, 93, 780, 834, 551, 241, 662, 444, 907, 756, 712, 434]"
29,8,6573,5365,9286,0,2089,4484,"[207, 712, 1390, 170, 1196, 773, 1051, 734, 0, 1494, 382, 1358, 1008, 1049, 1273, 1494, 1490, 971, 635, 1007, 622, 1437, 1265, 992, 613, 824, 1128, 825, 749]"
30,8,6142,5568,9860,0,2247,3895,"[21, 787, 1093, 405, 893, 1050, 1082, 72, 0, 1298, 334, 377, 1101, 1059, 260, 1298, 1251, 1005, 897, 901, 778, 493, 299, 754, 217, 1031, 880, 168, 96]"
31,8,5718,7273,8305,0,1906,3812,"[1029, 694, 523, 157, 242, 884, 887, 847, 0, 1270, 655, 100, 675, 1166, 998, 1270, 1145, 410, 488, 324, 319, 425, 904, 809, 1257, 292, 808, 1200, 302]"
32,8,6937,5623,9619,0,5921,1016,"[227, 26, 115, 316, 332, 243, 1, 47, 0, 338, 224, 311, 135, 49, 324, 338, 278, 42, 90, 87, 96, 49, 138, 67, 309, 170, 24, 231, 244]"
33,8,5046,6378,8287,0,1557,3489,"[447, 1144, 1090, 901, 792, 1111, 208, 946, 0, 1163, 894, 122, 905, 135, 403, 1163, 1112, 37, 149, 679, 371, 747, 721, 1069, 372, 328, 320, 2, 1064]"
34,8,6153,5333,9107,0,943,5210,"[1231, 1270, 1489, 988, 648, 579, 11, 635, 0, 1736, 1130, 1212, 1633, 36, 1407, 1736, 1142, 1214, 317, 1680, 1180, 239, 862, 150, 724, 1083, 1396, 937, 345]"
35,8,5870,5763,9214,0,2035,3835,"[890, 1114, 818, 907, 285, 493, 972, 76, 0, 1278, 344, 546, 826, 435, 210, 1278, 740, 714, 598, 827, 420, 462, 57, 498, 547, 490, 985, 1120, 896]"
36,8,5570,7217,7567,0,3626,1944,"[179, 521, 487, 84, 244, 357, 212, 20, 0, 648, 323, 501, 129, 622, 182, 648, 16, 19, 241, 265, 514, 197, 365, 200, 361, 22, 577, 457, 145]"
37,8,5672,5467,7772,0,4029,1643,"[376, 498, 302, 132, 519, 301, 289, 276, 0, 547, 323, 480, 146, 364, 160, 547, 371, 68, 351, 355, 227, 72, 412, 471, 161, 164, 113, 276, 277]"
38,8,5458,6995,6235,0,957,4501,"[1252, 361, 659, 1306, 1342, 759, 1232, 287, 0, 1500, 228, 47, 189, 394, 520, 1500, 374, 1391, 29, 466, 1011, 817, 1046, 932, 680, 121, 690, 932, 959]"
39,8,6453,6506,6182,0,769,5684,"[1463, 1804, 1394, 1148, 660, 1496, 1815, 46, 0, 1894, 699, 1204, 1315, 359, 1769, 1894, 890, 345, 763, 892, 1241, 608, 434, 1378, 1050, 1056, 894, 702, 447]"
40,8,5740,6672,5250,0,2363,3377,"[972, 877, 623, 857, 573, 655, 628, 951, 0, 1125, 862, 1038, 479, 325, 829, 1125, 114, 949, 627, 809, 32, 867, 320, 834, 136, 109, 315, 468, 1047]"
41,8,6581,6946,4885,0,3331,3250,"[299, 801, 682, 504, 79, 1066, 1030, 608, 0, 1083, 684, 729, 1028, 501, 458, 1083, 222, 899, 215, 961, 105, 541, 475, 266, 163, 605, 674, 768, 68]"
42,8,6599,6289,5195,0,3930,2669,"[363, 731, 309, 360, 797, 847, 123, 158, 0, 889, 69, 830, 793, 405, 591, 889, 101, 526, 552, 475, 208, 501, 33, 118, 691, 213, 504, 37, 350]"
43,8,5140,1006,9329,0,3825,1315,"[175, 231, 421, 392, 320, 126, 268, 292, 0, 438, 311, 16, 32, 6, 197, 438, 65, 138, 297, 153, 77, 123, 52, 361, 281, 221, 159, 236, 216]"
44,8,6760,6234,9855,0,1887,4873,"[1596, 1021, 1313, 1202, 129, 1267, 1058, 52, 0, 1624, 1260, 598, 1224, 804, 1108, 1624, 261, 79, 1338, 165, 1086, 711, 1032, 1292, 750, 469, 137, 1021, 1095]"
45,8,6278,5227,10000,906,350,5928,"[506, 1107, 1245, 328, 525, 117, 1634, 281, 0, 1976, 1549, 191, 302, 1770, 63, 1976, 1305, 1520, 31, 658, 197, 606, 821, 603, 336, 201, 1626, 1905, 127]"
46,8,6330,6283,10000,47,6018,312,"[59, 45, 24, 40, 69, 31, 13, 56, 0, 104, 98, 56, 103, 103, 25, 104, 92, 68, 14, 91, 71, 35, 27, 15, 82, 10, 103, 7, 1]"
47,8,6875,6138,10000,737,1725,5150,"[173, 326, 1443, 932, 905, 691, 1287, 804, 0, 1716, 1212, 954, 563, 803, 1410, 1716, 111, 1453, 197, 337, 952, 1320, 1155, 695, 647, 1097, 1144, 1455, 624]"
48,8,6713,6171,10000,542,52,6661,"[511, 2163, 1629, 2061, 1872, 783, 1627, 636, 0, 2220, 1257, 1946, 752, 528, 2026, 2220, 2097, 1866, 342, 1956, 222, 1610, 1629, 2009, 1286, 769, 744, 1914, 527]"
49,8,6646,5088,10000,1558,2882,3764,"[591, 1072, 591, 776, 510, 424, 976, 326, 0, 1254, 1187, 1145, 93, 146, 857, 1254, 466, 440, 267, 62, 177, 69, 576, 269, 671, 386, 1092, 1009, 364]"
50,8,5574,7021,8553,0,4404,1170,"[260, 113, 23, 259, 273, 3, 343, 227, 0, 390, 61, 248, 149, 3, 113, 390, 223, 317, 374, 298, 191, 109, 329, 277, 32, 48, 373, 306, 197]"
51,8,6788,5486,9855,0,5432,1356,"[156, 10, 387, 155, 296, 1, 428, 267, 0, 452, 121, 404, 286, 301, 201, 452, 147, 155, 373, 238, 25, 41, 381, 415, 332, 352, 231, 276, 35]"
52,8,5016,6717,8154,0,3690,1326,"[204, 32, 19, 162, 201, 166, 416, 384, 0, 442, 394, 118, 91, 12, 263, 442, 215, 154, 87, 22, 48, 409, 413, 229, 423, 371, 240, 167, 198]"
53,8,5741,6522,7373,0,4777,964,"[257, 109, 254, 68, 252, 257, 135, 117, 0, 321, 309, 174, 254, 160, 266, 321, 169, 109, 189, 145, 135, 51, 175, 53, 306, 47, 291, 109, 237]"
54,8,6504,7147,6730,0,6162,342,"[31, 84, 98, 88, 88, 51, 73, 40, 0, 114, 0, 98, 55, 33, 6, 114, 83, 80, 67, 78, 90, 41, 83, 46, 104, 105, 73, 73, 61]"
55,8,5617,5525,6822,0,1553,4064,"[982, 1077, 58, 809, 724, 821, 466, 105, 0, 1354, 614, 974, 1079, 928, 1234, 1354, 412, 937, 1228, 921, 71, 1303, 646, 710, 1146, 414, 785, 1309, 388]"
56,8,5023,5911,5934,0,3515,1508,"[34, 151, 133, 119, 187, 47, 296, 390, 0, 502, 399, 382, 464, 38, 46, 502, 431, 86, 186, 66, 445, 39, 118, 397, 302, 397, 178, 381, 484]"
57,8,5776,7401,4309,0,1470,4306,"[1070, 1215, 711, 1366, 1379, 1350, 1320, 902, 0, 1435, 538, 666, 1263, 1025, 1368, 1435, 640, 895, 1289, 1275, 1358, 1192, 1278, 1113, 376, 1325, 425, 208, 848]"
58,8,6263,1067,9505,0,1348,4915,"[58, 1057, 823, 871, 722, 1584, 105, 35, 0, 1638, 1286, 530, 1034, 300, 910, 1638, 304, 1173, 1240, 136, 1440, 1421, 1520, 56, 1141, 770, 455, 1450, 1288]"
59,8,6409,5098,10000,816,184,6225,"[182, 1356, 971, 1829, 622, 1676, 2056, 149, 0, 2075, 516, 2070, 798, 1698, 1204, 2075, 2061, 1862, 772, 1304, 645, 1030, 778, 1331, 1382, 217, 952, 91, 775]"
60,8,5260,5461,9799,0,4005,1255,"[98, 394, 312, 94, 119, 358, 360, 408, 0, 418, 2, 24, 362, 118, 345, 418, 286, 284, 131, 0, 97, 214, 70, 153, 369, 144, 174, 369, 203]"
61,8,5017,5612,9204,0,4786,231,"[56, 59, 36, 17, 3, 8, 35, 10, 0, 77, 70, 1, 48, 12, 68, 77, 41, 7, 38, 36, 18, 17, 6, 48, 62, 28, 20, 70, 9]"
62,8,6152,6099,9257,0,2188,3964,"[1104, 1270, 801, 1203, 771, 842, 481, 783, 0, 1321, 626, 378, 233, 1248, 1137, 1321, 241, 842, 166, 336, 27, 1213, 14, 26, 317, 139, 375, 78, 898]"
63,8,6656,6488,9425,0,804,5852,"[1916, 703, 1148, 847, 418, 139, 1027, 1183, 0, 1950, 1705, 464, 1839, 214, 1662, 1950, 912, 1004, 571, 1866, 1050, 948, 1689, 286, 1364, 1805, 836, 1536, 1478]"
64,8,5232,5220,9437,0,831,4401,"[74, 1105, 365, 769, 1390, 571, 1453, 28, 0, 1467, 773, 1261, 77, 102, 1427, 1467, 534, 801, 866, 102, 446, 431, 230, 433, 905, 1418, 1402, 446, 910]"
65,8,6708,5963,10000,182,2870,3838,"[998, 575, 108, 516, 753, 844, 87, 656, 0, 1279, 603, 1154, 1262, 544, 849, 1279, 852, 751, 32, 820, 919, 646, 1221, 57, 91, 575, 963, 287, 1124]"
66,8,6792,5588,10000,1204,5899,893,"[221, 51, 266, 72, 91, 136, 253, 87, 0, 297, 278, 246, 108, 295, 257, 297, 8, 239, 236, 60, 57, 35, 124, 12, 282, 237, 212, 183, 45]"
67,8,5406,7035,8371,0,4907,499,"[126, 103, 96, 112, 92, 60, 162, 11, 0, 166, 110, 166, 33, 17, 96, 166, 4, 15, 108, 93, 35, 88, 39, 154, 146, 161, 119, 159, 29]"
68,8,6571,6847,8095,0,2550,4021,"[941, 787, 1086, 329, 886, 307, 1051, 38, 0, 1340, 630, 809, 1081, 1219, 925, 1340, 841, 1328, 819, 1206, 1064, 508, 848, 775, 627, 1157, 316, 836, 555]"
69,8,6792,6190,8697,0,437,6355,"[2112, 725, 985, 2090, 8, 1716, 946, 1955, 0, 2118, 1490, 892, 1138, 992, 1657, 2118, 835, 1842, 474, 875, 1541, 1137, 26, 1805, 1432, 923, 1551, 815, 1541]"
70,8,6363,6396,8664,0,2362,4001,"[121, 559, 843, 404, 545, 463, 393, 600, 0, 1333, 887, 831, 1209, 715, 948, 1333, 87, 713, 1314, 1082, 997, 40, 1201, 1029, 1073, 529, 116, 1057, 1190]"
71,8,6273,5406,9531,0,5089,1184,"[342, 371, 254, 132, 237, 111, 116, 322, 0, 394, 58, 217, 372, 328, 368, 394, 315, 363, 265, 244, 342, 14, 229, 141, 273, 382, 99, 50, 359]"
72,8,5331,5524,9338,0,4828,503,"[61, 153, 111, 34, 10, 97, 80, 70, 0, 167, 104, 27, 37, 24, 87, 167, 89, 150, 129, 102, 149, 141, 114, 87, 81, 17, 68, 63, 139]"
73,8,6108,7111,8335,0,4966,1142,"[164, 288, 347, 350, 272, 350, 361, 120, 0, 380, 168, 202, 263, 59, 291, 380, 116, 355, 109, 354, 241, 307, 18, 66, 356, 363, 317, 345, 180]"
74,8,6726,5998,9063,0,5836,890,"[234, 25, 18, 9, 31, 133, 172, 238, 0, 296, 55, 184, 5, 236, 76, 296, 176, 256, 115, 11, 61, 149, 32, 103, 191, 57, 235, 3, 86]"
75,8,5895,6593,8365,0,4797,1098,"[365, 333, 101, 273, 170, 248, 64, 334, 0, 366, 166, 315, 110, 256, 251, 366, 238, 144, 269, 124, 259, 147, 304, 349, 243, 222, 197, 134, 212]"
76,8,5412,6464,7313,0,2589,2823,"[334, 98, 211, 757, 564, 41, 927, 135, 0, 941, 674, 243, 302, 592, 799, 941, 858, 913, 613, 207, 253, 69, 848, 824, 918, 807, 528, 707, 601]"
77,8,6899,5749,8463,0,4321,2578,"[603, 467, 62, 745, 226, 341, 469, 84, 0, 859, 706, 356, 96, 634, 744, 859, 75, 40, 480, 750, 360, 46, 693, 749, 358, 118, 15, 388, 817]"
78,8,6907,5024,10000,346,3006,3901,"[686, 1148, 689, 720, 210, 760, 1122, 944, 0, 1300, 503, 220, 1113, 793, 98, 1300, 493, 539, 843, 1100, 517, 827, 999, 306, 1111, 601, 252, 69, 327]"
79,8,5258,6124,9134,0,5144,114,"[7, 5, 9, 4, 11, 16, 6, 17, 0, 38, 15, 36, 11, 35, 30, 38, 11, 10, 33, 30, 23, 37, 2, 30, 18, 28, 19, 19, 3]"
80,8,5391,6972,7553,0,3495,1896,"[198, 131, 522, 531, 191, 11, 14, 298, 0, 632, 617, 79, 344, 274, 431, 632, 373, 32, 58, 213, 422, 247, 579, 539, 352, 167, 202, 606, 418]"
81,8,5520,6061,7012,0,5007,513,"[117, 99, 7, 54, 61, 121, 26, 72, 0, 171, 60, 29, 93, 147, 63, 171, 65, 160, 151, 132, 102, 87, 111, 126, 131, 15, 141, 71, 74]"
82,8,5336,6266,6082,0,4781,555,"[66, 23, 59, 75, 63, 185, 107, 114, 0, 185, 63, 13, 166, 156, 160, 185, 177, 144, 80, 15, 57, 134, 0, 102, 80, 15, 143, 36, 64]"
83,8,6338,5807,6613,0,4665,1673,"[449, 95, 450, 224, 97, 4, 521, 244, 0, 557, 68, 394, 507, 302, 329, 557, 186, 39, 78, 140, 122, 459, 486, 263, 31, 502, 504, 57, 222]"
84,8,6482,6111,6984,0,4930,1552,"[85, 396, 324, 371, 403, 281, 183, 420, 0, 517, 0, 86, 89, 54, 56, 517, 57, 286, 117, 198, 262, 430, 124, 227, 254, 453, 378, 1, 95]"
85,8,5213,5492,6705,0,3644,1569,"[269, 219, 161, 469, 496, 505, 111, 443, 0, 523, 383, 312, 111, 520, 382, 523, 122, 289, 154, 21, 29, 384, 385, 211, 17, 317, 157, 472, 139]"
86,8,6798,6821,6682,0,442,6356,"[199, 1340, 1909, 629, 558, 64, 794, 829, 0, 2118, 1245, 1475, 1179, 409, 1915, 2118, 296, 1998, 1188, 305, 1359, 456, 1986, 1518, 689, 1411, 238, 1202, 1495]"
87,8,6638,5669,7651,0,6364,274,"[56, 30, 2, 65, 27, 25, 25, 72, 0, 91, 84, 22, 9, 89, 10, 91, 88, 49, 59, 25, 37, 60, 16, 47, 58, 57, 61, 89, 37]"
88,8,5715,6052,7314,0,737,4978,"[566, 1266, 1648, 375, 636, 372, 164, 1565, 0, 1659, 430, 713, 604, 1451, 1380, 1659, 431, 1525, 630, 60, 1608, 1259, 690, 661, 426, 1050, 293, 998, 474]"
89,8,5280,7468,5126,0,5123,157,"[13, 51, 37, 17, 19, 21, 30, 12, 0, 52, 4, 31, 46, 24, 5, 52, 31, 30, 7, 47, 12, 3, 45, 34, 7, 39, 32, 26, 13]"
90,8,5349,4574,5901,0,113,5236,"[889, 1483, 1438, 271, 1273, 869, 451, 1262, 0, 1745, 333, 145, 221, 389, 1042, 1745, 1161, 988, 324, 167, 104, 244, 1711, 1678, 1582, 1590, 22, 453, 1151]"
91,8,5627,5541,5987,0,2573,3054,"[104, 233, 510, 746, 289, 156, 567, 993, 0, 1018, 252, 592, 24, 289, 188, 1018, 237, 496, 353, 181, 362, 445, 556, 971, 345, 330, 306, 143, 580]"
92,8,5224,5575,5636,0,4078,1146,"[49, 169, 157, 278, 84, 265, 154, 143, 0, 382, 165, 221, 173, 299, 333, 382, 165, 87, 289, 143, 102, 273, 74, 348, 181, 74, 229, 174, 274]"
93,8,5408,6818,4226,0,532,4876,"[1595, 402, 1144, 1186, 249, 729, 1153, 736, 0, 1625, 418, 1562, 1492, 1227, 1551, 1625, 1516, 549, 1110, 161, 851, 944, 99, 1325, 256, 1286, 1319, 379, 1605]"
94,8,5200,162,9264,0,2781,2419,"[58, 161, 59, 303, 488, 190, 72, 277, 0, 806, 403, 186, 341, 92, 250, 806, 301, 773, 284, 589, 639, 435, 548, 659, 208, 582, 402, 445, 473]"
95,8,6831,6990,9105,0,1508,5323,"[273, 41, 1054, 975, 1626, 1126, 1105, 677, 0, 1774, 1100, 602, 539, 1722, 791, 1774, 1156, 844, 429, 93, 114, 358, 132, 633, 1204, 341, 936, 1139, 523]"
96,8,5167,6814,7458,0,2491,2676,"[318, 114, 774, 55, 680, 420, 278, 181, 0, 892, 772, 874, 15, 603, 487, 892, 299, 297, 154, 724, 356, 783, 164, 493, 737, 664, 350, 97, 189]"
97,8,6363,7413,6408,0,4550,1813,"[348, 57, 405, 118, 93, 465, 63, 450, 0, 604, 583, 590, 173, 56, 158, 604, 461, 447, 525, 309, 156, 319, 507, 84, 560, 565, 45, 455, 499]"
98,8,5258,6410,5256,0,4746,512,"[149, 143, 123, 100, 143, 158, 114, 165, 0, 170, 133, 26, 142, 36, 22, 170, 87, 56, 2, 5, 63, 123, 17, 142, 62, 35, 155, 38, 139]"
99,8,6866,6942,5180,0,5516,1350,"[218, 299, 114, 80, 132, 128, 296, 61, 0, 450, 163, 64, 98, 171, 450, 450, 99, 395, 293, 340, 24, 339, 157, 134, 156, 205, 290, 126, 93]"
100,8,5675,3454,7401,0,4956,719,"[101, 189, 167, 211, 169, 141, 95, 124, 0, 239, 31, 41, 60, 231, 43, 239, 17, 69, 13, 1, 83, 65, 175, 140, 0, 84, 225, 44, 49]"
101,8,5010,6520,5891,0,1079,3931,"[498, 254, 220, 613, 752, 520, 819, 196, 0, 1310, 1111, 430, 311, 679, 197, 1310, 1069, 649, 1161, 1241, 1159, 1188, 1293, 893, 86, 1272, 421, 1029, 962]"
102,8,5795,5290,6396,0,4922,873,"[28, 189, 153, 56, 260, 109, 175, 267, 0, 291, 178, 83, 266, 123, 28, 291, 281, 5, 289, 246, 23, 265, 138, 217, 116, 81, 57, 42, 237]"
103,8,5126,5741,5781,0,291,4835,"[838, 1422, 1168, 598, 551, 1554, 325, 1312, 0, 1611, 39, 1443, 1282, 1325, 27, 1611, 1495, 263, 252, 624, 845, 390, 1159, 377, 680, 487, 53, 774, 1271]"
104,8,5213,1842,9152,0,399,4814,"[251, 1099, 539, 1325, 651, 41, 482, 1586, 0, 1604, 1497, 422, 1596, 33, 54, 1604, 1380, 734, 1536, 1302, 313, 1256, 240, 1524, 102, 472, 1195, 816, 1273]"
105,8,6234,7145,8241,0,4644,1590,"[119, 236, 482, 479, 276, 409, 376, 132, 0, 530, 514, 299, 121, 255, 53, 530, 110, 379, 190, 67, 185, 113, 70, 417, 76, 479, 25, 351, 228]"
106,8,5060,5061,8240,0,1892,3168,"[393, 742, 279, 643, 983, 55, 191, 405, 0, 1056, 42, 835, 1054, 226, 1026, 1056, 732, 678, 556, 945, 1024, 1016, 212, 803, 1042, 835, 71, 598, 402]"
107,8,6687,5848,9079,0,2765,3922,"[500, 730, 839, 268, 365, 686, 76, 448, 0, 1307, 20, 129, 849, 501, 1118, 1307, 1193, 57, 1053, 473, 190, 117, 764, 51, 1237, 1203, 646, 126, 549]"
108,8,5352,5062,9369,0,1963,3389,"[810, 538, 1015, 902, 164, 306, 397, 539, 0, 1129, 772, 725, 831, 608, 1127, 1129, 374, 399, 1094, 481, 583, 159, 238, 262, 54, 904, 181, 248, 1029]"
109,8,6575,5739,10000,205,102,6473,"[676, 869, 578, 994, 1814, 1777, 99, 280, 0, 2157, 1172, 1268, 1721, 11, 2020, 2157, 1441, 1720, 1753, 166, 1355, 983, 831, 1516, 1875, 2081, 197, 669, 1576]"
110,8,5483,7379,8104,0,4373,1110,"[114, 106, 75, 6, 46, 343, 72, 348, 0, 370, 8, 334, 283, 318, 294, 370, 231, 152, 246, 58, 206, 8, 214, 360, 23, 140, 27, 267, 348]"
111,8,5907,5532,8479,0,4096,1811,"[257, 143, 490, 42, 529, 474, 39, 226, 0, 603, 414, 205, 493, 127, 574, 603, 310, 462, 471, 481, 14, 40, 361, 297, 352, 213, 411, 545, 330]"
112,8,5526,5552,8453,0,1580,3946,"[1010, 1137, 975, 123, 1152, 675, 147, 388, 0, 1315, 1314, 631, 478, 1015, 383, 1315, 1100, 1066, 440, 523, 1124, 1309, 154, 229, 724, 588, 636, 448, 974]"
113,8,6636,6231,8858,0,3516,3120,"[674, 268, 755, 543, 971, 902, 32, 412, 0, 1040, 598, 386, 927, 23, 98, 1040, 809, 21, 333, 690, 326, 819, 507, 334, 231, 34, 551, 702, 3]"
114,8,5782,5167,9473,0,1345,4437,"[705, 1371, 1301, 141, 917, 326, 390, 89, 0, 1479, 581, 1045, 166, 582, 721, 1479, 1272, 1175, 1285, 1427, 276, 467, 671, 538, 193, 1136, 1129, 866, 773]"
115,8,5941,7327,8087,0,5704,237,"[68, 76, 74, 24, 71, 39, 9, 0, 0, 79, 38, 71, 51, 23, 46, 79, 65, 72, 56, 62, 12, 0, 46, 26, 64, 76, 47, 50, 16]"
116,8,6139,6564,7662,0,2751,3388,"[504, 239, 34, 123, 753, 159, 420, 51, 0, 1129, 194, 655, 752, 143, 1017, 1129, 983, 421, 636, 354, 1032, 439, 856, 720, 21, 641, 521, 236, 303]"
117,8,5517,5154,8025,0,5212,305,"[37, 49, 4, 10, 39, 23, 71, 21, 0, 101, 20, 29, 23, 2, 41, 101, 96, 70, 89, 4, 54, 83, 87, 12, 30, 33, 42, 98, 56]"
118,8,5416,6222,7219,0,2480,2936,"[683, 336, 257, 130, 68, 416, 974, 436, 0, 978, 761, 5, 546, 799, 471, 978, 749, 484, 322, 410, 70, 872, 634, 79, 601, 851, 584, 383, 551]"
119,8,6237,5838,7618,0,4739,1498,"[259, 382, 388, 85, 400, 322, 44, 382, 0, 499, 310, 418, 429, 223, 399, 499, 79, 438, 457, 491, 286, 151, 183, 53, 351, 154, 159, 416, 367]"
0,9,6212,0,6212,0,5088,1124,"[73, 108, 336, 170, 46, 254, 300, 274, 374, 0, 194, 48, 371, 313, 232, 374, 348, 174, 295, 272, 190, 366, 324, 149, 159, 322, 268, 22, 312]"
1,9,5889,5151,6950,0,760,5129,"[1195, 1203, 294, 607, 190, 104, 560, 1222, 1709, 0, 446, 235, 32, 69, 1188, 1709, 913, 28, 440, 1325, 647, 308, 1681, 147, 170, 1214, 542, 341, 515]"
2,9,5598,5380,7168,0,129,5469,"[882, 1764, 944, 109, 1536, 1244, 881, 1268, 1823, 0, 277, 1137, 850, 1713, 983, 1823, 1738, 906, 1391, 1269, 1000, 688, 28, 1053, 1083, 1795, 1220, 88, 143]"
3,9,5003,6086,6085,0,788,4215,"[28, 538, 943, 186, 219, 1058, 1385, 749, 1405, 0, 970, 677, 819, 853, 1066, 1405, 334, 983, 1062, 912, 1020, 534, 47, 256, 854, 823, 956, 1011, 79]"
4,9,6130,6572,5643,0,5219,911,"[142, 76, 44, 295, 81, 28, 166, 8, 303, 0, 156, 157, 231, 200, 36, 303, 236, 169, 148, 108, 232, 161, 147, 36, 177, 159, 112, 133, 69]"
5,9,6691,6304,6030,0,6182,509,"[58, 2, 142, 133, 136, 151, 149, 103, 169, 0, 90, 99, 40, 0, 23, 169, 160, 31, 34, 1, 82, 67, 168, 97, 46, 84, 154, 13, 3]"
6,9,6013,6231,5812,0,4050,1963,"[172, 244, 612, 335, 369, 140, 215, 539, 654, 0, 295, 616, 546, 608, 547, 654, 537, 69, 496, 98, 505, 629, 289, 9, 317, 33, 468, 165, 394]"
7,9,6224,6320,5716,0,1179,5045,"[124, 411, 1588, 221, 1236, 1572, 380, 840, 1681, 0, 379, 1472, 157, 402, 1434, 1681, 817, 1018, 695, 175, 737, 568, 202, 500, 972, 471, 1615, 105, 1089]"
8,9,5491,5793,5414,0,2665,2826,"[904, 266, 385, 290, 747, 431, 356, 893, 942, 0, 362, 269, 322, 138, 857, 942, 750, 771, 269, 418, 362, 398, 61, 426, 650, 323, 138, 796, 650]"
9,9,5559,3050,7923,0,5172,387,"[36, 123, 16, 21, 35, 110, 31, 94, 129, 0, 87, 100, 18, 113, 6, 129, 48, 55, 41, 56, 73, 40, 39, 12, 59, 36, 57, 123, 37]"
10,9,5736,5924,7735,0,2420,3316,"[117, 190, 864, 513, 685, 403, 702, 785, 1105, 0, 501, 791, 251, 67, 572, 1105, 399, 11, 586, 678, 829, 212, 757, 328, 558, 377, 144, 505, 478]"
11,9,5316,6921,6130,0,2748,2568,"[763, 849, 692, 267, 142, 524, 488, 507, 856, 0, 809, 635, 376, 344, 59, 856, 12, 393, 35, 847, 613, 714, 469, 670, 582, 279, 82, 131, 563]"
12,9,6492,6240,6382,0,2774,3718,"[122, 305, 714, 948, 689, 790, 414, 601, 1239, 0, 279, 446, 600, 183, 379, 1239, 208, 673, 199, 826, 1218, 402, 1032, 438, 31, 332, 1018, 814, 827]"
13,9,5567,6575,5374,0,3308,2259,"[57, 159, 424, 539, 216, 66, 410, 71, 753, 0, 382, 335, 576, 169, 51, 753, 722, 257, 502, 626, 3, 188, 144, 475, 109, 257, 729, 171, 117]"
14,9,5647,5851,5170,0,3220,2427,"[175, 762, 224, 432, 398, 59, 154, 399, 809, 0, 51, 97, 35, 524, 145, 809, 200, 487, 684, 414, 150, 562, 469, 512, 358, 191, 22, 446, 79]"
15,9,5278,3994,6454,0,4092,1186,"[151, 230, 85, 132, 264, 236, 358, 266, 395, 0, 14, 257, 117, 85, 308, 395, 199, 90, 161, 147, 346, 21, 65, 17, 113, 197, 368, 341, 15]"
16,9,6141,5003,7592,0,3347,2794,"[757, 367, 547, 592, 218, 860, 124, 818, 931, 0, 24, 228, 637, 600, 779, 931, 45, 93, 100, 364, 215, 451, 385, 87, 293, 267, 571, 715, 144]"
17,9,6713,6202,8103,0,1115,5598,"[1253, 1334, 1225, 1778, 1145, 27, 806, 873, 1866, 0, 1505, 679, 1760, 544, 159, 1866, 1151, 1317, 214, 737, 1031, 1861, 199, 405, 121, 1045, 1198, 142, 1670]"
18,9,5342,5986,7459,0,1133,4209,"[1177, 1030, 1283, 1204, 259, 1277, 626, 289, 1403, 0, 535, 46, 908, 936, 753, 1403, 543, 73, 1219, 1020, 851, 972, 577, 15, 999, 1030, 1273, 37, 195]"
19,9,5841,5168,8132,0,3591,2250,"[47, 376, 606, 324, 221, 666, 471, 312, 750, 0, 484, 398, 464, 116, 206, 750, 619, 690, 30, 12, 115, 177, 101, 730, 332, 541, 621, 73, 541]"
20,9,6230,7481,6881,0,2742,3488,"[444, 84, 41, 174, 874, 727, 28, 1012, 1162, 0, 1056, 617, 776, 323, 237, 1162, 801, 228, 1086, 201, 802, 58, 833, 608, 1133, 1017, 1144, 700, 757]"
21,9,5444,7483,4842,0,2406,3038,"[179, 119, 241, 304, 557, 468, 486, 763, 1012, 0, 329, 811, 33, 993, 322, 1012, 773, 411, 1002, 671, 28, 238, 573, 679, 952, 883, 851, 705, 0]"
22,9,6548,7192,4198,0,1047,5501,"[1564, 1166, 200, 574, 421, 83, 33, 1133, 1833, 0, 511, 1564, 611, 454, 477, 1833, 676, 1034, 587, 30, 1427, 1122, 292, 1074, 1695, 1755, 950, 787, 1731]"
23,9,6303,1152,9349,0,1689,4614,"[938, 841, 250, 74, 57, 837, 100, 1018, 1538, 0, 1408, 1523, 495, 658, 424, 1538, 1244, 529, 1459, 1059, 139, 860, 886, 153, 1191, 574, 19, 1238, 836]"
24,9,6394,6117,9626,0,3536,2858,"[800, 6, 890, 868, 344, 529, 296, 244, 952, 0, 725, 90, 18, 404, 192, 952, 513, 718, 628, 596, 900, 676, 946, 540, 349, 122, 223, 591, 170]"
25,9,6326,7088,8864,0,1784,4542,"[1048, 1104, 1317, 482, 67, 1382, 181, 1339, 1514, 0, 1271, 1195, 360, 1104, 948, 1514, 53, 1386, 1459, 1384, 1137, 1299, 359, 477, 266, 1232, 737, 361, 18]"
26,9,5877,5945,8796,0,4812,1065,"[69, 40, 12, 275, 154, 147, 139, 113, 355, 0, 36, 296, 67, 10, 342, 355, 39, 199, 127, 184, 190, 71, 27, 200, 113, 101, 43, 257, 3]"
27,9,5837,6159,8474,0,4107,1730,"[136, 252, 244, 296, 201, 330, 435, 571, 576, 0, 33, 67, 368, 257, 416, 576, 375, 59, 111, 379, 398, 385, 197, 102, 391, 112, 391, 463, 249]"
28,9,5707,6591,7590,0,4501,1206,"[49, 365, 57, 280, 213, 244, 151, 371, 402, 0, 19, 178, 246, 146, 70, 402, 262, 242, 390, 264, 48, 251, 138, 63, 398, 386, 264, 197, 308]"
29,9,6401,5750,8241,0,3777,2624,"[493, 612, 36, 323, 400, 22, 576, 425, 874, 0, 187, 71, 120, 285, 478, 874, 539, 716, 391, 195, 31, 197, 800, 183, 250, 169, 264, 714, 396]"
30,9,5394,7147,6488,0,671,4723,"[980, 615, 1309, 46, 303, 1190, 1161, 117, 1574, 0, 421, 35, 1565, 1146, 88, 1574, 1560, 21, 1533, 574, 514, 457, 804, 330, 1499, 1476, 719, 322, 1077]"
31,9,5279,6077,5690,0,265,5014,"[512, 657, 751, 1409, 440, 453, 483, 556, 1671, 0, 532, 433, 324, 132, 1094, 1671, 1224, 453, 497, 301, 257, 86, 1372, 1218, 1212, 1002, 964, 215, 386]"
32,9,6804,7491,5003,0,4185,2619,"[483, 466, 15, 182, 147, 276, 465, 166, 873, 0, 37, 390, 374, 871, 40, 873, 420, 577, 382, 657, 232, 368, 785, 213, 600, 212, 296, 92, 102]"
33,9,5761,3405,7359,0,1329,4432,"[198, 911, 1058, 777, 1184, 1443, 1372, 534, 1477, 0, 784, 1016, 1015, 473, 8, 1477, 1156, 94, 180, 429, 299, 1100, 1051, 174, 1299, 1147, 1153, 1400, 107]"
34,9,6277,6245,7391,0,996,5281,"[1350, 1755, 1296, 1321, 265, 584, 547, 444, 1760, 0, 868, 1022, 427, 145, 1199, 1760, 658, 525, 493, 958, 1616, 1383, 920, 852, 706, 922, 1664, 721, 1360]"
35,9,6529,6820,7100,0,5393,1136,"[21, 275, 71, 215, 70, 228, 327, 322, 378, 0, 364, 332, 219, 340, 179, 378, 35, 52, 246, 355, 290, 43, 279, 322, 224, 86, 129, 74, 0]"
36,9,5204,5543,6761,0,3318,1886,"[383, 113, 507, 406, 142, 253, 508, 198, 628, 0, 507, 142, 349, 294, 11, 628, 123, 500, 627, 442, 558, 539, 127, 69, 182, 596, 480, 225, 206]"
37,9,6918,7093,6586,0,1956,4962,"[309, 1370, 334, 1626, 368, 67, 472, 299, 1654, 0, 907, 1634, 140, 1631, 476, 1654, 975, 1291, 1564, 9, 841, 18, 1432, 420, 1368, 678, 934, 657, 1081]"
38,9,5195,6023,5758,0,96,5099,"[470, 1642, 737, 1085, 395, 1073, 672, 1652, 1699, 0, 1657, 478, 1265, 793, 324, 1699, 1344, 1116, 1505, 687, 628, 1018, 325, 57, 1005, 963, 444, 1158, 587]"
39,9,5623,5731,5650,0,3939,1684,"[341, 399, 445, 156, 223, 203, 341, 76, 561, 0, 406, 32, 296, 37, 232, 561, 63, 552, 249, 342, 163, 447, 468, 123, 455, 419, 376, 374, 437]"
40,9,6429,6390,5689,0,4019,2410,"[482, 533, 465, 289, 66, 634, 230, 141, 803, 0, 352, 693, 112, 668, 378, 803, 268, 124, 632, 208, 723, 779, 185, 206, 290, 542, 144, 415, 137]"
41,9,6879,6575,5993,0,2073,4806,"[1141, 137, 307, 3, 962, 1016, 217, 1006, 1602, 0, 514, 740, 1315, 944, 897, 1602, 105, 1307, 1517, 1448, 1475, 573, 521, 835, 1480, 231, 1285, 381, 244]"
42,9,6274,6185,6082,0,1707,4567,"[1372, 1180, 46, 620, 27, 494, 531, 676, 1522, 0, 263, 75, 361, 593, 223, 1522, 1056, 1079, 636, 343, 1223, 270, 724, 163, 393, 824, 1283, 653, 5]"
43,9,6148,5562,6668,0,2721,3427,"[761, 942, 512, 796, 1128, 978, 944, 362, 1142, 0, 1047, 72, 480, 1100, 744, 1142, 457, 592, 757, 434, 312, 717, 197, 783, 411, 172, 758, 476, 769]"
44,9,5680,6243,6105,0,162,5518,"[332, 718, 1282, 644, 35, 688, 1828, 1191, 1839, 0, 1665, 234, 1108, 791, 1427, 1839, 227, 1461, 150, 1826, 1512, 847, 1641, 1331, 1452, 189, 887, 965, 341]"
45,9,6177,5518,6764,0,1809,4368,"[1215, 1407, 162, 556, 432, 477, 1195, 596, 1456, 0, 1338, 704, 1279, 832, 26, 1456, 1399, 709, 1334, 8, 122, 1332, 1322, 205, 159, 856, 14, 887, 844]"
46,9,5069,5540,6293,0,3559,1510,"[6, 491, 247, 447, 309, 198, 328, 492, 503, 0, 65, 476, 395, 479, 437, 503, 431, 412, 283, 84, 436, 274, 194, 424, 404, 272, 136, 206, 108]"
47,9,6488,6426,6355,0,2920,3568,"[12, 515, 1051, 212, 95, 326, 1001, 153, 1189, 0, 180, 724, 268, 1099, 7, 1189, 282, 196, 1118, 399, 232, 582, 591, 1156, 79, 547, 879, 51, 756]"
48,9,5652,5185,6822,0,1963,3689,"[870, 40, 125, 867, 978, 752, 24, 436, 1229, 0, 403, 861, 33, 278, 597, 1229, 237, 551, 141, 265, 572, 429, 666, 1040, 1029, 605, 1167, 1071, 158]"
49,9,6813,6815,6820,0,910,5903,"[317, 322, 210, 1772, 1042, 1576, 790, 1478, 1967, 0, 175, 1114, 408, 133, 517, 1967, 731, 1584, 673, 230, 1748, 1468, 289, 677, 368, 1299, 1087, 430, 1938]"
50,9,5443,5365,6898,0,2442,3001,"[284, 57, 555, 393, 50, 193, 731, 991, 1000, 0, 400, 310, 558, 927, 167, 1000, 123, 430, 431, 988, 528, 729, 533, 754, 325, 654, 138, 767, 473]"
51,9,6804,6125,7577,0,5062,1742,"[335, 541, 473, 429, 300, 151, 83, 226, 580, 0, 146, 215, 510, 105, 199, 580, 191, 412, 233, 99, 324, 579, 525, 561, 81, 75, 33, 87, 94]"
52,9,5821,5037,8361,0,3359,2462,"[809, 301, 199, 106, 470, 193, 167, 140, 820, 0, 724, 263, 522, 3, 650, 820, 650, 297, 209, 666, 127, 94, 144, 774, 264, 290, 305, 473, 26]"
53,9,5567,5471,8457,0,1732,3835,"[971, 378, 54, 878, 116, 1252, 361, 1198, 1278, 0, 358, 347, 1026, 978, 303, 1278, 355, 1033, 1092, 99, 450, 638, 165, 343, 231, 486, 1230, 481, 1272]"
54,9,5150,7085,6522,0,3931,1219,"[213, 344, 1, 303, 95, 400, 404, 114, 406, 0, 210, 126, 250, 312, 312, 406, 279, 377, 15, 11, 105, 49, 84, 393, 14, 221, 338, 181, 228]"
55,9,5748,6990,5280,0,100,5648,"[1658, 374, 255, 1558, 1292, 469, 1629, 1662, 1882, 0, 719, 401, 1734, 983, 1052, 1882, 939, 986, 272, 654, 412, 1771, 899, 1147, 268, 85, 695, 413, 730]"
56,9,5983,5889,5374,0,4675,1308,"[367, 25, 327, 251, 384, 227, 182, 140, 436, 0, 336, 318, 256, 330, 66, 436, 290, 238, 310, 306, 408, 352, 124, 279, 373, 143, 212, 128, 254]"
57,9,5049,874,9549,0,1732,3317,"[641, 673, 890, 316, 816, 509, 308, 984, 1105, 0, 902, 181, 257, 94, 172, 1105, 526, 600, 943, 118, 139, 49, 859, 151, 967, 894, 72, 152, 677]"
58,9,5725,5367,9907,0,295,5430,"[577, 684, 395, 1675, 1546, 1163, 921, 178, 1810, 0, 1739, 1593, 1406, 763, 1521, 1810, 917, 529, 122, 48, 330, 1258, 1679, 1462, 365, 909, 522, 1565, 793]"
59,9,6273,5110,10000,1070,4444,1829,"[166, 537, 371, 175, 465, 324, 419, 106, 609, 0, 237, 234, 83, 145, 318, 609, 507, 115, 378, 459, 29, 211, 218, 289, 126, 193, 460, 307, 569]"
60,9,6358,7202,9156,0,5917,441,"[118, 48, 20, 48, 9, 17, 120, 124, 147, 0, 50, 11, 64, 95, 40, 147, 147, 26, 120, 17, 121, 28, 77, 0, 34, 65, 48, 86, 139]"
61,9,6929,6558,9527,0,5718,1211,"[175, 224, 120, 218, 211, 276, 82, 128, 403, 0, 68, 307, 194, 133, 311, 403, 310, 107, 379, 151, 76, 202, 79, 394, 352, 332, 96, 247, 83]"
62,9,6335,5043,10000,819,5184,1151,"[29, 0, 30, 191, 303, 62, 254, 220, 383, 0, 330, 257, 164, 181, 330, 383, 261, 33, 94, 79, 250, 76, 282, 31, 291, 202, 107, 234, 181]"
63,9,5394,5030,10000,364,173,5221,"[487, 1515, 44, 1305, 344, 1414, 963, 1607, 1740, 0, 452, 1534, 109, 981, 837, 1740, 1064, 392, 1726, 484, 0, 1737, 796, 1340, 814, 1188, 1706, 79, 1091]"
64,9,6440,6109,10000,331,2331,4109,"[1201, 599, 231, 1114, 702, 64, 1154, 102, 1369, 0, 157, 22, 925, 40, 487, 1369, 1340, 687, 899, 859, 349, 224, 678, 970, 485, 1144, 337, 743, 785]"
65,9,6237,7494,8743,0,879,5358,"[1134, 1720, 1139, 227, 723, 1474, 419, 496, 1786, 0, 1318, 1551, 852, 1602, 1489, 1786, 193, 981, 187, 571, 544, 857, 964, 1677, 1728, 789, 1551, 496, 326]"
66,9,5144,6994,6893,0,373,4771,"[1100, 1383, 331, 1298, 1411, 1241, 1040, 1394, 1590, 0, 1537, 914, 1477, 570, 1319, 1590, 994, 211, 1520, 475, 1180, 1288, 261, 16, 447, 350, 857, 213, 144]"
67,9,6109,6043,6959,0,54,6055,"[1607, 75, 474, 106, 1098, 1668, 36, 1101, 2018, 0, 1302, 811, 1353, 241, 1308, 2018, 1810, 355, 551, 1019, 991, 863, 1545, 217, 1466, 459, 1177, 1803, 1018]"
68,9,6259,6900,6318,0,4375,1884,"[256, 18, 564, 218, 217, 46, 381, 202, 628, 0, 359, 72, 223, 305, 212, 628, 500, 88, 157, 583, 400, 583, 97, 24, 96, 277, 118, 69, 451]"
69,9,5808,5250,6876,0,2463,3345,"[801, 621, 577, 814, 940, 233, 449, 513, 1115, 0, 156, 263, 329, 112, 641, 1115, 380, 897, 191, 170, 845, 964, 934, 245, 561, 621, 300, 788, 531]"
70,9,5644,6196,6324,0,3384,2260,"[428, 509, 691, 734, 10, 406, 15, 198, 753, 0, 196, 579, 197, 94, 107, 753, 332, 373, 392, 573, 473, 17, 216, 638, 547, 419, 42, 403, 477]"
71,9,5787,5846,6265,0,3091,2696,"[316, 581, 852, 420, 860, 205, 849, 640, 898, 0, 14, 506, 193, 286, 776, 898, 336, 327, 524, 502, 832, 404, 578, 443, 404, 177, 816, 438, 735]"
72,9,5049,7449,3865,0,195,4854,"[1259, 779, 988, 1607, 184, 636, 11, 624, 1618, 0, 302, 660, 1512, 1141, 1464, 1618, 241, 818, 933, 500, 118, 1484, 985, 434, 977, 883, 822, 1597, 1456]"
73,9,5347,3579,5633,0,2090,3257,"[584, 854, 159, 271, 215, 658, 199, 44, 1085, 0, 1044, 478, 1032, 1018, 586, 1085, 207, 290, 64, 316, 1020, 690, 810, 657, 453, 798, 1023, 663, 688]"
74,9,6671,7107,5197,0,4277,2394,"[586, 737, 350, 65, 621, 263, 526, 94, 798, 0, 418, 647, 554, 706, 177, 798, 279, 425, 725, 412, 401, 724, 189, 592, 367, 690, 149, 764, 250]"
75,9,5510,5000,5707,0,339,5171,"[57, 1353, 1337, 260, 235, 71, 626, 426, 1723, 0, 1543, 658, 1190, 847, 1442, 1723, 1201, 1162, 1256, 113, 1462, 1365, 113, 835, 776, 754, 1315, 443, 341]"
76,9,6802,5865,6644,0,3004,3798,"[947, 983, 760, 1128, 284, 477, 634, 559, 1266, 0, 377, 1005, 116, 619, 25, 1266, 119, 307, 98, 746, 174, 797, 16, 589, 967, 1107, 1213, 303, 95]"
77,9,5163,6248,5559,0,4699,464,"[95, 123, 8, 24, 19, 125, 117, 113, 154, 0, 136, 72, 34, 33, 21, 154, 118, 37, 79, 147, 20, 129, 103, 111, 10, 100, 102, 15, 130]"
78,9,6947,5678,6828,0,1806,5141,"[56, 1402, 1088, 1443, 1616, 116, 496, 518, 1713, 0, 1199, 350, 534, 1535, 646, 1713, 1280, 1492, 1163, 1571, 1457, 1384, 40, 546, 601, 1027, 1067, 1258, 442]"
79,9,6411,6333,6906,0,3041,3370,"[5, 576, 123, 80, 493, 498, 583, 291, 1123, 0, 863, 984, 1068, 279, 1086, 1123, 123, 1043, 1111, 77, 80, 670, 444, 784, 27, 792, 741, 720, 851]"
80,9,6663,6291,7278,0,2181,4482,"[183, 1224, 824, 1342, 1076, 997, 624, 1105, 1494, 0, 662, 903, 555, 200, 1291, 1494, 667, 826, 323, 1136, 747, 166, 932, 70, 250, 517, 577, 249, 432]"
81,9,6523,6235,7566,0,4321,2202,"[691, 190, 661, 573, 259, 18, 449, 47, 734, 0, 656, 365, 39, 534, 144, 734, 656, 195, 141, 42, 282, 346, 164, 287, 433, 362, 253, 577, 97]"
82,9,6398,6195,7769,0,3569,2829,"[318, 863, 748, 750, 198, 358, 480, 72, 943, 0, 387, 746, 939, 218, 829, 943, 369, 327, 759, 623, 19, 74, 769, 387, 483, 640, 874, 793, 336]"
83,9,6060,5158,8671,0,1717,4343,"[497, 203, 429, 1123, 832, 307, 1279, 1386, 1447, 0, 268, 303, 366, 953, 248, 1447, 342, 1445, 844, 1090, 1176, 623, 1381, 1225, 613, 859, 1023, 986, 183]"
84,9,6444,5636,9479,0,4520,1924,"[21, 122, 594, 307, 270, 588, 84, 343, 641, 0, 296, 575, 15, 338, 284, 641, 348, 154, 403, 237, 240, 594, 48, 326, 407, 39, 452, 420, 550]"
85,9,5555,7163,7871,0,612,4943,"[83, 97, 42, 493, 87, 491, 238, 932, 1647, 0, 1102, 1531, 12, 1313, 1192, 1647, 598, 185, 575, 1356, 1404, 1324, 1087, 1123, 457, 1542, 128, 1059, 356]"
86,9,5277,5555,7593,0,4592,685,"[40, 77, 1, 160, 130, 171, 226, 48, 228, 0, 211, 123, 126, 14, 146, 228, 9, 73, 63, 209, 35, 22, 76, 61, 185, 36, 218, 93, 181]"
87,9,5987,5769,7811,0,4569,1418,"[191, 134, 105, 271, 292, 297, 264, 368, 472, 0, 273, 321, 102, 40, 253, 472, 251, 263, 450, 334, 282, 169, 289, 318, 466, 123, 134, 51, 387]"
88,9,5930,6065,7676,0,4546,1384,"[192, 193, 327, 347, 411, 402, 438, 140, 461, 0, 400, 416, 426, 88, 225, 461, 413, 297, 240, 224, 425, 70, 340, 424, 369, 70, 17, 278, 45]"
89,9,5657,7113,6220,0,2683,2974,"[99, 367, 633, 965, 589, 515, 818, 229, 991, 0, 442, 411, 803, 642, 870, 991, 92, 899, 785, 499, 934, 756, 153, 391, 853, 760, 919, 217, 209]"
90,9,5030,7197,4053,0,4275,755,"[43, 113, 161, 235, 82, 157, 72, 50, 251, 0, 75, 194, 139, 239, 40, 251, 99, 199, 17, 226, 121, 78, 82, 162, 84, 110, 74, 53, 25]"
91,9,6664,4360,6357,0,1221,5443,"[221, 1264, 1019, 75, 1218, 945, 1227, 1708, 1814, 0, 883, 302, 1270, 1174, 274, 1814, 299, 591, 1088, 546, 77, 583, 1267, 646, 1029, 1689, 755, 1807, 1280]"
92,9,6228,6784,5801,0,1296,4932,"[564, 1455, 87, 675, 1450, 1239, 578, 86, 1644, 0, 1400, 623, 906, 120, 1207, 1644, 1479, 1199, 1110, 383, 1396, 1477, 1629, 664, 737, 943, 646, 1025, 1079]"
93,9,5231,6454,4578,0,2677,2554,"[211, 379, 483, 64, 93, 838, 715, 688, 851, 0, 826, 812, 145, 641, 355, 851, 584, 808, 110, 609, 781, 770, 684, 168, 626, 129, 5, 496, 23]"
94,9,6201,5088,5691,0,5938,263,"[26, 23, 85, 77, 17, 3, 71, 87, 87, 0, 28, 41, 75, 69, 12, 87, 59, 49, 56, 74, 10, 32, 83, 2, 41, 28, 70, 48, 77]"
95,9,6387,5197,6881,0,700,5687,"[1612, 748, 654, 755, 1419, 573, 1664, 1327, 1895, 0, 173, 1889, 1155, 508, 439, 1895, 1680, 455, 631, 1112, 441, 1208, 134, 1552, 244, 1430, 1139, 704, 790]"
96,9,6537,6295,7123,0,947,5590,"[79, 1164, 349, 1526, 494, 444, 1056, 1483, 1863, 0, 1525, 1296, 923, 557, 692, 1863, 236, 138, 665, 342, 1186, 368, 1587, 731, 1510, 399, 465, 55, 1256]"
97,9,5489,5742,6870,0,4534,955,"[60, 226, 137, 128, 168, 288, 43, 127, 318, 0, 124, 105, 114, 132, 168, 318, 294, 71, 225, 5, 94, 313, 138, 126, 152, 240, 192, 298, 58]"
98,9,6034,5657,7247,0,2542,3492,"[209, 405, 686, 186, 1001, 778, 211, 598, 1164, 0, 948, 475, 1072, 534, 114, 1164, 653, 353, 614, 470, 1043, 255, 1008, 1129, 747, 126, 948, 183, 273]"
99,9,6095,5153,8189,0,1751,4344,"[1407, 1108, 657, 498, 967, 335, 368, 1285, 1448, 0, 395, 36, 449, 866, 82, 1448, 870, 1085, 45, 839, 1300, 1423, 596, 1109, 434, 329, 496, 727, 879]"
100,9,6306,5795,8700,0,2699,3607,"[122, 655, 220, 794, 550, 34, 297, 886, 1202, 0, 1088, 725, 722, 82, 297, 1202, 714, 626, 1174, 511, 1022, 777, 1043, 1038, 48, 477, 771, 1168, 336]"
101,9,6833,5943,9590,0,1708,5125,"[1437, 1104, 390, 325, 864, 1561, 163, 1256, 1708, 0, 508, 1414, 1329, 483, 1488, 1708, 1233, 1625, 87, 1222, 376, 937, 1503, 1326, 125, 1453, 1278, 751, 438]"
102,9,6890,6568,9912,0,4230,2660,"[584, 142, 574, 255, 119, 122, 781, 744, 886, 0, 776, 502, 313, 420, 845, 886, 196, 399, 319, 667, 321, 552, 287, 335, 354, 601, 344, 553, 684]"
103,9,6496,6957,9451,0,3616,2880,"[778, 135, 109, 194, 717, 888, 806, 31, 960, 0, 717, 665, 708, 367, 933, 960, 20, 214, 863, 25, 115, 334, 169, 746, 323, 282, 393, 516, 855]"
104,9,6332,6310,9473,0,1306,5026,"[158, 183, 1604, 1074, 888, 1035, 454, 679, 1675, 0, 1420, 137, 283, 491, 1601, 1675, 1189, 1179, 243, 638, 1010, 98, 152, 231, 698, 327, 234, 1081, 194]"
105,9,6373,6008,9838,0,2513,3860,"[688, 1241, 1119, 1221, 928, 79, 1258, 450, 1286, 0, 52, 1041, 974, 95, 422, 1286, 795, 253, 1080, 1187, 231, 1275, 840, 92, 404, 534, 394, 379, 495]"
106,9,6382,6106,10000,114,1850,4532,"[796, 506, 374, 953, 1044, 297, 1287, 1410, 1510, 0, 561, 104, 1073, 1266, 197, 1510, 1051, 620, 604, 517, 230, 1431, 769, 43, 950, 315, 457, 1020, 502]"
107,9,5469,6366,9103,0,4409,1060,"[208, 187, 349, 177, 229, 60, 236, 297, 353, 0, 311, 200, 62, 177, 301, 353, 203, 284, 22, 315, 340, 253, 108, 80, 52, 212, 342, 101, 141]"
108,9,6723,7388,8438,0,4434,2289,"[38, 272, 297, 375, 27, 116, 106, 740, 763, 0, 488, 19, 576, 248, 180, 763, 600, 301, 609, 270, 86, 728, 383, 230, 480, 397, 591, 763, 323]"
109,9,5535,6143,7830,0,3587,1948,"[618, 162, 411, 481, 281, 172, 52, 284, 649, 0, 212, 404, 523, 193, 225, 649, 50, 565, 159, 305, 594, 416, 395, 429, 126, 592, 344, 464, 23]"
110,9,6850,5041,9639,0,4971,1879,"[180, 82, 148, 542, 403, 304, 184, 258, 626, 0, 386, 283, 511, 609, 568, 626, 351, 601, 144, 259, 362, 398, 546, 60, 363, 513, 78, 395, 352]"
111,9,6190,6546,9283,0,4064,2126,"[192, 70, 357, 311, 240, 564, 0, 454, 708, 0, 588, 573, 624, 294, 290, 708, 298, 348, 331, 433, 300, 412, 650, 160, 499, 524, 33, 496, 703]"
112,9,5803,6314,8772,0,4250,1553,"[77, 452, 185, 55, 456, 242, 282, 220, 517, 0, 105, 176, 22, 511, 160, 517, 46, 479, 236, 23, 329, 54, 32, 57, 202, 211, 214, 187, 57]"
113,9,5816,5067,9521,0,706,5110,"[1032, 905, 1108, 727, 1543, 1571, 1040, 1163, 1703, 0, 1517, 826, 1566, 1472, 385, 1703, 1591, 1366, 960, 1541, 1109, 1035, 1562, 898, 1469, 693, 758, 900, 1553]"
114,9,5451,5615,9357,0,902,4549,"[567, 647, 191, 1003, 1325, 1398, 494, 596, 1516, 0, 337, 1013, 1427, 486, 1490, 1516, 9, 1421, 31, 864, 281, 541, 1243, 584, 111, 762, 616, 374, 1500]"
115,9,6912,6623,9646,0,538,6374,"[1961, 1172, 415, 1330, 958, 1003, 1089, 2113, 2124, 0, 466, 663, 483, 1470, 333, 2124, 1905, 1043, 740, 659, 1669, 657, 1444, 1994, 1780, 1729, 343, 643, 1368]"
116,9,6746,6722,9670,0,2366,4380,"[862, 644, 507, 1415, 689, 437, 849, 1328, 1460, 0, 860, 495, 471, 723, 1451, 1460, 1379, 253, 685, 1300, 497, 10, 1355, 156, 947, 354, 1039, 976, 590]"
117,9,6519,6807,9382,0,2474,4045,"[1142, 1016, 899, 17, 213, 354, 1339, 194, 1348, 0, 584, 141, 301, 1053, 249, 1348, 677, 155, 1174, 937, 1131, 1328, 135, 738, 332, 1055, 1273, 127, 1226]"
118,9,5183,7255,7310,0,1153,4030,"[689, 18, 29, 456, 506, 42, 730, 350, 1343, 0, 1329, 508, 807, 1305, 871, 1343, 988, 498, 352, 1020, 1187, 151, 537, 1333, 858, 784, 263, 828, 920]"
119,9,6732,6283,7759,0,3680,3052,"[595, 18, 594, 676, 8, 631, 720, 270, 1017, 0, 306, 508, 92, 267, 4, 1017, 207, 350, 644, 302, 479, 500, 951, 442, 333, 378, 94, 428, 756]"
0,10,45,0,45,0,28,17,"[2, 0, 1, 5, 3, 4, 0, 3, 0, 5, 0, 5, 1, 0, 0, 0, 4, 3, 1, 0, 4, 1, 3, 3, 1, 0, 0, 5, 1]"
1,10,11,2,54,0,11,0,"[0, 0, 0, 0, 0, 0, 0, 0, 0, 0, 0, 0, 0, 0, 0, 0, 0, 0, 0, 0, 0, 0, 0, 0, 0, 0, 0, 0, 0]"
2,10,63,25,92,0,54,9,"[2, 3, 3, 3, 2, 3, 1, 0, 1, 1, 0, 2, 1, 3, 2, 3, 2, 0, 0, 3, 0, 2, 2, 1, 1, 0, 0, 3, 3]"
3,10,91,34,149,0,17,74,"[8, 22, 22, 24, 21, 19, 7, 9, 15, 8, 0, 20, 16, 11, 7, 5, 9, 10, 24, 3, 1, 13, 14, 22, 7, 24, 11, 24, 18]"
4,10,74,13,210,0,68,6,"[1, 1, 2, 2, 2, 0, 1, 0, 1, 0, 0, 1, 1, 1, 2, 2, 0, 2, 2, 1, 0, 2, 1, 0, 1, 1, 2, 2, 1]"
5,10,44,15,239,0,33,11,"[0, 3, 2, 3, 0, 0, 1, 3, 0, 0, 0, 0, 1, 0, 3, 3, 3, 0, 0, 3, 2, 3, 0, 1, 3, 0, 2, 3, 1]"
6,10,95,23,311,0,19,76,"[16, 18, 18, 25, 15, 14, 17, 13, 1, 16, 0, 15, 5, 11, 0, 20, 2, 25, 16, 5, 16, 11, 14, 18, 20, 14, 9, 25, 1]"
7,10,78,6,383,0,65,13,"[4, 4, 2, 4, 2, 3, 3, 1, 4, 4, 0, 1, 4, 1, 2, 2, 0, 1, 1, 3, 3, 4, 4, 3, 1, 2, 1, 4, 3]"
8,10,67,52,398,0,30,37,"[0, 11, 2, 12, 11, 10, 6, 12, 8, 10, 0, 12, 11, 9, 8, 9, 9, 5, 1, 8, 12, 10, 6, 4, 4, 4, 11, 12, 10]"
9,10,51,31,418,0,11,40,"[7, 4, 1, 13, 9, 4, 1, 6, 11, 6, 0, 10, 3, 8, 12, 3, 10, 8, 7, 6, 11, 11, 5, 1, 1, 12, 3, 13, 6]"
10,10,86,12,492,0,17,69,"[18, 15, 18, 23, 4, 2, 17, 20, 17, 8, 0, 13, 1, 8, 1, 23, 17, 18, 5, 3, 5, 0, 6, 14, 5, 11, 7, 23, 5]"
11,10,98,65,525,0,13,85,"[22, 24, 28, 28, 7, 4, 25, 18, 20, 3, 0, 17, 3, 27, 15, 20, 20, 20, 6, 5, 15, 22, 14, 0, 14, 23, 12, 28, 14]"
12,10,59,54,530,0,7,52,"[4, 16, 12, 17, 4, 15, 11, 7, 3, 7, 0, 8, 16, 7, 17, 0, 13, 6, 2, 9, 16, 4, 5, 12, 17, 14, 6, 17, 10]"
13,10,51,7,574,0,10,41,"[13, 6, 0, 13, 3, 7, 6, 12, 4, 13, 0, 11, 1, 9, 6, 10, 5, 1, 12, 3, 13, 6, 12, 13, 8, 6, 4, 13, 3]"
14,10,55,26,603,0,7,48,"[15, 10, 6, 16, 11, 3, 13, 4, 1, 2, 0, 8, 0, 6, 3, 10, 12, 10, 8, 7, 16, 5, 3, 1, 8, 6, 5, 16, 13]"
15,10,8,2,609,0,1,7,"[0, 2, 0, 2, 0, 0, 1, 2, 0, 1, 0, 2, 0, 2, 2, 2, 2, 1, 0, 2, 1, 1, 2, 1, 1, 1, 1, 2, 2]"
16,10,73,15,667,0,60,13,"[2, 0, 4, 4, 3, 4, 1, 0, 4, 2, 0, 3, 0, 3, 0, 3, 0, 3, 2, 4, 1, 4, 1, 3, 0, 0, 3, 4, 4]"
17,10,35,12,690,0,0,35,"[2, 11, 7, 11, 8, 11, 0, 2, 7, 7, 0, 1, 0, 8, 5, 2, 10, 1, 3, 2, 1, 6, 10, 4, 4, 6, 3, 11, 0]"
18,10,30,6,714,0,7,23,"[1, 6, 6, 7, 5, 5, 6, 2, 5, 2, 0, 5, 6, 6, 0, 6, 2, 7, 2, 1, 7, 7, 3, 3, 4, 7, 5, 7, 2]"
19,10,2,1,715,0,0,2,"[0, 0, 0, 0, 0, 0, 0, 0, 0, 0, 0, 0, 0, 0, 0, 0, 0, 0, 0, 0, 0, 0, 0, 0, 0, 0, 0, 0, 0]"
20,10,1,0,715,0,1,0,"[0, 0, 0, 0, 0, 0, 0, 0, 0, 0, 0, 0, 0, 0, 0, 0, 0, 0, 0, 0, 0, 0, 0, 0, 0, 0, 0, 0, 0]"
21,10,80,72,723,0,70,10,"[3, 2, 3, 3, 2, 2, 2, 2, 2, 0, 0, 2, 3, 3, 1, 1, 2, 0, 1, 1, 2, 3, 0, 3, 2, 3, 2, 3, 3]"
22,10,48,10,761,0,17,31,"[2, 6, 0, 10, 2, 6, 1, 5, 6, 0, 0, 7, 9, 6, 8, 7, 3, 2, 10, 0, 3, 5, 2, 8, 0, 5, 0, 10, 9]"
23,10,0,0,761,0,0,0,"[0, 0, 0, 0, 0, 0, 0, 0, 0, 0, 0, 0, 0, 0, 0, 0, 0, 0, 0, 0, 0, 0, 0, 0, 0, 0, 0, 0, 0]"
24,10,19,4,776,0,17,2,"[0, 0, 0, 0, 0, 0, 0, 0, 0, 0, 0, 0, 0, 0, 0, 0, 0, 0, 0, 0, 0, 0, 0, 0, 0, 0, 0, 0, 0]"
25,10,5,1,780,0,2,3,"[0, 0, 0, 1, 1, 0, 1, 1, 0, 0, 0, 0, 1, 0, 0, 0, 1, 1, 1, 1, 0, 0, 1, 1, 1, 0, 0, 1, 0]"
26,10,45,38,787,0,16,29,"[5, 9, 1, 9, 9, 7, 0, 5, 4, 6, 0, 0, 0, 5, 4, 8, 2, 7, 7, 4, 5, 6, 5, 3, 4, 5, 4, 9, 5]"
27,10,65,8,844,0,17,48,"[16, 10, 14, 16, 5, 16, 9, 4, 12, 10, 0, 9, 5, 13, 16, 0, 8, 0, 1, 2, 14, 15, 12, 2, 0, 1, 5, 16, 2]"
28,10,54,15,883,0,51,3,"[0, 0, 0, 1, 0, 0, 1, 1, 0, 1, 0, 0, 0, 1, 1, 1, 1, 0, 1, 1, 1, 0, 1, 1, 0, 0, 0, 1, 1]"
29,10,16,16,883,0,0,16,"[3, 5, 0, 5, 3, 3, 1, 5, 1, 1, 0, 3, 0, 1, 4, 3, 4, 1, 5, 5, 1, 2, 5, 0, 1, 1, 4, 5, 2]"
30,10,22,19,886,0,17,5,"[0, 1, 1, 1, 1, 1, 0, 1, 0, 1, 0, 1, 1, 0, 0, 0, 1, 0, 1, 1, 1, 0, 1, 1, 1, 0, 1, 1, 0]"
31,10,62,52,896,0,21,41,"[3, 1, 0, 13, 5, 7, 6, 13, 5, 8, 0, 6, 6, 1, 3, 11, 5, 8, 2, 1, 12, 0, 2, 6, 12, 8, 6, 13, 7]"
32,10,32,16,912,0,31,1,"[0, 0, 0, 0, 0, 0, 0, 0, 0, 0, 0, 0, 0, 0, 0, 0, 0, 0, 0, 0, 0, 0, 0, 0, 0, 0, 0, 0, 0]"
33,10,83,25,970,0,18,65,"[5, 20, 15, 21, 13, 21, 13, 14, 7, 6, 0, 14, 12, 0, 10, 3, 2, 1, 17, 15, 18, 18, 8, 14, 5, 7, 13, 21, 10]"
34,10,42,2,1010,0,21,21,"[4, 7, 5, 7, 2, 1, 1, 2, 7, 7, 0, 0, 2, 1, 0, 7, 4, 7, 6, 4, 1, 6, 5, 5, 1, 1, 2, 7, 5]"
35,10,4,4,1010,0,0,4,"[1, 1, 0, 1, 0, 1, 0, 1, 1, 0, 0, 0, 1, 0, 1, 0, 1, 0, 1, 0, 0, 1, 0, 0, 1, 1, 1, 1, 0]"
36,10,90,10,1090,0,42,48,"[12, 15, 15, 16, 6, 8, 12, 16, 5, 14, 0, 1, 15, 0, 4, 5, 3, 6, 2, 6, 15, 8, 3, 4, 16, 5, 12, 16, 10]"
37,10,46,5,1131,0,38,8,"[1, 2, 2, 2, 1, 0, 1, 0, 2, 0, 0, 0, 1, 2, 2, 0, 1, 0, 1, 1, 2, 2, 0, 2, 0, 0, 0, 2, 0]"
38,10,84,55,1160,0,42,42,"[1, 14, 4, 14, 6, 13, 2, 13, 9, 1, 0, 1, 8, 6, 0, 4, 8, 14, 5, 12, 2, 5, 11, 0, 8, 8, 12, 14, 14]"
39,10,52,4,1208,0,1,51,"[7, 2, 11, 17, 6, 13, 7, 14, 1, 10, 0, 8, 9, 7, 6, 4, 14, 13, 7, 16, 5, 16, 3, 8, 17, 6, 3, 17, 5]"
40,10,25,9,1224,0,17,8,"[0, 2, 0, 2, 2, 1, 0, 0, 0, 1, 0, 2, 1, 2, 0, 2, 2, 0, 2, 1, 2, 0, 1, 0, 1, 2, 2, 2, 1]"
41,10,19,10,1233,0,4,15,"[1, 2, 5, 5, 4, 1, 4, 2, 1, 4, 0, 2, 0, 5, 1, 2, 1, 3, 5, 0, 1, 4, 1, 1, 5, 2, 0, 5, 1]"
42,10,14,0,1247,0,13,1,"[0, 0, 0, 0, 0, 0, 0, 0, 0, 0, 0, 0, 0, 0, 0, 0, 0, 0, 0, 0, 0, 0, 0, 0, 0, 0, 0, 0, 0]"
43,10,57,48,1256,0,50,7,"[1, 0, 0, 2, 1, 1, 0, 0, 1, 1, 0, 0, 1, 2, 2, 0, 1, 1, 1, 1, 0, 1, 2, 1, 2, 2, 0, 2, 1]"
44,10,45,17,1284,0,12,33,"[5, 2, 8, 11, 6, 10, 0, 11, 9, 7, 0, 2, 6, 8, 7, 9, 3, 8, 2, 9, 10, 8, 4, 8, 11, 0, 10, 11, 6]"
45,10,88,5,1367,0,27,61,"[9, 1, 4, 20, 1, 0, 18, 10, 13, 1, 0, 0, 9, 18, 15, 3, 18, 1, 12, 4, 13, 20, 19, 11, 17, 8, 0, 20, 8]"
46,10,54,40,1381,0,52,2,"[0, 0, 0, 0, 0, 0, 0, 0, 0, 0, 0, 0, 0, 0, 0, 0, 0, 0, 0, 0, 0, 0, 0, 0, 0, 0, 0, 0, 0]"
47,10,22,4,1399,0,5,17,"[4, 1, 1, 5, 3, 0, 1, 2, 5, 2, 0, 1, 0, 1, 2, 3, 0, 5, 2, 1, 5, 3, 5, 2, 4, 2, 0, 5, 3]"
48,10,6,0,1405,0,3,3,"[0, 1, 0, 1, 0, 1, 1, 1, 0, 1, 0, 0, 1, 1, 0, 1, 0, 0, 0, 1, 1, 0, 0, 0, 0, 1, 1, 1, 0]"
49,10,80,37,1448,0,33,47,"[15, 5, 4, 15, 0, 11, 1, 5, 15, 3, 0, 8, 3, 9, 10, 10, 13, 3, 12, 12, 2, 1, 12, 10, 1, 3, 3, 15, 6]"
50,10,69,25,1492,0,45,24,"[8, 2, 1, 8, 7, 1, 3, 1, 1, 5, 0, 5, 5, 4, 8, 2, 3, 3, 1, 8, 6, 8, 4, 3, 6, 8, 6, 8, 4]"
51,10,23,10,1505,0,7,16,"[1, 5, 0, 5, 2, 5, 1, 3, 5, 2, 0, 3, 5, 3, 1, 3, 4, 0, 0, 3, 2, 1, 2, 0, 4, 5, 4, 5, 4]"
52,10,13,9,1509,0,12,1,"[0, 0, 0, 0, 0, 0, 0, 0, 0, 0, 0, 0, 0, 0, 0, 0, 0, 0, 0, 0, 0, 0, 0, 0, 0, 0, 0, 0, 0]"
53,10,61,30,1540,0,3,58,"[0, 11, 11, 19, 18, 9, 5, 15, 2, 9, 0, 4, 15, 0, 15, 17, 8, 19, 5, 19, 19, 16, 13, 4, 3, 18, 10, 19, 11]"
54,10,96,83,1553,0,63,33,"[1, 2, 7, 11, 8, 2, 8, 10, 7, 1, 0, 11, 5, 0, 5, 1, 3, 5, 4, 3, 4, 2, 9, 7, 8, 7, 2, 11, 10]"
55,10,83,73,1563,0,15,68,"[9, 19, 16, 22, 11, 17, 5, 15, 13, 1, 0, 12, 6, 11, 17, 14, 13, 0, 4, 7, 6, 0, 12, 22, 3, 2, 7, 22, 2]"
56,10,66,66,1563,0,1,65,"[4, 2, 1, 21, 2, 17, 19, 19, 2, 19, 0, 10, 6, 17, 6, 2, 5, 6, 11, 14, 4, 2, 10, 1, 3, 18, 11, 21, 3]"
57,10,60,46,1577,0,9,51,"[6, 17, 3, 17, 8, 8, 6, 15, 10, 2, 0, 1, 14, 1, 14, 17, 17, 9, 13, 5, 16, 12, 7, 10, 16, 7, 12, 17, 13]"
58,10,29,17,1589,0,18,11,"[1, 1, 0, 3, 3, 3, 1, 1, 3, 1, 0, 0, 3, 2, 3, 1, 3, 2, 3, 1, 3, 2, 1, 2, 0, 2, 1, 3, 3]"
59,10,15,3,1601,0,13,2,"[0, 0, 0, 0, 0, 0, 0, 0, 0, 0, 0, 0, 0, 0, 0, 0, 0, 0, 0, 0, 0, 0, 0, 0, 0, 0, 0, 0, 0]"
60,10,8,8,1601,0,1,7,"[0, 0, 0, 2, 0, 2, 0, 1, 0, 2, 0, 1, 2, 1, 2, 0, 0, 1, 2, 1, 1, 1, 0, 2, 1, 2, 2, 2, 1]"
61,10,94,9,1686,0,56,38,"[5, 11, 11, 12, 12, 12, 7, 2, 6, 8, 0, 5, 9, 11, 4, 9, 6, 1, 2, 5, 9, 12, 2, 5, 11, 12, 6, 12, 7]"
62,10,67,31,1722,0,54,13,"[2, 3, 0, 4, 4, 4, 3, 1, 3, 4, 0, 1, 3, 3, 3, 2, 2, 0, 1, 3, 3, 0, 0, 0, 4, 4, 3, 4, 0]"
63,10,98,60,1760,0,26,72,"[8, 0, 10, 24, 12, 11, 20, 18, 20, 21, 0, 6, 10, 16, 9, 19, 15, 1, 11, 2, 19, 17, 1, 13, 20, 20, 13, 24, 21]"
64,10,55,7,1808,0,25,30,"[8, 10, 2, 10, 6, 9, 0, 0, 0, 6, 0, 10, 9, 0, 7, 2, 5, 2, 8, 1, 10, 5, 8, 1, 10, 8, 10, 10, 0]"
65,10,82,39,1851,0,40,42,"[9, 5, 8, 14, 8, 1, 8, 1, 5, 10, 0, 4, 13, 3, 0, 2, 0, 1, 11, 14, 7, 0, 7, 1, 8, 0, 7, 14, 5]"
66,10,74,0,1925,0,14,60,"[15, 0, 9, 20, 7, 5, 2, 17, 12, 19, 0, 5, 4, 19, 9, 17, 8, 20, 13, 1, 9, 17, 15, 13, 6, 16, 8, 20, 1]"
67,10,1,0,1852,0,1,0,"[0, 0, 0, 0, 0, 0, 0, 0, 0, 0, 0, 0, 0, 0, 0, 0, 0, 0, 0, 0, 0, 0, 0, 0, 0, 0, 0, 0, 0]"
68,10,55,11,1896,0,1,54,"[11, 5, 18, 18, 7, 7, 13, 9, 8, 3, 0, 11, 3, 11, 10, 6, 15, 18, 15, 16, 16, 9, 14, 5, 11, 14, 10, 18, 7]"
69,10,77,45,1928,0,13,64,"[19, 17, 0, 21, 2, 1, 16, 21, 10, 6, 0, 17, 13, 11, 17, 8, 16, 5, 14, 4, 3, 11, 1, 12, 2, 14, 1, 21, 1]"
70,10,35,24,1939,0,32,3,"[1, 0, 0, 1, 1, 1, 1, 0, 0, 1, 0, 0, 1, 0, 0, 1, 0, 1, 1, 0, 1, 0, 0, 1, 1, 0, 1, 1, 0]"
71,10,56,25,1970,0,22,34,"[3, 0, 6, 11, 9, 5, 4, 11, 2, 1, 0, 2, 3, 3, 1, 2, 1, 2, 9, 9, 4, 1, 3, 11, 5, 1, 9, 11, 5]"
72,10,6,6,1970,0,5,1,"[0, 0, 0, 0, 0, 0, 0, 0, 0, 0, 0, 0, 0, 0, 0, 0, 0, 0, 0, 0, 0, 0, 0, 0, 0, 0, 0, 0, 0]"
73,10,7,5,1972,0,4,3,"[1, 1, 1, 1, 0, 1, 1, 1, 0, 1, 0, 0, 0, 0, 1, 0, 0, 0, 1, 1, 1, 1, 0, 0, 1, 1, 0, 1, 1]"
74,10,37,5,2004,0,22,15,"[1, 0, 4, 5, 4, 3, 2, 0, 3, 3, 0, 3, 1, 0, 4, 0, 5, 2, 2, 5, 5, 1, 5, 1, 0, 1, 3, 5, 0]"
75,10,63,6,2061,0,29,34,"[4, 2, 8, 11, 7, 11, 7, 6, 1, 7, 0, 3, 6, 0, 4, 3, 0, 2, 7, 3, 0, 2, 10, 5, 0, 7, 11, 11, 10]"
76,10,48,14,2095,0,12,36,"[5, 0, 0, 12, 6, 2, 11, 12, 3, 3, 0, 3, 1, 5, 3, 5, 6, 5, 11, 11, 11, 9, 5, 9, 8, 11, 6, 12, 7]"
77,10,88,3,2180,0,88,0,"[0, 0, 0, 0, 0, 0, 0, 0, 0, 0, 0, 0, 0, 0, 0, 0, 0, 0, 0, 0, 0, 0, 0, 0, 0, 0, 0, 0, 0]"
78,10,83,55,2208,0,29,54,"[6, 18, 12, 18, 5, 10, 13, 10, 2, 18, 0, 2, 3, 12, 8, 3, 6, 1, 7, 3, 3, 2, 5, 9, 1, 12, 18, 18, 4]"
79,10,39,20,2227,0,18,21,"[2, 6, 7, 7, 2, 6, 3, 2, 3, 6, 0, 6, 7, 4, 0, 0, 7, 3, 3, 2, 2, 5, 6, 5, 1, 3, 5, 7, 2]"
80,10,30,25,2232,0,19,11,"[2, 3, 1, 3, 3, 0, 0, 1, 2, 2, 0, 3, 1, 0, 2, 2, 2, 3, 2, 3, 0, 1, 3, 1, 0, 1, 1, 3, 0]"
81,10,98,35,2295,0,30,68,"[19, 15, 11, 22, 18, 20, 16, 16, 15, 0, 0, 19, 4, 0, 2, 20, 4, 8, 20, 12, 6, 10, 4, 0, 21, 20, 21, 22, 1]"
82,10,58,22,2331,0,27,31,"[1, 10, 2, 10, 6, 9, 10, 8, 4, 0, 0, 10, 6, 2, 0, 8, 7, 0, 4, 8, 4, 5, 9, 3, 3, 2, 0, 10, 7]"
83,10,34,21,2344,0,28,6,"[0, 0, 0, 2, 1, 2, 2, 1, 1, 2, 0, 2, 0, 1, 1, 1, 0, 2, 0, 0, 0, 2, 0, 1, 1, 0, 0, 2, 0]"
84,10,94,71,2367,0,76,18,"[5, 0, 3, 6, 3, 6, 1, 4, 2, 4, 0, 5, 3, 5, 3, 3, 3, 2, 1, 4, 6, 3, 5, 1, 4, 5, 3, 6, 3]"
85,10,66,15,2418,0,37,29,"[8, 4, 9, 9, 6, 3, 1, 7, 4, 9, 0, 2, 5, 9, 0, 8, 4, 1, 7, 4, 8, 5, 5, 3, 6, 5, 6, 9, 8]"
86,10,86,16,2488,0,86,0,"[0, 0, 0, 0, 0, 0, 0, 0, 0, 0, 0, 0, 0, 0, 0, 0, 0, 0, 0, 0, 0, 0, 0, 0, 0, 0, 0, 0, 0]"
87,10,3,2,2489,0,1,2,"[0, 0, 0, 0, 0, 0, 0, 0, 0, 0, 0, 0, 0, 0, 0, 0, 0, 0, 0, 0, 0, 0, 0, 0, 0, 0, 0, 0, 0]"
88,10,17,6,2500,0,1,16,"[0, 1, 0, 5, 1, 4, 2, 4, 5, 2, 0, 1, 2, 1, 4, 4, 5, 5, 3, 1, 3, 4, 3, 4, 2, 5, 2, 5, 5]"
89,10,31,13,2518,0,23,8,"[2, 2, 2, 2, 0, 0, 2, 2, 2, 1, 0, 2, 1, 0, 1, 1, 0, 2, 0, 1, 1, 1, 0, 2, 2, 1, 0, 2, 1]"
90,10,3,3,2518,0,3,0,"[0, 0, 0, 0, 0, 0, 0, 0, 0, 0, 0, 0, 0, 0, 0, 0, 0, 0, 0, 0, 0, 0, 0, 0, 0, 0, 0, 0, 0]"
91,10,40,0,2558,0,4,36,"[10, 2, 2, 12, 10, 12, 1, 12, 5, 8, 0, 11, 1, 7, 0, 4, 2, 8, 10, 6, 6, 5, 11, 0, 8, 11, 2, 12, 12]"
92,10,10,5,2563,0,10,0,"[0, 0, 0, 0, 0, 0, 0, 0, 0, 0, 0, 0, 0, 0, 0, 0, 0, 0, 0, 0, 0, 0, 0, 0, 0, 0, 0, 0, 0]"
93,10,14,3,2574,0,1,13,"[4, 0, 1, 4, 0, 0, 1, 4, 3, 3, 0, 3, 4, 3, 4, 2, 2, 2, 1, 2, 2, 0, 0, 4, 4, 1, 3, 4, 3]"
94,10,12,7,2579,0,1,11,"[2, 2, 2, 3, 3, 0, 3, 1, 1, 0, 0, 2, 3, 2, 1, 0, 0, 1, 3, 2, 3, 0, 0, 0, 3, 0, 0, 3, 2]"
95,10,11,11,2579,0,7,4,"[0, 1, 1, 1, 0, 1, 0, 1, 0, 0, 0, 0, 1, 0, 1, 1, 0, 0, 1, 1, 0, 0, 1, 1, 1, 1, 1, 1, 0]"
96,10,31,4,2606,0,16,15,"[0, 4, 5, 5, 3, 5, 5, 2, 5, 0, 0, 2, 5, 1, 1, 4, 3, 5, 0, 0, 4, 0, 3, 5, 2, 2, 1, 5, 4]"
97,10,9,5,2610,0,6,3,"[1, 0, 1, 1, 0, 1, 0, 1, 1, 1, 0, 0, 1, 0, 0, 1, 0, 1, 1, 1, 0, 0, 0, 1, 1, 0, 0, 1, 1]"
98,10,88,10,2688,0,52,36,"[11, 1, 12, 12, 12, 3, 10, 8, 11, 12, 0, 12, 8, 9, 0, 5, 10, 0, 12, 6, 2, 6, 7, 5, 6, 1, 1, 12, 9]"
99,10,7,5,2690,0,0,7,"[1, 1, 2, 2, 2, 1, 1, 2, 2, 2, 0, 1, 1, 2, 1, 2, 1, 2, 1, 0, 1, 2, 2, 2, 0, 2, 2, 2, 1]"
100,10,31,22,2699,0,0,31,"[7, 5, 3, 10, 4, 4, 1, 6, 1, 5, 0, 4, 1, 10, 3, 1, 2, 0, 3, 8, 0, 8, 1, 8, 8, 3, 3, 10, 10]"
101,10,25,23,2701,0,16,9,"[1, 2, 3, 3, 2, 2, 2, 2, 1, 3, 0, 1, 3, 0, 3, 1, 1, 1, 1, 2, 2, 0, 0, 3, 3, 3, 0, 3, 0]"
102,10,25,12,2714,0,2,23,"[2, 1, 6, 7, 5, 1, 7, 3, 1, 6, 0, 0, 2, 2, 6, 7, 2, 0, 5, 6, 5, 4, 2, 5, 0, 4, 4, 7, 2]"
103,10,88,87,2715,0,75,13,"[1, 0, 4, 4, 3, 3, 2, 1, 0, 2, 0, 0, 3, 0, 3, 0, 3, 0, 1, 1, 1, 0, 2, 3, 2, 3, 0, 4, 2]"
104,10,12,9,2718,0,8,4,"[0, 1, 1, 1, 1, 1, 0, 0, 1, 1, 0, 1, 0, 1, 0, 0, 1, 0, 1, 0, 1, 0, 1, 1, 0, 1, 1, 1, 0]"
105,10,27,21,2724,0,26,1,"[0, 0, 0, 0, 0, 0, 0, 0, 0, 0, 0, 0, 0, 0, 0, 0, 0, 0, 0, 0, 0, 0, 0, 0, 0, 0, 0, 0, 0]"
106,10,95,59,2760,0,74,21,"[5, 4, 1, 7, 3, 6, 2, 2, 4, 1, 0, 5, 3, 7, 7, 2, 0, 1, 0, 0, 6, 0, 7, 4, 6, 7, 4, 7, 0]"
107,10,87,55,2792,0,16,71,"[23, 1, 19, 23, 13, 5, 9, 22, 18, 9, 0, 14, 9, 11, 8, 11, 21, 13, 7, 22, 18, 9, 2, 17, 22, 14, 9, 23, 19]"
108,10,17,3,2806,0,5,12,"[4, 1, 0, 4, 3, 4, 2, 1, 3, 2, 0, 0, 4, 2, 0, 1, 1, 0, 2, 4, 0, 4, 4, 0, 3, 2, 1, 4, 2]"
109,10,74,44,2836,0,57,17,"[0, 2, 5, 5, 1, 5, 0, 1, 4, 5, 0, 4, 4, 3, 5, 2, 4, 2, 1, 3, 4, 3, 2, 5, 0, 5, 2, 5, 5]"
110,10,10,2,2844,0,1,9,"[1, 1, 3, 3, 3, 0, 0, 1, 1, 3, 0, 1, 1, 2, 1, 1, 3, 1, 2, 0, 1, 0, 3, 2, 3, 1, 2, 3, 3]"
111,10,63,29,2878,0,21,42,"[6, 10, 9, 14, 6, 7, 1, 9, 3, 5, 0, 5, 4, 14, 3, 2, 5, 11, 12, 10, 11, 7, 6, 4, 6, 12, 10, 14, 2]"
112,10,17,16,2879,0,7,10,"[0, 3, 2, 3, 3, 1, 1, 0, 0, 2, 0, 2, 2, 3, 1, 0, 0, 2, 1, 2, 1, 2, 1, 3, 1, 2, 0, 3, 1]"
113,10,13,10,2882,0,1,12,"[0, 2, 1, 4, 2, 2, 1, 4, 2, 3, 0, 0, 1, 4, 1, 2, 2, 1, 2, 4, 4, 1, 4, 4, 0, 2, 0, 4, 3]"
114,10,38,26,2894,0,21,17,"[2, 4, 3, 5, 0, 1, 2, 4, 2, 4, 0, 5, 5, 5, 5, 4, 1, 0, 5, 4, 1, 2, 4, 1, 1, 3, 4, 5, 5]"
115,10,72,2,2964,0,71,1,"[0, 0, 0, 0, 0, 0, 0, 0, 0, 0, 0, 0, 0, 0, 0, 0, 0, 0, 0, 0, 0, 0, 0, 0, 0, 0, 0, 0, 0]"
116,10,100,10,3054,0,9,91,"[11, 24, 14, 30, 2, 26, 5, 6, 18, 13, 0, 19, 17, 26, 19, 13, 9, 6, 21, 0, 24, 15, 16, 19, 1, 2, 15, 30, 7]"
117,10,22,18,3058,0,19,3,"[0, 1, 1, 1, 1, 0, 1, 0, 1, 1, 0, 0, 0, 0, 0, 0, 1, 1, 1, 1, 0, 1, 0, 1, 0, 1, 1, 1, 0]"
118,10,11,8,3061,0,10,1,"[0, 0, 0, 0, 0, 0, 0, 0, 0, 0, 0, 0, 0, 0, 0, 0, 0, 0, 0, 0, 0, 0, 0, 0, 0, 0, 0, 0, 0]"
119,10,44,17,3088,0,43,1,"[0, 0, 0, 0, 0, 0, 0, 0, 0, 0, 0, 0, 0, 0, 0, 0, 0, 0, 0, 0, 0, 0, 0, 0, 0, 0, 0, 0, 0]"
0,11,3273,0,3273,0,2898,375,"[25, 15, 98, 98, 38, 77, 47, 25, 19, 59, 43, 0, 31, 71, 2, 114, 83, 13, 18, 116, 49, 72, 125, 42, 125, 89, 54, 46, 111]"
1,11,4861,2957,5177,0,72,4789,"[46, 149, 802, 1239, 645, 498, 335, 494, 263, 1042, 663, 0, 370, 1380, 848, 1049, 444, 739, 1151, 555, 1018, 372, 1596, 122, 1596, 772, 327, 434, 97]"
2,11,3342,1104,7415,0,2088,1254,"[244, 336, 142, 391, 150, 23, 150, 165, 170, 144, 104, 0, 364, 324, 14, 364, 337, 407, 72, 409, 380, 237, 418, 380, 418, 52, 175, 43, 111]"
3,11,4206,5304,6317,0,2963,1243,"[72, 240, 154, 187, 317, 267, 181, 131, 172, 325, 269, 0, 194, 127, 218, 134, 134, 29, 40, 130, 24, 366, 414, 23, 414, 145, 19, 132, 2]"
4,11,4463,3046,7734,0,1115,3348,"[663, 662, 484, 679, 173, 206, 1019, 1112, 206, 41, 951, 0, 701, 89, 306, 0, 44, 701, 289, 13, 674, 941, 1116, 204, 1116, 387, 614, 735, 658]"
5,11,4882,6267,6349,0,2998,1884,"[525, 448, 596, 325, 32, 292, 163, 412, 252, 295, 427, 0, 200, 446, 432, 565, 216, 164, 616, 100, 392, 247, 628, 297, 628, 247, 76, 128, 184]"
6,11,3356,2068,7637,0,1809,1547,"[397, 487, 174, 348, 394, 245, 55, 142, 261, 5, 223, 0, 304, 53, 52, 192, 130, 14, 359, 298, 154, 326, 515, 52, 515, 222, 418, 329, 421]"
7,11,3960,6158,5439,0,379,3581,"[1070, 807, 316, 1020, 1011, 514, 747, 35, 326, 1038, 281, 0, 1166, 371, 951, 1046, 1150, 127, 369, 693, 800, 94, 1193, 598, 1193, 1088, 807, 850, 1141]"
8,11,3514,2598,6355,0,2003,1511,"[40, 164, 219, 244, 9, 162, 249, 468, 67, 447, 257, 0, 334, 316, 262, 480, 10, 275, 72, 383, 391, 361, 503, 463, 503, 466, 503, 170, 105]"
9,11,3549,1854,8050,0,1669,1880,"[192, 229, 376, 164, 605, 345, 320, 115, 437, 9, 102, 0, 588, 32, 370, 176, 618, 385, 228, 153, 158, 287, 626, 262, 626, 38, 147, 3, 277]"
10,11,3779,5094,6735,0,583,3196,"[404, 355, 9, 891, 130, 412, 123, 1027, 382, 942, 189, 0, 733, 245, 729, 994, 874, 258, 491, 907, 511, 491, 1065, 236, 1065, 884, 717, 148, 569]"
11,11,3552,174,10000,113,1463,2089,"[146, 642, 109, 546, 502, 544, 166, 282, 24, 249, 357, 0, 407, 187, 304, 243, 456, 611, 421, 498, 658, 293, 696, 216, 696, 322, 122, 411, 648]"
12,11,4718,6489,8229,0,3780,938,"[126, 80, 265, 300, 151, 237, 66, 184, 112, 300, 165, 0, 32, 168, 293, 311, 294, 122, 169, 147, 114, 111, 312, 269, 312, 10, 140, 306, 229]"
13,11,4846,6516,6559,0,718,4128,"[1041, 672, 1043, 604, 65, 979, 923, 1227, 360, 792, 1162, 0, 866, 283, 729, 630, 646, 52, 673, 1364, 1269, 285, 1376, 1219, 1376, 117, 1232, 990, 1029]"
14,11,3758,379,9938,0,414,3344,"[382, 696, 557, 946, 1109, 1048, 351, 131, 467, 687, 775, 0, 1061, 344, 557, 1042, 748, 564, 527, 998, 585, 796, 1114, 754, 1114, 448, 674, 515, 961]"
15,11,4522,5813,8647,0,2464,2058,"[124, 15, 327, 57, 133, 142, 210, 487, 147, 532, 133, 0, 216, 323, 628, 228, 624, 202, 526, 495, 447, 412, 686, 311, 686, 633, 659, 66, 284]"
16,11,4493,5902,7238,0,3023,1470,"[117, 168, 340, 459, 422, 365, 151, 434, 47, 24, 227, 0, 168, 9, 219, 371, 87, 0, 483, 78, 383, 469, 490, 198, 490, 339, 346, 70, 275]"
17,11,4530,7146,4622,0,2635,1895,"[308, 630, 93, 266, 481, 386, 603, 357, 44, 150, 514, 0, 618, 8, 30, 146, 235, 43, 191, 255, 219, 85, 631, 536, 631, 26, 279, 35, 232]"
18,11,3761,2085,6298,0,74,3687,"[339, 1036, 378, 811, 1189, 220, 1124, 1099, 678, 1177, 439, 0, 749, 439, 120, 102, 968, 835, 262, 959, 188, 390, 1229, 354, 1229, 806, 904, 215, 990]"
19,11,4085,2322,8061,0,1665,2420,"[628, 614, 786, 227, 526, 424, 737, 519, 225, 303, 506, 0, 605, 644, 159, 416, 97, 627, 519, 170, 495, 109, 806, 402, 806, 326, 394, 308, 234]"
20,11,3886,7458,4489,0,1621,2265,"[614, 166, 274, 149, 292, 722, 424, 361, 670, 280, 529, 0, 376, 700, 689, 27, 150, 348, 599, 634, 651, 266, 755, 360, 755, 489, 243, 750, 644]"
21,11,4382,3509,5362,0,198,4184,"[439, 286, 661, 1294, 688, 482, 172, 490, 1154, 1326, 787, 0, 385, 45, 271, 706, 943, 750, 316, 1097, 939, 1241, 1394, 1189, 1394, 751, 1077, 1262, 115]"
22,11,3779,135,9006,0,3170,609,"[130, 15, 171, 12, 67, 118, 71, 129, 86, 38, 105, 0, 136, 137, 8, 175, 111, 48, 86, 79, 185, 45, 203, 47, 203, 80, 128, 90, 10]"
23,11,4304,7344,5966,0,3461,843,"[214, 46, 131, 24, 44, 53, 23, 237, 167, 194, 23, 0, 41, 38, 88, 224, 170, 14, 59, 8, 270, 250, 281, 182, 281, 143, 91, 132, 115]"
24,11,3887,2083,7770,0,1872,2015,"[569, 605, 554, 214, 169, 72, 99, 473, 268, 313, 29, 0, 197, 632, 655, 340, 222, 637, 342, 615, 37, 14, 671, 447, 671, 627, 120, 200, 363]"
25,11,3358,5071,6057,0,2696,662,"[62, 104, 201, 90, 195, 193, 130, 26, 146, 218, 72, 0, 92, 106, 153, 173, 103, 88, 69, 215, 151, 61, 220, 48, 220, 18, 1, 209, 195]"
26,11,3621,3073,6605,0,3355,266,"[4, 36, 78, 35, 38, 43, 60, 10, 43, 64, 86, 0, 70, 51, 37, 57, 58, 71, 53, 33, 67, 45, 88, 31, 88, 27, 56, 4, 38]"
27,11,3736,1341,9000,0,96,3640,"[251, 906, 751, 1059, 1114, 959, 705, 3, 1028, 1208, 1183, 0, 1207, 646, 983, 766, 496, 519, 191, 231, 44, 1096, 1213, 962, 1213, 330, 1016, 165, 750]"
28,11,4448,6230,7218,0,1283,3165,"[547, 239, 694, 605, 746, 490, 1002, 718, 168, 817, 295, 0, 979, 681, 620, 793, 815, 681, 569, 993, 867, 957, 1055, 19, 1055, 950, 964, 56, 903]"
29,11,3720,1646,9292,0,2670,1050,"[5, 105, 338, 227, 163, 257, 290, 120, 61, 304, 184, 0, 204, 115, 154, 327, 11, 326, 282, 115, 29, 212, 350, 289, 350, 97, 233, 243, 181]"
30,11,4469,6406,7355,0,1916,2553,"[237, 107, 540, 250, 421, 39, 676, 322, 816, 402, 4, 0, 410, 463, 805, 566, 155, 809, 66, 702, 337, 641, 851, 819, 851, 448, 838, 90, 747]"
31,11,4840,6567,5628,0,1691,3149,"[191, 694, 709, 373, 383, 143, 395, 628, 969, 734, 741, 0, 838, 435, 510, 295, 468, 409, 1042, 756, 822, 359, 1049, 895, 1049, 333, 1029, 708, 265]"
32,11,4090,1811,7907,0,2559,1531,"[107, 338, 208, 146, 506, 399, 441, 440, 458, 137, 472, 0, 14, 370, 373, 375, 25, 329, 378, 365, 259, 188, 510, 449, 510, 43, 89, 142, 75]"
33,11,3582,5389,6100,0,1182,2400,"[94, 759, 530, 297, 350, 72, 370, 514, 694, 799, 186, 0, 395, 651, 584, 308, 453, 237, 381, 66, 229, 653, 800, 544, 800, 721, 642, 497, 473]"
34,11,3417,1211,8306,0,586,2831,"[429, 783, 863, 401, 385, 781, 414, 402, 232, 222, 652, 0, 707, 706, 930, 116, 940, 164, 857, 237, 409, 578, 943, 836, 943, 624, 304, 178, 54]"
35,11,4220,5140,7386,0,3623,597,"[60, 66, 151, 101, 162, 86, 139, 15, 74, 190, 111, 0, 193, 1, 63, 77, 109, 34, 96, 17, 183, 63, 199, 151, 199, 65, 132, 38, 51]"
36,11,3258,963,9681,0,1128,2130,"[273, 215, 167, 36, 284, 262, 319, 523, 381, 701, 298, 0, 479, 80, 94, 485, 179, 52, 550, 203, 386, 411, 710, 33, 710, 248, 88, 411, 687]"
37,11,3001,6444,6238,0,1622,1379,"[198, 229, 25, 235, 373, 140, 418, 405, 54, 67, 266, 0, 361, 214, 196, 271, 352, 363, 458, 269, 299, 89, 459, 365, 459, 193, 359, 434, 395]"
38,11,3216,575,8879,0,153,3063,"[757, 683, 364, 517, 632, 581, 634, 133, 962, 426, 628, 0, 71, 112, 854, 195, 682, 17, 739, 209, 671, 869, 1021, 763, 1021, 907, 528, 953, 82]"
39,11,4152,6349,6682,0,968,3184,"[505, 364, 1050, 27, 464, 1017, 926, 151, 581, 454, 76, 0, 752, 447, 85, 275, 9, 186, 925, 1018, 437, 565, 1061, 595, 1061, 199, 829, 42, 80]"
40,11,3278,638,9322,0,657,2621,"[106, 842, 615, 390, 100, 653, 526, 60, 488, 532, 120, 0, 233, 804, 643, 112, 292, 685, 416, 510, 426, 114, 873, 129, 873, 154, 353, 456, 346]"
41,11,3732,5413,7641,0,3643,89,"[9, 18, 8, 10, 22, 9, 11, 16, 20, 10, 7, 0, 5, 29, 19, 6, 24, 13, 11, 13, 25, 16, 29, 20, 29, 26, 24, 2, 29]"
42,11,4803,6996,5448,0,1736,3067,"[191, 335, 189, 618, 822, 874, 796, 460, 540, 116, 546, 0, 598, 827, 189, 345, 191, 980, 595, 312, 491, 233, 1022, 852, 1022, 525, 431, 498, 41]"
43,11,3659,3431,5676,0,3281,378,"[38, 20, 30, 25, 86, 57, 23, 79, 63, 72, 115, 0, 43, 101, 5, 31, 27, 13, 40, 119, 33, 47, 126, 99, 126, 58, 22, 75, 1]"
44,11,4413,946,9143,0,2314,2099,"[538, 212, 174, 88, 572, 185, 240, 499, 28, 424, 626, 0, 627, 379, 550, 580, 476, 601, 671, 288, 73, 587, 699, 271, 699, 182, 590, 526, 323]"
45,11,3248,5528,6863,0,902,2346,"[128, 282, 29, 581, 240, 312, 82, 744, 544, 438, 503, 0, 634, 397, 772, 563, 148, 543, 53, 748, 125, 314, 782, 224, 782, 320, 246, 780, 318]"
46,11,4600,5761,5702,0,4560,40,"[5, 5, 7, 0, 6, 10, 0, 2, 4, 4, 11, 0, 6, 4, 7, 5, 13, 2, 3, 13, 10, 3, 13, 4, 13, 1, 0, 12, 6]"
47,11,3012,691,8023,0,1287,1725,"[432, 455, 475, 342, 133, 303, 301, 517, 289, 178, 310, 0, 508, 91, 514, 318, 89, 241, 117, 557, 424, 281, 575, 495, 575, 317, 367, 62, 318]"
48,11,3032,7384,3671,0,2954,78,"[21, 26, 12, 17, 3, 0, 25, 10, 16, 24, 22, 0, 3, 12, 13, 16, 3, 22, 10, 5, 1, 20, 26, 4, 26, 17, 12, 8, 21]"
49,11,3932,3274,4329,0,1779,2153,"[542, 482, 43, 278, 584, 2, 613, 685, 467, 616, 634, 0, 384, 140, 202, 4, 647, 642, 699, 418, 50, 705, 717, 241, 717, 384, 584, 260, 76]"
50,11,4851,542,8638,0,1924,2927,"[746, 444, 458, 718, 755, 943, 481, 332, 705, 12, 259, 0, 108, 646, 908, 286, 188, 259, 23, 797, 11, 562, 975, 872, 975, 253, 15, 392, 894]"
51,11,4566,7289,5915,0,2174,2392,"[611, 641, 86, 472, 236, 104, 152, 529, 783, 662, 401, 0, 281, 165, 202, 778, 471, 727, 733, 220, 492, 284, 797, 337, 797, 163, 710, 53, 712]"
52,11,4240,379,9776,0,3495,745,"[16, 220, 3, 89, 212, 165, 110, 229, 44, 44, 23, 0, 183, 77, 170, 159, 227, 116, 164, 213, 87, 228, 248, 175, 248, 150, 144, 133, 178]"
53,11,4300,6152,7924,0,628,3672,"[120, 896, 294, 643, 461, 8, 637, 968, 865, 363, 406, 0, 899, 1184, 407, 556, 1197, 1065, 155, 42, 1154, 425, 1224, 952, 1224, 246, 205, 118, 1115]"
54,11,4122,5019,7027,0,1578,2544,"[286, 382, 374, 649, 68, 627, 489, 627, 844, 577, 165, 0, 515, 453, 461, 193, 185, 273, 505, 157, 144, 224, 848, 703, 848, 246, 828, 430, 241]"
55,11,4071,7073,4025,0,1549,2522,"[483, 161, 477, 61, 162, 223, 511, 672, 720, 108, 664, 0, 125, 305, 146, 627, 103, 539, 226, 664, 56, 58, 840, 162, 840, 2, 547, 141, 35]"
56,11,4034,3052,5007,0,3623,411,"[122, 130, 11, 94, 105, 95, 42, 33, 100, 104, 136, 0, 35, 89, 77, 17, 92, 42, 135, 114, 131, 64, 137, 99, 137, 26, 26, 88, 65]"
57,11,4546,1110,8443,0,3842,704,"[200, 24, 85, 56, 217, 87, 36, 228, 158, 42, 206, 0, 140, 209, 143, 181, 222, 230, 41, 209, 30, 137, 234, 186, 234, 229, 93, 55, 164]"
58,11,4240,6831,5852,0,1649,2591,"[115, 164, 355, 134, 502, 755, 395, 733, 309, 205, 330, 0, 657, 170, 850, 616, 359, 531, 757, 101, 734, 10, 863, 552, 863, 536, 57, 780, 742]"
59,11,4831,3399,7284,0,2940,1891,"[551, 262, 205, 307, 510, 484, 205, 237, 409, 22, 215, 0, 358, 106, 480, 218, 385, 464, 70, 530, 485, 184, 630, 616, 630, 399, 347, 569, 428]"
60,11,4485,6147,5622,0,2619,1866,"[1, 267, 419, 333, 163, 152, 272, 254, 398, 419, 590, 0, 393, 7, 38, 363, 335, 189, 475, 111, 591, 21, 622, 409, 622, 239, 360, 435, 190]"
61,11,3334,951,8005,0,2832,502,"[23, 77, 92, 3, 94, 93, 60, 105, 139, 123, 61, 0, 60, 101, 21, 32, 111, 154, 32, 17, 18, 115, 167, 137, 167, 167, 51, 41, 76]"
62,11,3186,5372,5819,0,3100,86,"[0, 27, 4, 14, 19, 1, 6, 28, 9, 11, 13, 0, 11, 7, 15, 15, 23, 26, 16, 10, 11, 16, 28, 9, 28, 1, 11, 21, 0]"
63,11,3142,366,8595,0,274,2868,"[945, 177, 455, 756, 881, 713, 676, 924, 310, 99, 658, 0, 553, 884, 502, 53, 108, 832, 590, 428, 437, 247, 956, 338, 956, 803, 360, 544, 27]"
64,11,4038,5848,6785,0,443,3595,"[110, 570, 126, 423, 117, 475, 1060, 369, 323, 70, 288, 0, 857, 1123, 35, 1180, 78, 105, 32, 1022, 625, 977, 1198, 206, 1198, 1030, 125, 492, 679]"
65,11,4516,6821,4480,0,3516,1000,"[202, 266, 248, 21, 101, 45, 240, 280, 243, 10, 254, 0, 83, 294, 21, 258, 267, 266, 87, 153, 331, 256, 333, 267, 333, 143, 109, 7, 157]"
66,11,4417,666,8231,0,611,3806,"[1058, 245, 807, 241, 535, 71, 5, 564, 341, 578, 433, 0, 158, 1120, 359, 885, 767, 817, 828, 575, 53, 802, 1268, 575, 1268, 1198, 460, 44, 610]"
67,11,3246,6873,4604,0,3115,131,"[30, 15, 35, 21, 14, 21, 14, 7, 15, 13, 14, 0, 31, 13, 13, 11, 1, 30, 36, 24, 23, 3, 43, 41, 43, 18, 10, 11, 31]"
68,11,3335,1584,6355,0,3189,146,"[45, 16, 40, 24, 14, 16, 39, 22, 16, 27, 10, 0, 44, 20, 37, 31, 15, 35, 42, 41, 17, 31, 48, 42, 48, 45, 38, 14, 3]"
69,11,3364,1709,8010,0,1588,1776,"[517, 187, 63, 405, 227, 53, 474, 509, 492, 385, 471, 0, 440, 408, 589, 227, 187, 566, 494, 289, 234, 317, 592, 513, 592, 224, 415, 117, 108]"
70,11,4245,6046,6209,0,3359,886,"[77, 219, 253, 118, 8, 85, 90, 72, 281, 172, 150, 0, 237, 147, 90, 51, 260, 146, 48, 231, 72, 136, 295, 206, 295, 19, 1, 230, 50]"
71,11,4490,585,10000,114,2931,1559,"[94, 33, 359, 202, 409, 195, 121, 91, 329, 437, 178, 0, 160, 100, 384, 387, 288, 90, 204, 86, 66, 39, 519, 51, 519, 309, 516, 497, 167]"
72,11,3214,5078,8136,0,1239,1975,"[387, 34, 615, 441, 468, 391, 297, 354, 186, 318, 414, 0, 167, 501, 560, 323, 514, 301, 514, 137, 14, 424, 658, 432, 658, 284, 627, 651, 442]"
73,11,4228,5819,6545,0,1134,3094,"[89, 15, 88, 266, 29, 344, 411, 507, 960, 86, 896, 0, 574, 230, 919, 621, 406, 258, 493, 107, 466, 722, 1031, 370, 1031, 936, 249, 424, 831]"
74,11,4159,2694,8010,0,2910,1249,"[288, 208, 177, 383, 380, 46, 384, 400, 34, 282, 351, 0, 76, 79, 182, 392, 316, 99, 148, 356, 155, 226, 416, 98, 416, 333, 8, 416, 51]"
75,11,3952,6026,5936,0,2442,1510,"[436, 56, 89, 378, 217, 487, 38, 277, 67, 376, 487, 0, 9, 76, 219, 65, 458, 59, 75, 278, 318, 313, 503, 198, 503, 46, 421, 373, 236]"
76,11,4223,3512,6647,0,3497,726,"[234, 70, 229, 39, 84, 141, 3, 190, 43, 134, 84, 0, 13, 73, 133, 197, 191, 198, 216, 124, 47, 224, 242, 0, 242, 26, 47, 24, 202]"
77,11,3057,1872,7832,0,703,2354,"[615, 163, 127, 764, 624, 19, 395, 590, 11, 490, 2, 0, 754, 209, 140, 29, 453, 449, 612, 78, 255, 159, 784, 529, 784, 454, 490, 668, 606]"
78,11,3007,2424,8415,0,764,2243,"[450, 378, 678, 80, 420, 67, 479, 154, 219, 729, 541, 0, 565, 9, 636, 380, 304, 656, 726, 532, 37, 557, 747, 603, 747, 550, 743, 676, 739]"
79,11,3051,5059,6407,0,1957,1094,"[204, 140, 132, 357, 240, 140, 231, 8, 200, 358, 229, 0, 188, 303, 48, 11, 117, 292, 116, 172, 221, 287, 364, 61, 364, 279, 318, 354, 191]"
80,11,3874,1214,9067,0,2105,1769,"[315, 221, 101, 172, 444, 273, 530, 28, 147, 470, 61, 0, 238, 352, 376, 344, 320, 98, 378, 344, 177, 484, 589, 418, 589, 359, 255, 246, 220]"
81,11,4211,5356,7922,0,420,3791,"[967, 516, 532, 755, 163, 92, 1050, 108, 190, 837, 1015, 0, 860, 3, 126, 1101, 866, 1030, 33, 539, 867, 6, 1263, 824, 1263, 135, 872, 42, 499]"
82,11,3674,6338,5258,0,1272,2402,"[359, 338, 182, 201, 59, 605, 774, 381, 41, 104, 67, 0, 680, 315, 630, 619, 120, 117, 800, 458, 79, 110, 800, 228, 800, 672, 661, 631, 304]"
83,11,4801,1246,8813,0,873,3928,"[795, 1307, 747, 54, 71, 558, 198, 492, 13, 1199, 370, 0, 757, 618, 807, 600, 117, 987, 1198, 865, 580, 46, 1309, 243, 1309, 855, 654, 207, 701]"
84,11,4976,5796,7993,0,1378,3598,"[387, 1073, 1140, 888, 172, 47, 731, 85, 701, 502, 495, 0, 1085, 708, 199, 851, 1081, 31, 124, 1099, 410, 947, 1199, 851, 1199, 927, 531, 276, 26]"
85,11,4670,7468,5195,0,3964,706,"[145, 25, 174, 170, 138, 194, 182, 52, 123, 233, 139, 0, 184, 120, 135, 136, 40, 126, 125, 172, 189, 3, 235, 181, 235, 184, 68, 77, 87]"
86,11,3467,3206,5456,0,975,2492,"[429, 235, 354, 358, 178, 558, 229, 23, 225, 109, 302, 0, 331, 253, 233, 220, 80, 58, 195, 388, 743, 570, 830, 307, 830, 391, 415, 364, 300]"
87,11,4757,1367,8846,0,1935,2822,"[912, 573, 89, 686, 408, 180, 299, 542, 727, 127, 501, 0, 192, 876, 753, 791, 649, 795, 714, 250, 465, 396, 940, 327, 940, 606, 504, 628, 103]"
88,11,3533,5328,7051,0,2607,926,"[45, 80, 185, 289, 259, 229, 126, 245, 28, 272, 255, 0, 169, 138, 59, 211, 283, 113, 3, 79, 133, 288, 308, 45, 308, 5, 220, 133, 0]"
89,11,3636,2415,8272,0,1173,2463,"[643, 813, 566, 127, 606, 509, 661, 29, 503, 588, 375, 0, 593, 485, 817, 637, 312, 527, 693, 762, 49, 816, 821, 70, 821, 242, 688, 647, 756]"
90,11,3332,5334,6270,0,819,2513,"[740, 682, 769, 566, 663, 160, 49, 253, 715, 217, 547, 0, 35, 742, 216, 617, 13, 168, 820, 753, 370, 491, 837, 776, 837, 629, 349, 477, 80]"
91,11,3518,2004,7784,0,666,2852,"[486, 156, 480, 41, 647, 164, 45, 142, 349, 720, 390, 0, 604, 941, 105, 746, 744, 300, 746, 603, 798, 273, 950, 946, 950, 111, 339, 540, 904]"
92,11,3921,5372,6333,0,668,3253,"[888, 389, 507, 876, 247, 704, 453, 989, 466, 610, 65, 0, 347, 180, 126, 718, 5, 1019, 2, 612, 924, 650, 1084, 178, 1084, 264, 401, 42, 229]"
93,11,4362,475,10000,220,228,4134,"[479, 838, 126, 807, 202, 87, 898, 1164, 1310, 1150, 426, 0, 576, 712, 411, 965, 881, 1227, 881, 1216, 702, 101, 1378, 1049, 1378, 317, 785, 445, 1256]"
94,11,3912,6323,7589,0,1116,2796,"[15, 390, 916, 85, 201, 341, 795, 680, 298, 871, 350, 0, 93, 65, 238, 93, 682, 729, 654, 17, 582, 362, 932, 314, 932, 875, 539, 773, 2]"
95,11,4367,6177,5779,0,3134,1233,"[342, 204, 284, 59, 217, 166, 138, 339, 289, 309, 356, 0, 197, 54, 291, 405, 124, 102, 367, 269, 31, 61, 411, 341, 411, 401, 280, 389, 155]"
96,11,3428,2369,6838,0,2271,1157,"[331, 255, 45, 28, 312, 110, 262, 257, 143, 310, 199, 0, 330, 363, 317, 293, 335, 358, 129, 216, 371, 359, 385, 285, 385, 363, 327, 118, 186]"
97,11,4641,7434,4045,0,2702,1939,"[276, 544, 450, 432, 325, 626, 174, 296, 114, 171, 260, 0, 488, 81, 7, 64, 162, 441, 190, 211, 34, 614, 646, 160, 646, 582, 156, 238, 507]"
98,11,4932,2072,6905,0,2875,2057,"[152, 661, 41, 430, 100, 614, 58, 72, 595, 376, 410, 0, 414, 104, 301, 394, 9, 402, 127, 19, 213, 469, 685, 29, 685, 572, 553, 17, 60]"
99,11,4706,7200,4411,0,822,3884,"[404, 993, 1111, 856, 559, 783, 1257, 782, 695, 339, 324, 0, 1293, 1223, 524, 527, 140, 615, 1251, 284, 196, 931, 1294, 304, 1294, 1029, 743, 880, 216]"
100,11,4783,2021,7173,0,2024,2759,"[488, 172, 485, 547, 645, 164, 110, 560, 805, 345, 29, 0, 324, 649, 212, 325, 450, 499, 169, 164, 148, 695, 919, 535, 919, 614, 218, 172, 38]"
101,11,3748,114,10000,807,2409,1339,"[117, 418, 247, 69, 164, 306, 39, 194, 120, 422, 132, 0, 89, 0, 141, 341, 135, 435, 232, 156, 356, 39, 446, 91, 446, 207, 120, 80, 371]"
102,11,4832,5398,9434,0,2848,1984,"[410, 522, 232, 382, 125, 343, 292, 581, 387, 199, 590, 0, 146, 52, 516, 81, 409, 251, 209, 164, 490, 570, 661, 547, 661, 563, 183, 542, 104]"
103,11,3199,6465,6168,0,201,2998,"[794, 795, 30, 70, 153, 59, 984, 164, 408, 725, 646, 0, 894, 177, 817, 233, 874, 845, 594, 441, 190, 88, 999, 742, 999, 468, 842, 949, 182]"
104,11,3794,793,9169,0,2486,1308,"[407, 127, 137, 316, 272, 238, 69, 372, 60, 7, 216, 0, 423, 417, 301, 420, 107, 48, 6, 354, 336, 278, 436, 411, 436, 92, 47, 178, 232]"
105,11,3699,5536,7332,0,3161,538,"[44, 47, 8, 143, 14, 99, 124, 132, 113, 116, 121, 0, 83, 47, 45, 109, 68, 83, 49, 14, 134, 109, 179, 19, 179, 132, 108, 152, 90]"
106,11,3983,6636,4679,0,2296,1687,"[91, 556, 78, 264, 76, 442, 68, 415, 103, 226, 116, 0, 264, 372, 420, 24, 477, 129, 331, 123, 214, 507, 562, 258, 562, 237, 142, 4, 386]"
107,11,4129,1069,7739,0,1305,2824,"[823, 627, 130, 886, 402, 9, 844, 417, 224, 633, 941, 0, 930, 917, 819, 339, 659, 597, 217, 619, 291, 654, 941, 161, 941, 349, 452, 314, 358]"
108,11,4007,7185,4561,0,1860,2147,"[322, 617, 403, 41, 495, 115, 664, 383, 363, 650, 703, 0, 633, 59, 16, 256, 714, 299, 330, 581, 614, 226, 715, 169, 715, 86, 282, 434, 407]"
109,11,4164,3088,5637,0,1750,2414,"[486, 758, 36, 162, 91, 425, 453, 682, 270, 313, 255, 0, 282, 193, 120, 5, 756, 75, 201, 40, 417, 437, 804, 406, 804, 410, 260, 754, 656]"
110,11,4515,1851,8301,0,53,4462,"[898, 839, 933, 1251, 365, 1037, 6, 540, 176, 478, 804, 0, 229, 859, 205, 884, 997, 19, 242, 521, 846, 24, 1487, 129, 1487, 794, 1090, 232, 221]"
111,11,3503,7361,4443,0,3169,334,"[16, 105, 68, 56, 83, 108, 55, 85, 45, 18, 92, 0, 3, 97, 76, 37, 1, 54, 10, 19, 90, 89, 111, 109, 111, 91, 57, 83, 15]"
112,11,4056,1447,7052,0,3666,390,"[123, 37, 7, 25, 43, 52, 60, 123, 72, 96, 118, 0, 59, 39, 81, 115, 56, 60, 112, 92, 57, 79, 130, 103, 130, 48, 14, 65, 38]"
113,11,3514,458,10000,108,2410,1104,"[67, 4, 91, 207, 230, 148, 344, 189, 159, 19, 325, 0, 349, 95, 364, 309, 83, 312, 259, 353, 348, 210, 368, 357, 368, 154, 126, 345, 203]"
114,11,4844,5083,9761,0,2103,2741,"[584, 629, 509, 411, 904, 180, 212, 765, 308, 297, 785, 0, 253, 492, 71, 188, 398, 330, 718, 286, 590, 211, 913, 580, 913, 146, 890, 456, 795]"
115,11,4203,7114,6850,0,4201,2,"[0, 0, 0, 0, 0, 0, 0, 0, 0, 0, 0, 0, 0, 0, 0, 0, 0, 0, 0, 0, 0, 0, 0, 0, 0, 0, 0, 0, 0]"
116,11,3505,1098,9257,0,1817,1688,"[465, 236, 314, 99, 466, 301, 8, 548, 552, 431, 331, 0, 363, 362, 80, 71, 70, 171, 323, 409, 327, 205, 562, 175, 562, 520, 467, 80, 120]"
117,11,3795,6872,6180,0,891,2904,"[534, 95, 451, 452, 615, 183, 828, 814, 405, 69, 673, 0, 195, 150, 413, 864, 225, 232, 961, 65, 246, 785, 968, 905, 968, 659, 99, 374, 927]"
118,11,4385,3870,6695,0,3553,832,"[18, 94, 237, 153, 26, 84, 3, 128, 153, 232, 9, 0, 241, 108, 235, 22, 183, 193, 172, 70, 58, 165, 277, 236, 277, 54, 226, 74, 218]"
119,11,3298,2948,7045,0,468,2830,"[254, 240, 860, 383, 363, 620, 395, 52, 636, 106, 650, 0, 789, 521, 714, 770, 942, 849, 323, 418, 79, 687, 943, 95, 943, 940, 924, 461, 147]"
0,12,4927,0,4927,0,2319,2608,"[477, 651, 71, 22, 200, 480, 811, 695, 473, 680, 720, 337, 0, 298, 148, 149, 238, 73, 181, 670, 756, 780, 618, 41, 149, 869, 780, 101, 869]"
1,12,3767,449,8245,0,782,2985,"[864, 316, 762, 700, 388, 829, 845, 230, 447, 538, 512, 23, 0, 151, 626, 158, 415, 608, 236, 933, 954, 332, 866, 599, 578, 995, 253, 745, 995]"
2,12,4122,6252,6115,0,3713,409,"[116, 85, 105, 72, 105, 135, 6, 51, 80, 21, 46, 85, 0, 93, 1, 89, 107, 85, 50, 90, 114, 27, 54, 65, 63, 136, 50, 101, 136]"
3,12,4362,113,10000,364,1810,2552,"[328, 532, 769, 359, 343, 254, 51, 716, 514, 528, 559, 676, 0, 735, 477, 186, 788, 91, 132, 802, 222, 444, 138, 32, 242, 850, 58, 652, 850]"
4,12,3181,5130,8051,0,2371,810,"[62, 113, 32, 36, 78, 15, 226, 112, 196, 180, 85, 44, 0, 118, 182, 151, 38, 258, 9, 214, 268, 58, 68, 160, 131, 270, 77, 192, 270]"
5,12,4556,5011,7596,0,311,4245,"[1333, 1043, 88, 411, 1222, 314, 263, 465, 102, 139, 1189, 1336, 0, 826, 820, 110, 373, 1073, 551, 357, 1064, 598, 1365, 1351, 1329, 1415, 903, 570, 1415]"
6,12,4575,6157,6014,0,4084,491,"[79, 10, 14, 61, 39, 117, 150, 160, 104, 89, 150, 112, 0, 111, 151, 117, 53, 65, 90, 30, 138, 143, 68, 104, 26, 163, 9, 43, 163]"
7,12,3863,639,9238,0,2290,1573,"[249, 144, 396, 251, 411, 107, 25, 39, 153, 449, 338, 350, 0, 63, 175, 245, 172, 116, 217, 344, 320, 7, 3, 190, 233, 524, 323, 15, 524]"
8,12,4424,6558,7104,0,725,3699,"[134, 352, 432, 354, 1232, 586, 99, 732, 608, 671, 293, 462, 0, 145, 1028, 150, 350, 281, 998, 723, 759, 92, 956, 430, 623, 1233, 545, 1092, 1233]"
9,12,4905,5499,6510,0,537,4368,"[725, 1151, 386, 594, 503, 479, 53, 865, 1438, 188, 831, 517, 0, 1093, 36, 1409, 684, 363, 713, 1069, 394, 1442, 43, 126, 1300, 1456, 348, 209, 1456]"
10,12,3296,867,8939,0,1281,2015,"[108, 70, 156, 482, 599, 295, 268, 145, 661, 17, 192, 419, 0, 633, 279, 591, 415, 600, 566, 498, 646, 362, 237, 206, 467, 671, 20, 178, 671]"
11,12,3612,7294,5257,0,3323,289,"[41, 3, 49, 29, 61, 39, 55, 20, 38, 46, 6, 38, 0, 24, 29, 78, 87, 70, 72, 51, 96, 70, 78, 23, 57, 96, 8, 54, 96]"
12,12,3223,542,7938,0,2405,818,"[160, 106, 98, 187, 122, 225, 39, 264, 162, 64, 178, 210, 0, 137, 88, 30, 113, 248, 166, 177, 227, 189, 34, 0, 126, 272, 81, 210, 272]"
13,12,3374,7052,4260,0,1114,2260,"[235, 192, 381, 432, 643, 474, 455, 132, 728, 499, 274, 334, 0, 648, 350, 184, 56, 410, 274, 699, 721, 526, 494, 693, 129, 753, 643, 741, 753]"
14,12,4868,3054,6074,0,739,4129,"[593, 751, 1317, 1002, 899, 624, 863, 567, 399, 368, 359, 339, 0, 679, 124, 601, 781, 616, 641, 1028, 911, 456, 1180, 856, 444, 1376, 1161, 58, 1376]"
15,12,4914,4199,6789,0,41,4873,"[629, 101, 1471, 1351, 1303, 468, 1099, 961, 360, 80, 268, 1286, 0, 376, 36, 358, 194, 233, 89, 969, 54, 1548, 1260, 902, 1113, 1624, 64, 47, 1624]"
16,12,3478,2048,8219,0,1432,2046,"[133, 28, 224, 521, 86, 284, 520, 630, 10, 319, 595, 109, 0, 471, 575, 75, 0, 258, 390, 548, 138, 333, 556, 159, 21, 682, 348, 201, 682]"
17,12,3520,5511,6228,0,592,2928,"[689, 391, 526, 455, 355, 823, 212, 384, 575, 201, 149, 218, 0, 155, 8, 661, 926, 130, 796, 369, 789, 686, 119, 421, 557, 976, 852, 533, 976]"
18,12,4365,2852,7741,0,1074,3291,"[386, 17, 935, 760, 694, 906, 427, 744, 571, 428, 1043, 232, 0, 999, 855, 134, 511, 231, 635, 64, 973, 192, 133, 963, 632, 1097, 69, 179, 1097]"
19,12,3234,986,9989,0,1369,1865,"[173, 538, 602, 287, 141, 574, 378, 147, 492, 418, 245, 140, 0, 323, 336, 280, 339, 542, 519, 141, 13, 149, 323, 257, 123, 621, 10, 180, 621]"
20,12,4282,7437,6834,0,3944,338,"[74, 56, 96, 69, 52, 103, 89, 85, 108, 10, 20, 82, 0, 4, 112, 101, 48, 112, 84, 90, 51, 25, 108, 3, 8, 112, 64, 70, 112]"
21,12,3641,1348,9127,0,1463,2178,"[626, 559, 191, 583, 456, 658, 684, 438, 307, 589, 268, 72, 0, 658, 216, 401, 501, 439, 128, 648, 518, 294, 671, 577, 682, 726, 421, 257, 726]"
22,12,3519,6661,5985,0,2829,690,"[75, 119, 129, 58, 197, 175, 116, 50, 182, 226, 78, 162, 0, 33, 212, 43, 112, 44, 112, 156, 157, 227, 124, 23, 47, 230, 60, 58, 230]"
23,12,3556,1986,7555,0,2866,690,"[95, 210, 57, 21, 2, 80, 100, 13, 41, 65, 126, 126, 0, 135, 196, 143, 22, 228, 153, 212, 182, 58, 91, 171, 74, 230, 4, 32, 230]"
24,12,4625,7415,4765,0,2760,1865,"[134, 249, 110, 594, 313, 126, 170, 269, 263, 364, 340, 173, 0, 331, 489, 63, 50, 348, 216, 187, 403, 417, 397, 416, 148, 621, 105, 37, 621]"
25,12,3217,868,7114,0,929,2288,"[507, 433, 668, 226, 245, 171, 341, 597, 191, 56, 261, 458, 0, 123, 366, 262, 204, 679, 341, 590, 512, 718, 173, 434, 559, 762, 637, 314, 762]"
26,12,4687,6125,5676,0,2009,2678,"[862, 249, 412, 488, 606, 508, 303, 156, 68, 855, 535, 208, 0, 423, 279, 118, 119, 521, 724, 769, 503, 555, 341, 399, 662, 892, 187, 890, 892]"
27,12,3018,793,7901,0,1090,1928,"[574, 389, 303, 136, 527, 619, 575, 287, 123, 346, 316, 411, 0, 78, 605, 155, 584, 346, 541, 478, 364, 79, 273, 245, 363, 642, 83, 93, 642]"
28,12,3280,5679,5502,0,1707,1573,"[143, 461, 75, 46, 88, 142, 11, 454, 416, 321, 8, 327, 0, 132, 442, 494, 492, 172, 80, 1, 393, 134, 215, 147, 128, 524, 120, 349, 524]"
29,12,3057,1210,7349,0,2475,582,"[25, 23, 136, 88, 164, 8, 189, 42, 153, 5, 117, 105, 0, 82, 155, 0, 137, 147, 145, 125, 182, 127, 42, 13, 37, 194, 81, 131, 194]"
30,12,3376,579,10000,146,555,2821,"[863, 104, 336, 580, 213, 553, 490, 403, 226, 164, 131, 845, 0, 865, 756, 919, 292, 338, 99, 838, 550, 754, 142, 107, 361, 940, 35, 270, 940]"
31,12,3650,5706,7944,0,186,3464,"[508, 71, 753, 832, 704, 162, 458, 910, 483, 855, 335, 838, 0, 283, 226, 1026, 290, 1022, 552, 663, 248, 339, 897, 426, 396, 1154, 830, 944, 1154]"
32,12,4718,5346,7316,0,2289,2429,"[723, 29, 637, 80, 708, 508, 777, 218, 49, 149, 411, 380, 0, 70, 202, 669, 655, 688, 484, 441, 112, 809, 693, 802, 204, 809, 719, 583, 809]"
33,12,4163,5618,5861,0,2702,1461,"[289, 106, 129, 440, 237, 413, 73, 74, 374, 114, 451, 268, 0, 363, 337, 381, 381, 193, 256, 215, 13, 260, 461, 99, 147, 487, 156, 52, 487]"
34,12,4998,4233,6626,0,967,4031,"[560, 140, 1331, 984, 764, 957, 245, 1026, 1098, 1076, 288, 922, 0, 1053, 285, 433, 1143, 630, 187, 90, 349, 596, 1047, 1184, 1312, 1343, 720, 464, 1343]"
35,12,4841,6342,5125,0,621,4220,"[592, 716, 942, 600, 150, 541, 82, 182, 728, 1098, 55, 433, 0, 210, 1084, 1152, 827, 1273, 1354, 552, 1117, 121, 741, 115, 1067, 1406, 1153, 546, 1406]"
36,12,4988,2873,7240,0,4129,859,"[268, 263, 261, 132, 203, 115, 199, 103, 216, 127, 2, 78, 0, 102, 170, 216, 194, 136, 56, 225, 148, 155, 208, 47, 261, 286, 168, 77, 286]"
37,12,4434,7296,4378,0,606,3828,"[267, 618, 1224, 19, 458, 686, 1165, 528, 709, 242, 1037, 1274, 0, 829, 798, 1057, 1067, 706, 857, 461, 472, 529, 471, 349, 1264, 1276, 501, 31, 1276]"
38,12,4755,2411,6722,0,3616,1139,"[46, 245, 365, 228, 224, 125, 177, 321, 205, 221, 341, 23, 0, 7, 213, 159, 183, 53, 213, 210, 130, 129, 73, 73, 293, 379, 252, 102, 379]"
39,12,3732,3390,7064,0,221,3511,"[147, 5, 300, 902, 393, 930, 22, 353, 157, 258, 354, 497, 0, 293, 891, 115, 369, 1131, 697, 993, 831, 855, 99, 1121, 769, 1170, 4, 381, 1170]"
40,12,3756,395,10000,425,1174,2582,"[601, 795, 792, 148, 100, 306, 104, 650, 816, 556, 231, 725, 0, 172, 328, 856, 71, 506, 97, 449, 540, 239, 204, 38, 546, 860, 183, 562, 860]"
41,12,3606,5604,8002,0,2563,1043,"[21, 313, 259, 245, 183, 38, 44, 216, 156, 304, 60, 272, 0, 213, 321, 104, 110, 305, 4, 74, 257, 302, 14, 241, 44, 347, 282, 87, 347]"
42,12,4903,5966,6939,0,3000,1903,"[627, 0, 554, 385, 167, 2, 125, 631, 172, 271, 8, 351, 0, 170, 611, 342, 622, 353, 225, 540, 150, 126, 273, 159, 128, 634, 53, 408, 634]"
43,12,4982,6991,4930,0,2443,2539,"[527, 773, 479, 441, 208, 383, 826, 248, 431, 732, 827, 147, 0, 57, 209, 150, 833, 7, 648, 5, 71, 139, 693, 740, 263, 846, 488, 224, 846]"
44,12,4312,2252,6990,0,1744,2568,"[430, 836, 579, 430, 7, 574, 666, 663, 113, 435, 446, 162, 0, 261, 550, 213, 694, 307, 797, 88, 744, 352, 253, 631, 291, 856, 12, 614, 856]"
45,12,4553,7108,4435,0,1561,2992,"[718, 277, 955, 300, 747, 584, 31, 28, 317, 784, 466, 190, 0, 981, 180, 473, 25, 804, 934, 18, 980, 487, 83, 807, 700, 997, 237, 240, 997]"
46,12,4998,4722,4711,0,2947,2051,"[204, 570, 249, 650, 380, 43, 218, 370, 400, 456, 61, 283, 0, 114, 55, 52, 518, 326, 116, 219, 616, 559, 606, 157, 631, 683, 350, 1, 683]"
47,12,3669,863,7517,0,3287,382,"[102, 120, 16, 91, 112, 30, 126, 43, 87, 64, 90, 39, 0, 27, 127, 19, 124, 38, 43, 46, 126, 13, 52, 71, 111, 127, 37, 91, 127]"
48,12,4004,5456,6065,0,1407,2597,"[492, 174, 148, 796, 415, 455, 494, 516, 86, 754, 568, 27, 0, 331, 238, 249, 560, 733, 389, 462, 92, 544, 560, 610, 819, 865, 264, 458, 865]"
49,12,3549,1519,8095,0,612,2937,"[480, 304, 58, 807, 695, 195, 232, 443, 52, 594, 653, 557, 0, 860, 743, 643, 810, 602, 491, 184, 778, 501, 726, 381, 167, 979, 956, 281, 979]"
50,12,4744,5617,7222,0,327,4417,"[548, 1118, 429, 1103, 68, 506, 160, 561, 463, 652, 597, 1024, 0, 861, 587, 986, 797, 38, 198, 185, 138, 28, 397, 206, 1037, 1472, 613, 792, 1472]"
51,12,3169,618,9773,0,941,2228,"[492, 663, 687, 548, 240, 688, 357, 541, 383, 594, 614, 591, 0, 73, 55, 143, 131, 500, 142, 448, 69, 650, 361, 309, 210, 742, 56, 338, 742]"
52,12,4501,7403,6871,0,2054,2447,"[58, 633, 218, 329, 12, 726, 638, 512, 752, 798, 106, 487, 0, 381, 307, 735, 647, 703, 604, 163, 91, 255, 658, 590, 203, 815, 299, 504, 815]"
53,12,4605,6104,5372,0,3711,894,"[105, 143, 283, 180, 236, 174, 31, 96, 54, 107, 96, 113, 0, 185, 106, 274, 67, 4, 233, 84, 264, 167, 274, 279, 8, 298, 65, 15, 298]"
54,12,3862,2587,6647,0,237,3625,"[551, 1193, 61, 568, 87, 73, 829, 624, 63, 473, 150, 86, 0, 796, 287, 172, 723, 952, 442, 765, 709, 396, 180, 634, 1179, 1208, 651, 801, 1208]"
55,12,3879,2739,7787,0,3317,562,"[77, 21, 65, 7, 164, 174, 94, 37, 88, 70, 57, 123, 0, 38, 141, 165, 34, 150, 77, 118, 140, 159, 2, 8, 39, 187, 35, 20, 187]"
56,12,4660,7273,5174,0,2757,1903,"[432, 370, 256, 444, 600, 581, 482, 309, 458, 369, 397, 555, 0, 266, 78, 411, 482, 56, 478, 231, 548, 389, 102, 113, 539, 634, 467, 500, 634]"
57,12,3764,2563,6375,0,1866,1898,"[179, 338, 50, 72, 292, 601, 73, 417, 531, 182, 280, 187, 0, 622, 371, 150, 353, 288, 561, 146, 577, 467, 363, 114, 473, 632, 180, 272, 632]"
58,12,3690,2446,7619,0,1623,2067,"[688, 66, 131, 403, 156, 128, 648, 64, 582, 151, 322, 241, 0, 234, 458, 252, 600, 117, 553, 561, 162, 395, 328, 312, 69, 689, 246, 518, 689]"
59,12,4623,6978,5264,0,315,4308,"[774, 340, 955, 491, 146, 403, 1381, 1058, 232, 414, 536, 981, 0, 1423, 58, 373, 307, 754, 859, 663, 1200, 893, 941, 284, 995, 1436, 1212, 173, 1436]"
60,12,3467,2258,6473,0,2118,1349,"[33, 275, 442, 136, 245, 382, 206, 146, 380, 32, 57, 189, 0, 352, 184, 30, 232, 229, 55, 313, 345, 322, 196, 114, 151, 449, 293, 355, 449]"
61,12,4029,3235,7267,0,259,3770,"[529, 420, 547, 92, 1121, 1124, 168, 476, 1063, 1024, 89, 462, 0, 146, 909, 679, 382, 331, 445, 432, 111, 1144, 849, 812, 575, 1256, 40, 1012, 1256]"
62,12,3117,2447,7937,0,770,2347,"[738, 171, 145, 463, 562, 655, 674, 774, 75, 52, 31, 581, 0, 677, 197, 587, 695, 45, 234, 267, 472, 27, 105, 752, 695, 782, 223, 608, 782]"
63,12,3934,7460,4411,0,1699,2235,"[497, 73, 377, 357, 105, 618, 418, 285, 210, 128, 499, 649, 0, 742, 112, 691, 617, 368, 41, 509, 40, 702, 88, 177, 61, 745, 97, 221, 745]"
64,12,3933,1630,6714,0,1694,2239,"[147, 151, 98, 397, 120, 203, 321, 687, 652, 65, 135, 273, 0, 633, 392, 127, 285, 348, 174, 81, 687, 309, 252, 744, 536, 746, 232, 341, 746]"
65,12,3330,3004,7040,0,1919,1411,"[460, 227, 204, 172, 466, 248, 73, 439, 399, 195, 36, 107, 0, 371, 292, 430, 139, 430, 133, 288, 454, 321, 324, 236, 153, 470, 341, 35, 470]"
66,12,3734,1934,8840,0,733,3001,"[225, 752, 164, 137, 895, 197, 674, 209, 209, 234, 459, 138, 0, 449, 138, 204, 467, 529, 196, 627, 332, 707, 726, 570, 684, 1000, 867, 725, 1000]"
67,12,3452,7198,5094,0,2012,1440,"[278, 109, 150, 118, 138, 312, 266, 101, 91, 290, 401, 106, 0, 174, 414, 285, 345, 17, 335, 201, 437, 213, 334, 231, 272, 480, 251, 204, 480]"
68,12,4164,2838,6420,0,581,3583,"[91, 356, 366, 238, 266, 674, 760, 1153, 606, 834, 824, 601, 0, 248, 606, 545, 1181, 835, 1153, 724, 149, 595, 1037, 39, 250, 1194, 373, 1006, 1194]"
69,12,4240,1268,9392,0,1829,2411,"[642, 60, 752, 236, 345, 14, 31, 710, 387, 152, 20, 585, 0, 6, 220, 641, 752, 83, 559, 555, 626, 576, 326, 727, 269, 803, 299, 132, 803]"
70,12,3890,6599,6683,0,2331,1559,"[444, 47, 190, 116, 77, 253, 16, 306, 443, 351, 43, 261, 0, 353, 488, 348, 164, 8, 142, 384, 198, 81, 410, 180, 207, 519, 237, 63, 519]"
71,12,4984,6706,4961,0,1503,3481,"[945, 427, 365, 141, 715, 266, 208, 1117, 357, 251, 502, 352, 0, 608, 507, 360, 523, 387, 880, 507, 572, 851, 1134, 215, 845, 1160, 56, 544, 1160]"
72,12,4277,1646,7592,0,1096,3181,"[889, 136, 1049, 407, 567, 311, 503, 183, 75, 552, 735, 868, 0, 358, 226, 909, 506, 271, 433, 87, 294, 544, 439, 396, 586, 1060, 221, 618, 1060]"
73,12,3599,5736,5455,0,226,3373,"[786, 166, 127, 512, 668, 622, 896, 301, 297, 281, 700, 385, 0, 356, 670, 82, 734, 406, 993, 1045, 1057, 568, 781, 632, 134, 1124, 212, 446, 1124]"
74,12,3035,3009,5481,0,1143,1892,"[1, 623, 504, 10, 15, 369, 306, 118, 321, 50, 381, 400, 0, 483, 205, 248, 137, 189, 301, 617, 413, 93, 185, 404, 172, 630, 96, 45, 630]"
75,12,3769,2392,6858,0,626,3143,"[327, 307, 352, 123, 299, 298, 787, 501, 313, 361, 429, 692, 0, 453, 565, 978, 223, 510, 412, 1007, 1013, 384, 123, 984, 128, 1047, 897, 488, 1047]"
76,12,4717,6871,4704,0,3067,1650,"[27, 487, 229, 86, 52, 44, 148, 363, 456, 500, 534, 374, 0, 155, 383, 331, 102, 442, 499, 152, 183, 452, 545, 73, 521, 550, 441, 478, 550]"
77,12,3014,1230,6488,0,562,2452,"[576, 754, 651, 463, 92, 666, 93, 148, 419, 707, 513, 364, 0, 753, 320, 764, 70, 266, 510, 813, 802, 658, 573, 601, 62, 817, 343, 713, 817]"
78,12,3623,1087,9024,0,305,3318,"[231, 1104, 825, 787, 1040, 122, 123, 49, 321, 143, 306, 797, 0, 678, 668, 6, 65, 520, 758, 41, 662, 6, 162, 690, 512, 1106, 252, 829, 1106]"
79,12,4484,5173,8335,0,4161,323,"[99, 0, 60, 82, 15, 74, 52, 68, 101, 30, 70, 97, 0, 29, 38, 85, 56, 99, 86, 54, 87, 15, 95, 69, 44, 107, 82, 73, 107]"
80,12,3105,7042,4398,0,1807,1298,"[256, 239, 393, 222, 102, 283, 337, 296, 157, 295, 410, 427, 0, 156, 317, 246, 359, 218, 254, 204, 293, 172, 413, 294, 235, 432, 359, 213, 432]"
81,12,3099,109,7388,0,2489,610,"[103, 11, 179, 68, 68, 36, 4, 193, 109, 85, 88, 88, 0, 151, 76, 195, 0, 140, 159, 48, 110, 153, 107, 137, 113, 203, 134, 136, 203]"
82,12,3719,6582,4525,0,3684,35,"[1, 9, 10, 11, 8, 6, 0, 11, 1, 2, 11, 11, 0, 4, 8, 8, 5, 5, 3, 9, 10, 5, 8, 7, 11, 11, 1, 8, 11]"
83,12,3408,224,7709,0,506,2902,"[760, 116, 820, 496, 509, 744, 904, 623, 533, 171, 759, 834, 0, 961, 838, 124, 617, 599, 771, 875, 282, 939, 282, 250, 103, 967, 622, 145, 967]"
84,12,4848,6027,6530,0,3298,1550,"[451, 446, 40, 31, 232, 169, 220, 111, 497, 265, 515, 292, 0, 48, 29, 49, 13, 441, 64, 101, 155, 376, 433, 393, 205, 516, 241, 478, 516]"
85,12,4741,6311,4960,0,869,3872,"[212, 241, 891, 467, 1175, 869, 388, 734, 116, 68, 134, 922, 0, 423, 918, 993, 888, 93, 238, 875, 660, 528, 1111, 588, 50, 1290, 1000, 512, 1290]"
86,12,3025,898,7087,0,279,2746,"[174, 530, 601, 702, 757, 213, 460, 124, 16, 388, 849, 348, 0, 544, 107, 40, 778, 315, 601, 865, 831, 18, 270, 346, 453, 915, 671, 776, 915]"
87,12,3060,1434,8713,0,1127,1933,"[266, 495, 318, 315, 609, 92, 486, 573, 580, 467, 352, 11, 0, 320, 285, 569, 36, 482, 510, 533, 265, 348, 172, 100, 420, 644, 594, 595, 644]"
88,12,4935,7294,6354,0,2291,2644,"[502, 20, 786, 871, 301, 111, 796, 353, 298, 565, 77, 426, 0, 231, 65, 374, 733, 270, 576, 502, 577, 865, 318, 257, 149, 881, 875, 365, 881]"
89,12,4440,2041,8753,0,2973,1467,"[393, 153, 265, 58, 381, 82, 223, 365, 138, 279, 350, 279, 0, 441, 137, 474, 181, 327, 186, 94, 268, 189, 280, 422, 469, 489, 310, 480, 489]"
90,12,3123,5342,6534,0,112,3011,"[145, 830, 462, 179, 999, 197, 190, 648, 166, 569, 992, 760, 0, 953, 289, 91, 315, 42, 90, 102, 21, 496, 517, 213, 322, 1003, 219, 277, 1003]"
91,12,3393,2990,6937,0,2868,525,"[52, 52, 81, 139, 18, 117, 154, 98, 155, 127, 159, 118, 0, 169, 70, 30, 60, 49, 31, 55, 53, 18, 89, 152, 9, 175, 97, 14, 175]"
92,12,3968,1905,9000,0,415,3553,"[1144, 224, 912, 1174, 463, 532, 71, 538, 631, 876, 758, 460, 0, 329, 1150, 245, 764, 433, 740, 215, 890, 95, 834, 109, 1038, 1184, 1030, 219, 1184]"
93,12,3601,6630,5971,0,847,2754,"[617, 693, 508, 401, 883, 11, 878, 89, 452, 245, 486, 242, 0, 322, 799, 68, 914, 581, 181, 381, 768, 44, 112, 801, 164, 918, 747, 384, 918]"
94,12,3410,2696,6685,0,112,3298,"[613, 1082, 94, 896, 795, 747, 1028, 597, 748, 303, 1061, 536, 0, 132, 998, 146, 564, 797, 70, 563, 513, 63, 939, 927, 579, 1099, 755, 896, 1099]"
95,12,3493,2453,7725,0,429,3064,"[724, 785, 711, 109, 787, 194, 278, 81, 300, 322, 987, 646, 0, 590, 570, 246, 146, 425, 109, 951, 243, 590, 380, 928, 992, 1021, 684, 481, 1021]"
96,12,4240,6783,5182,0,456,3784,"[431, 877, 332, 1169, 49, 872, 269, 1237, 111, 1057, 516, 947, 0, 758, 119, 343, 674, 299, 250, 1173, 260, 1040, 1132, 101, 463, 1261, 629, 755, 1261]"
97,12,4886,3304,6764,0,3154,1732,"[556, 92, 526, 571, 448, 349, 260, 71, 28, 478, 341, 30, 0, 571, 461, 357, 230, 520, 341, 527, 277, 250, 366, 211, 67, 577, 474, 445, 577]"
98,12,4704,6966,4502,0,2295,2409,"[625, 532, 30, 131, 179, 10, 30, 649, 401, 785, 324, 25, 0, 347, 115, 763, 500, 145, 269, 479, 129, 303, 201, 742, 420, 803, 137, 656, 803]"
99,12,3306,1498,6310,0,154,3152,"[307, 596, 683, 777, 365, 539, 514, 486, 761, 427, 928, 974, 0, 341, 816, 445, 733, 253, 456, 270, 219, 330, 578, 684, 756, 1050, 180, 461, 1050]"
100,12,4541,3226,7625,0,3976,565,"[14, 165, 32, 48, 88, 68, 83, 181, 61, 5, 23, 45, 0, 165, 54, 155, 45, 41, 168, 76, 173, 97, 86, 42, 98, 188, 140, 70, 188]"
101,12,3470,6036,5059,0,408,3062,"[458, 1011, 285, 367, 476, 852, 101, 646, 13, 65, 881, 1002, 0, 880, 790, 678, 768, 18, 586, 42, 617, 499, 800, 440, 236, 1020, 612, 570, 1020]"
102,12,3790,2478,6371,0,298,3492,"[1074, 910, 932, 174, 739, 1092, 439, 37, 302, 1111, 22, 518, 0, 343, 338, 1033, 1030, 1154, 75, 518, 324, 989, 227, 541, 9, 1164, 565, 649, 1164]"
103,12,4002,2612,7761,0,2473,1529,"[149, 368, 306, 157, 133, 125, 319, 451, 344, 470, 253, 201, 0, 122, 462, 184, 283, 336, 253, 18, 356, 155, 269, 212, 229, 509, 47, 71, 509]"
104,12,4761,7259,5263,0,387,4374,"[1036, 621, 248, 167, 556, 1081, 70, 1323, 1241, 1141, 8, 743, 0, 1255, 2, 9, 93, 1231, 616, 727, 918, 1387, 12, 1421, 1435, 1458, 528, 1267, 1458]"
105,12,4191,448,9006,0,3699,492,"[154, 8, 90, 51, 138, 146, 78, 78, 4, 139, 157, 102, 0, 145, 64, 49, 142, 148, 0, 94, 51, 93, 118, 68, 62, 164, 113, 114, 164]"
106,12,3825,5787,7044,0,3529,296,"[78, 10, 81, 13, 43, 88, 43, 46, 68, 87, 59, 46, 0, 58, 85, 4, 63, 50, 88, 71, 78, 97, 10, 85, 34, 98, 48, 21, 98]"
107,12,4209,6149,5104,0,1315,2894,"[347, 628, 937, 499, 497, 78, 769, 865, 640, 215, 798, 133, 0, 831, 759, 780, 319, 776, 148, 727, 303, 938, 394, 429, 509, 964, 739, 323, 964]"
108,12,3281,2432,5953,0,1791,1490,"[236, 122, 496, 354, 76, 409, 228, 192, 373, 111, 104, 175, 0, 208, 46, 20, 300, 166, 323, 114, 128, 114, 342, 166, 342, 496, 107, 270, 496]"
109,12,4635,918,9670,0,2822,1813,"[393, 180, 197, 67, 55, 340, 585, 308, 233, 325, 101, 308, 0, 250, 155, 78, 422, 84, 361, 311, 466, 8, 519, 493, 1, 604, 597, 594, 604]"
110,12,4447,6932,7185,0,2544,1903,"[513, 200, 260, 312, 469, 173, 126, 594, 231, 517, 413, 523, 0, 619, 407, 590, 126, 496, 578, 228, 163, 186, 424, 195, 457, 634, 542, 219, 634]"
111,12,4227,5438,5974,0,3535,692,"[186, 205, 46, 164, 214, 208, 161, 9, 75, 15, 221, 207, 0, 136, 82, 96, 85, 218, 197, 152, 102, 3, 169, 135, 192, 230, 162, 89, 230]"
112,12,4264,1574,8664,0,2390,1874,"[488, 540, 129, 433, 106, 549, 260, 423, 113, 269, 231, 297, 0, 425, 187, 613, 81, 165, 17, 608, 455, 238, 494, 41, 547, 624, 248, 620, 624]"
113,12,4358,6441,6581,0,2629,1729,"[186, 448, 257, 238, 524, 484, 473, 403, 131, 447, 433, 498, 0, 148, 338, 464, 416, 205, 489, 91, 317, 465, 169, 88, 367, 576, 293, 45, 576]"
114,12,3979,3634,6926,0,1329,2650,"[50, 4, 684, 867, 685, 31, 824, 316, 744, 806, 354, 868, 0, 356, 738, 544, 15, 532, 566, 675, 474, 877, 829, 856, 69, 883, 422, 683, 883]"
115,12,4552,6308,5170,0,2133,2419,"[627, 185, 536, 21, 333, 794, 55, 209, 755, 609, 292, 754, 0, 422, 703, 392, 277, 158, 79, 563, 180, 447, 240, 543, 494, 806, 464, 11, 806]"
116,12,4533,1660,8043,0,4518,15,"[0, 2, 4, 2, 4, 3, 0, 1, 1, 0, 1, 1, 0, 4, 0, 1, 0, 5, 5, 1, 5, 4, 2, 3, 5, 5, 4, 2, 5]"
117,12,4874,6465,6452,0,908,3966,"[91, 66, 478, 316, 1284, 628, 497, 473, 603, 684, 128, 1223, 0, 878, 1100, 638, 514, 404, 852, 582, 917, 460, 81, 1268, 742, 1322, 250, 783, 1322]"
118,12,4500,3683,7269,0,2797,1703,"[209, 11, 226, 418, 79, 123, 46, 328, 521, 486, 290, 448, 0, 244, 82, 136, 332, 405, 466, 119, 44, 342, 149, 163, 557, 567, 26, 546, 567]"
119,12,4715,6389,5595,0,4697,18,"[3, 3, 6, 1, 6, 5, 2, 2, 4, 2, 5, 0, 0, 3, 5, 3, 5, 5, 0, 3, 4, 0, 3, 1, 2, 6, 1, 2, 6]"
0,13,2769,0,2769,0,1099,1670,"[481, 27, 530, 33, 134, 272, 416, 142, 86, 279, 216, 428, 407, 0, 193, 287, 78, 208, 556, 401, 542, 556, 476, 233, 245, 117, 555, 22, 111]"
1,13,1247,373,3643,0,1146,101,"[20, 8, 6, 11, 16, 26, 32, 19, 2, 20, 33, 3, 33, 0, 10, 27, 9, 17, 33, 11, 15, 33, 31, 4, 2, 5, 28, 29, 26]"
2,13,2022,1089,4576,0,453,1569,"[130, 30, 258, 220, 297, 269, 91, 195, 283, 163, 472, 522, 476, 0, 226, 31, 296, 501, 523, 441, 438, 523, 513, 177, 46, 143, 287, 32, 461]"
3,13,2003,859,5720,0,1867,136,"[40, 3, 39, 10, 4, 4, 18, 43, 14, 7, 3, 44, 45, 0, 37, 15, 6, 43, 45, 24, 32, 45, 27, 24, 7, 35, 22, 40, 25]"
4,13,2147,27,7840,0,323,1824,"[361, 261, 109, 421, 515, 388, 309, 35, 526, 518, 242, 283, 486, 0, 506, 257, 297, 74, 608, 376, 388, 608, 368, 530, 10, 119, 448, 316, 93]"
5,13,2627,1943,8524,0,1784,843,"[207, 35, 159, 225, 202, 68, 195, 199, 22, 113, 211, 168, 104, 0, 123, 274, 219, 3, 281, 95, 89, 281, 169, 258, 242, 210, 111, 256, 80]"
6,13,1541,911,9154,0,558,983,"[40, 68, 306, 112, 122, 274, 132, 2, 324, 311, 224, 105, 298, 0, 31, 304, 300, 301, 327, 325, 78, 327, 211, 264, 176, 211, 145, 276, 10]"
7,13,1288,752,9690,0,883,405,"[21, 134, 19, 37, 76, 27, 119, 4, 129, 11, 124, 88, 56, 0, 84, 24, 108, 58, 135, 6, 9, 135, 31, 80, 77, 27, 126, 25, 86]"
8,13,1402,5729,5363,0,487,915,"[137, 149, 80, 44, 31, 204, 55, 77, 168, 66, 246, 182, 28, 0, 208, 262, 213, 230, 305, 191, 29, 305, 173, 27, 190, 205, 255, 207, 122]"
9,13,2236,1548,6051,0,1114,1122,"[281, 143, 93, 188, 12, 116, 83, 295, 325, 363, 299, 204, 22, 0, 166, 272, 180, 169, 374, 366, 315, 374, 165, 234, 61, 260, 59, 353, 92]"
10,13,2440,1378,7113,0,2388,52,"[10, 10, 15, 9, 12, 3, 17, 12, 7, 1, 9, 2, 0, 0, 9, 12, 9, 1, 17, 8, 14, 17, 16, 12, 16, 8, 1, 5, 14]"
11,13,2041,1993,7161,0,1065,976,"[285, 153, 58, 60, 117, 201, 267, 144, 90, 219, 184, 63, 281, 0, 167, 115, 56, 114, 325, 165, 86, 325, 121, 130, 109, 276, 304, 278, 206]"
12,13,2033,1537,7657,0,924,1109,"[322, 178, 88, 108, 269, 181, 74, 272, 263, 294, 236, 344, 1, 0, 244, 58, 205, 5, 369, 196, 325, 369, 78, 226, 287, 244, 135, 350, 244]"
13,13,1199,662,8194,0,696,503,"[16, 92, 131, 85, 163, 97, 165, 83, 72, 45, 23, 152, 153, 0, 107, 119, 167, 106, 167, 162, 37, 167, 10, 149, 82, 149, 65, 101, 104]"
14,13,2870,6666,4398,0,2596,274,"[4, 17, 61, 88, 21, 22, 24, 87, 76, 69, 27, 85, 7, 0, 77, 80, 12, 62, 91, 72, 69, 91, 17, 8, 64, 15, 37, 37, 72]"
15,13,2771,2651,4518,0,1081,1690,"[110, 200, 231, 261, 29, 23, 136, 551, 48, 358, 60, 226, 382, 0, 340, 312, 14, 506, 563, 192, 307, 563, 43, 544, 51, 44, 251, 380, 415]"
16,13,1545,292,5771,0,933,612,"[24, 136, 181, 189, 139, 86, 113, 185, 176, 98, 76, 97, 204, 0, 180, 201, 49, 40, 204, 177, 144, 204, 27, 64, 156, 195, 185, 200, 177]"
17,13,2431,2417,5785,0,1305,1126,"[269, 179, 261, 280, 266, 107, 95, 150, 326, 160, 148, 134, 131, 0, 293, 186, 292, 141, 375, 156, 245, 375, 355, 278, 116, 212, 153, 251, 169]"
18,13,1445,1089,6141,0,1254,191,"[56, 14, 51, 54, 19, 40, 55, 14, 58, 6, 60, 16, 8, 0, 36, 47, 17, 24, 63, 52, 34, 63, 4, 33, 28, 8, 28, 38, 58]"
19,13,2549,2494,6196,0,1666,883,"[129, 18, 137, 183, 20, 185, 8, 56, 248, 235, 178, 172, 169, 0, 94, 25, 19, 264, 294, 48, 85, 294, 62, 180, 64, 205, 171, 37, 181]"
20,13,2026,1555,6667,0,954,1072,"[353, 74, 44, 255, 204, 26, 123, 105, 212, 310, 45, 143, 258, 0, 65, 297, 287, 37, 357, 113, 189, 357, 275, 113, 220, 333, 106, 246, 46]"
21,13,2656,1912,7411,0,680,1976,"[489, 511, 33, 199, 543, 559, 516, 84, 414, 346, 198, 349, 120, 0, 90, 330, 416, 605, 658, 93, 349, 658, 102, 232, 114, 149, 526, 218, 235]"
22,13,2562,501,9472,0,1719,843,"[271, 96, 174, 253, 230, 16, 97, 113, 65, 45, 43, 35, 54, 0, 114, 164, 91, 30, 281, 106, 256, 281, 94, 159, 18, 98, 47, 143, 237]"
23,13,1576,6877,4171,0,715,861,"[182, 139, 262, 203, 152, 248, 287, 238, 69, 254, 184, 141, 253, 0, 207, 99, 13, 206, 287, 244, 229, 287, 229, 101, 81, 174, 202, 174, 213]"
24,13,1737,95,5813,0,1390,347,"[115, 92, 48, 89, 49, 7, 27, 35, 9, 10, 64, 113, 93, 0, 28, 105, 107, 113, 115, 13, 10, 115, 92, 50, 58, 15, 86, 107, 45]"
25,13,2419,590,7642,0,1561,858,"[48, 262, 87, 46, 234, 159, 52, 197, 9, 172, 43, 126, 28, 0, 99, 148, 198, 203, 286, 203, 4, 286, 225, 189, 261, 251, 175, 285, 240]"
26,13,1380,1000,8022,0,539,841,"[28, 166, 71, 186, 174, 2, 178, 109, 126, 189, 203, 209, 12, 0, 152, 51, 116, 167, 280, 266, 261, 280, 96, 153, 78, 131, 7, 98, 272]"
27,13,2140,183,9979,0,70,2070,"[15, 549, 678, 85, 599, 677, 195, 686, 607, 395, 321, 449, 581, 0, 302, 28, 680, 262, 690, 520, 59, 690, 36, 602, 150, 72, 135, 623, 59]"
28,13,1529,5679,5829,0,1351,178,"[4, 49, 19, 41, 45, 42, 53, 43, 12, 8, 46, 23, 9, 0, 30, 46, 23, 56, 59, 13, 37, 59, 53, 21, 0, 57, 1, 39, 57]"
29,13,1162,112,6879,0,196,966,"[133, 129, 297, 38, 284, 119, 271, 220, 103, 257, 101, 290, 29, 0, 159, 14, 211, 262, 322, 82, 24, 322, 202, 181, 218, 172, 86, 90, 195]"
30,13,2894,1986,7787,0,201,2693,"[354, 816, 482, 812, 836, 44, 84, 11, 705, 369, 635, 41, 312, 0, 332, 779, 513, 153, 897, 305, 469, 897, 279, 532, 441, 838, 791, 240, 500]"
31,13,1512,1060,8239,0,626,886,"[227, 185, 182, 270, 196, 20, 276, 135, 146, 146, 58, 213, 91, 0, 20, 179, 285, 155, 295, 34, 216, 295, 43, 49, 18, 241, 255, 38, 227]"
32,13,2413,766,9886,0,1880,533,"[160, 81, 95, 171, 83, 123, 66, 126, 144, 132, 63, 99, 95, 0, 162, 38, 107, 29, 177, 177, 82, 177, 110, 137, 3, 119, 51, 27, 86]"
33,13,2032,6916,5002,0,159,1873,"[285, 448, 403, 146, 537, 99, 612, 96, 602, 505, 498, 150, 591, 0, 41, 150, 330, 356, 624, 373, 108, 624, 506, 406, 483, 328, 100, 58, 52]"
34,13,1479,793,5688,0,668,811,"[46, 249, 262, 189, 111, 52, 128, 7, 0, 106, 270, 219, 87, 0, 160, 266, 63, 111, 270, 29, 168, 270, 259, 134, 153, 170, 131, 227, 183]"
35,13,2326,2276,5738,0,2317,9,"[1, 2, 3, 2, 2, 3, 3, 2, 0, 0, 0, 1, 1, 0, 1, 0, 1, 2, 3, 1, 1, 3, 0, 1, 2, 2, 0, 3, 0]"
36,13,1302,1192,5848,0,548,754,"[113, 165, 57, 0, 71, 97, 120, 215, 42, 167, 246, 135, 129, 0, 76, 66, 86, 179, 251, 49, 67, 251, 251, 116, 50, 12, 133, 105, 223]"
37,13,2945,2775,6018,0,2588,357,"[72, 106, 6, 14, 52, 64, 45, 59, 34, 88, 66, 66, 60, 0, 36, 74, 16, 2, 119, 21, 49, 119, 8, 3, 1, 32, 10, 47, 5]"
38,13,2366,1353,7031,0,1994,372,"[23, 75, 59, 108, 55, 64, 16, 19, 119, 2, 6, 14, 47, 0, 21, 83, 3, 6, 124, 34, 96, 124, 88, 97, 68, 91, 64, 123, 2]"
39,13,2096,1333,7794,0,1921,175,"[27, 1, 21, 42, 42, 19, 21, 1, 2, 53, 13, 0, 5, 0, 40, 12, 9, 57, 58, 8, 37, 58, 56, 6, 20, 45, 24, 10, 48]"
40,13,2076,86,9784,0,1959,117,"[10, 2, 21, 14, 2, 19, 8, 32, 30, 32, 35, 24, 7, 0, 0, 36, 35, 10, 39, 39, 35, 39, 37, 30, 9, 35, 3, 35, 38]"
41,13,1768,5695,5857,0,1416,352,"[21, 11, 95, 70, 84, 52, 69, 58, 61, 2, 101, 94, 68, 0, 89, 35, 38, 33, 117, 111, 86, 117, 62, 35, 23, 95, 54, 29, 45]"
42,13,1771,199,7429,0,528,1243,"[165, 23, 114, 152, 43, 88, 293, 274, 46, 241, 245, 233, 315, 0, 50, 185, 269, 58, 414, 382, 401, 414, 290, 155, 151, 341, 186, 170, 14]"
43,13,2350,1276,8503,0,1017,1333,"[84, 168, 212, 225, 221, 201, 216, 395, 16, 254, 174, 48, 141, 0, 128, 35, 2, 251, 444, 31, 320, 444, 410, 223, 357, 194, 420, 398, 431]"
44,13,2852,5113,6242,0,1416,1436,"[269, 311, 218, 18, 197, 340, 369, 446, 59, 191, 419, 343, 233, 0, 377, 432, 154, 297, 478, 380, 473, 478, 27, 97, 269, 380, 231, 237, 471]"
45,13,2932,238,8936,0,2090,842,"[222, 56, 133, 123, 239, 110, 261, 104, 224, 67, 154, 41, 236, 0, 67, 188, 16, 220, 280, 5, 16, 280, 229, 238, 188, 129, 53, 206, 198]"
46,13,2329,6331,4934,0,821,1508,"[14, 172, 27, 9, 149, 355, 434, 25, 233, 225, 139, 477, 128, 0, 368, 236, 109, 146, 502, 218, 250, 502, 477, 192, 2, 399, 111, 247, 99]"
47,13,1566,168,6332,0,974,592,"[87, 167, 23, 35, 6, 53, 112, 14, 82, 44, 138, 76, 22, 0, 18, 138, 7, 49, 197, 113, 26, 197, 44, 148, 178, 137, 26, 153, 44]"
48,13,2944,2496,6780,0,68,2876,"[308, 561, 845, 542, 574, 519, 782, 473, 880, 152, 164, 0, 407, 0, 359, 603, 30, 835, 958, 283, 792, 958, 591, 790, 108, 75, 291, 52, 860]"
49,13,1038,407,7411,0,649,389,"[18, 68, 128, 27, 116, 112, 86, 107, 48, 60, 9, 98, 86, 0, 98, 1, 91, 53, 129, 60, 64, 129, 87, 52, 127, 127, 3, 48, 97]"
50,13,2421,1273,8559,0,1271,1150,"[359, 370, 11, 295, 112, 381, 143, 303, 355, 357, 125, 131, 189, 0, 91, 105, 186, 116, 383, 55, 345, 383, 265, 332, 140, 21, 145, 266, 10]"
51,13,2274,455,10000,378,761,1513,"[110, 420, 91, 136, 479, 237, 295, 162, 469, 296, 281, 66, 16, 0, 240, 168, 459, 135, 504, 92, 56, 504, 378, 470, 124, 204, 314, 495, 279]"
52,13,1343,6351,4992,0,545,798,"[30, 222, 166, 251, 110, 100, 60, 95, 206, 231, 6, 183, 239, 0, 178, 96, 231, 226, 266, 238, 136, 266, 239, 119, 258, 79, 266, 146, 108]"
53,13,2354,2299,5047,0,1936,418,"[114, 105, 103, 69, 96, 117, 21, 131, 105, 129, 90, 57, 61, 0, 62, 115, 71, 107, 139, 99, 138, 139, 51, 93, 61, 24, 122, 59, 43]"
54,13,1536,1134,5449,0,1318,218,"[14, 68, 1, 54, 54, 46, 55, 28, 34, 68, 15, 29, 50, 0, 26, 70, 29, 9, 72, 46, 70, 72, 64, 50, 72, 14, 2, 72, 12]"
55,13,2609,1059,6999,0,410,2199,"[445, 272, 668, 592, 152, 432, 349, 182, 245, 327, 319, 5, 725, 0, 407, 585, 214, 176, 733, 146, 271, 733, 730, 726, 278, 662, 95, 527, 706]"
56,13,1679,1232,7446,0,261,1418,"[330, 108, 240, 461, 312, 83, 239, 384, 63, 270, 65, 22, 429, 0, 369, 248, 257, 456, 472, 112, 275, 472, 128, 65, 238, 207, 357, 470, 53]"
57,13,2826,2205,8067,0,778,2048,"[466, 602, 536, 537, 89, 446, 319, 214, 191, 187, 621, 538, 608, 0, 267, 303, 442, 637, 682, 115, 72, 682, 364, 200, 347, 243, 442, 556, 473]"
58,13,1158,1152,8073,0,1124,34,"[2, 4, 0, 0, 8, 8, 2, 3, 11, 6, 2, 11, 6, 0, 6, 5, 2, 3, 11, 4, 8, 11, 10, 6, 2, 10, 0, 9, 9]"
59,13,2823,1542,9354,0,1434,1389,"[397, 341, 457, 167, 152, 35, 10, 37, 308, 462, 361, 330, 132, 0, 328, 440, 58, 327, 463, 365, 20, 463, 73, 214, 134, 204, 407, 146, 145]"
60,13,2607,5081,6880,0,1184,1423,"[295, 334, 208, 430, 71, 468, 336, 420, 5, 225, 388, 473, 310, 0, 317, 115, 86, 302, 474, 412, 376, 474, 229, 125, 379, 249, 142, 22, 20]"
61,13,1927,568,8239,0,479,1448,"[201, 239, 86, 36, 279, 156, 99, 444, 252, 398, 80, 130, 331, 0, 173, 147, 321, 291, 482, 459, 204, 482, 111, 392, 267, 405, 298, 210, 54]"
62,13,2851,6144,4946,0,800,2051,"[316, 667, 171, 497, 3, 230, 250, 385, 280, 129, 145, 522, 72, 0, 6, 26, 227, 670, 683, 147, 533, 683, 527, 193, 89, 227, 127, 616, 277]"
63,13,2760,2540,5166,0,1650,1110,"[8, 310, 134, 86, 224, 234, 92, 87, 254, 27, 11, 63, 192, 0, 7, 369, 277, 28, 370, 78, 36, 370, 168, 324, 128, 270, 154, 41, 2]"
64,13,2766,847,7085,0,1222,1544,"[311, 226, 363, 150, 29, 290, 246, 245, 137, 151, 469, 259, 244, 0, 47, 19, 88, 277, 514, 401, 121, 514, 379, 428, 197, 236, 251, 457, 111]"
65,13,1792,439,8438,0,1685,107,"[20, 22, 12, 14, 18, 18, 0, 12, 6, 18, 3, 13, 6, 0, 33, 1, 28, 5, 35, 23, 31, 35, 18, 26, 33, 12, 23, 33, 19]"
66,13,1213,862,8789,0,509,704,"[135, 55, 211, 208, 13, 178, 145, 53, 113, 221, 109, 143, 84, 0, 113, 216, 9, 64, 234, 118, 145, 234, 48, 83, 118, 199, 223, 119, 81]"
67,13,1686,636,9839,0,175,1511,"[468, 485, 395, 168, 240, 167, 284, 284, 366, 226, 381, 365, 66, 0, 433, 71, 367, 68, 503, 440, 355, 503, 101, 24, 415, 341, 322, 229, 323]"
68,13,1970,5835,5974,0,521,1449,"[267, 90, 140, 385, 262, 428, 35, 90, 74, 460, 219, 64, 202, 0, 188, 24, 471, 103, 483, 230, 260, 483, 357, 28, 48, 114, 445, 39, 447]"
69,13,1112,779,6307,0,268,844,"[171, 143, 88, 44, 181, 77, 150, 194, 45, 125, 124, 67, 159, 0, 115, 271, 73, 114, 281, 73, 78, 281, 16, 25, 281, 267, 58, 78, 222]"
70,13,2803,1778,7332,0,494,2309,"[20, 170, 307, 450, 712, 333, 66, 548, 219, 131, 195, 6, 99, 0, 207, 398, 693, 345, 769, 40, 70, 769, 595, 622, 239, 418, 580, 369, 671]"
71,13,1723,1499,7556,0,1364,359,"[23, 17, 99, 58, 7, 65, 27, 117, 59, 37, 81, 107, 117, 0, 66, 14, 119, 119, 119, 52, 8, 119, 82, 112, 106, 61, 29, 61, 49]"
72,13,2393,1845,8104,0,2141,252,"[25, 9, 71, 27, 61, 14, 65, 2, 14, 10, 23, 63, 1, 0, 10, 67, 15, 27, 84, 47, 45, 84, 34, 23, 4, 22, 25, 60, 80]"
73,13,2189,798,9495,0,1842,347,"[40, 84, 92, 88, 96, 53, 73, 20, 12, 41, 29, 62, 100, 0, 115, 31, 104, 96, 115, 26, 104, 115, 90, 30, 23, 71, 94, 90, 34]"
74,13,1554,7386,3663,0,1444,110,"[22, 21, 12, 21, 19, 20, 35, 3, 12, 2, 31, 32, 3, 0, 24, 5, 3, 4, 36, 6, 19, 36, 32, 2, 16, 15, 16, 22, 21]"
75,13,1159,295,4527,0,529,630,"[82, 36, 151, 127, 169, 14, 56, 103, 29, 156, 55, 154, 152, 0, 14, 114, 1, 85, 210, 186, 37, 210, 23, 83, 4, 47, 203, 202, 126]"
76,13,1362,939,4950,0,23,1339,"[130, 425, 149, 440, 2, 368, 284, 22, 19, 89, 154, 353, 150, 0, 261, 270, 435, 114, 446, 202, 357, 446, 168, 265, 318, 17, 8, 371, 37]"
77,13,2948,2182,5716,0,1523,1425,"[30, 175, 404, 416, 311, 115, 104, 154, 280, 413, 115, 40, 329, 0, 192, 24, 350, 398, 475, 157, 467, 475, 53, 412, 100, 228, 262, 94, 92]"
78,13,1100,1007,5809,0,582,518,"[31, 41, 18, 162, 108, 102, 154, 29, 62, 116, 75, 157, 126, 0, 110, 155, 56, 99, 172, 79, 122, 172, 163, 19, 138, 73, 98, 52, 135]"
79,13,2179,329,7659,0,2024,155,"[3, 40, 15, 40, 41, 16, 41, 8, 17, 26, 16, 47, 7, 0, 20, 28, 1, 6, 51, 1, 6, 51, 17, 20, 13, 27, 17, 43, 22]"
80,13,2304,1670,8293,0,1087,1217,"[398, 332, 175, 80, 50, 381, 325, 240, 367, 79, 250, 286, 21, 0, 281, 183, 279, 379, 405, 163, 73, 405, 175, 178, 206, 377, 68, 256, 215]"
81,13,2073,1317,9049,0,2018,55,"[2, 13, 11, 1, 6, 12, 2, 0, 12, 10, 15, 16, 5, 0, 5, 8, 4, 1, 18, 18, 3, 18, 0, 10, 0, 18, 17, 18, 17]"
82,13,2691,5069,6671,0,1592,1099,"[187, 151, 15, 252, 207, 136, 135, 234, 307, 350, 321, 345, 336, 0, 124, 63, 58, 101, 366, 260, 191, 366, 90, 232, 169, 232, 341, 343, 38]"
83,13,1984,1534,7121,0,349,1635,"[79, 151, 100, 209, 414, 396, 378, 59, 384, 415, 145, 463, 451, 0, 291, 430, 7, 480, 545, 145, 146, 545, 290, 323, 383, 475, 392, 481, 282]"
84,13,2813,1015,8919,0,1702,1111,"[102, 353, 346, 170, 236, 150, 101, 169, 108, 83, 283, 187, 97, 0, 216, 174, 313, 118, 370, 236, 128, 370, 82, 316, 57, 28, 114, 363, 89]"
85,13,2110,5900,5129,0,1270,840,"[45, 246, 271, 75, 233, 2, 108, 43, 56, 43, 214, 189, 195, 0, 62, 47, 183, 146, 280, 2, 254, 280, 204, 41, 249, 9, 213, 2, 76]"
86,13,1310,656,5783,0,123,1187,"[336, 272, 192, 161, 132, 174, 86, 273, 195, 107, 2, 365, 60, 0, 268, 197, 132, 139, 395, 373, 231, 395, 177, 40, 85, 206, 129, 386, 45]"
87,13,1603,180,7206,0,429,1174,"[97, 99, 367, 82, 83, 95, 108, 268, 322, 22, 259, 89, 241, 0, 223, 164, 198, 140, 391, 299, 354, 391, 328, 271, 125, 35, 96, 177, 189]"
88,13,2023,644,8585,0,1864,159,"[4, 45, 47, 34, 30, 24, 1, 41, 42, 45, 51, 43, 17, 0, 32, 42, 37, 14, 53, 11, 46, 53, 9, 2, 47, 2, 3, 1, 44]"
89,13,1761,1529,8817,0,514,1247,"[189, 334, 381, 197, 383, 318, 46, 381, 5, 95, 378, 205, 156, 0, 40, 317, 126, 344, 415, 117, 299, 415, 278, 240, 229, 155, 101, 364, 326]"
90,13,1647,1415,9049,0,526,1121,"[97, 357, 147, 128, 369, 104, 181, 243, 276, 180, 188, 144, 211, 0, 95, 159, 124, 220, 373, 256, 106, 373, 230, 226, 371, 316, 42, 139, 282]"
91,13,1591,1398,9242,0,1030,561,"[28, 86, 113, 169, 83, 122, 130, 106, 110, 79, 0, 40, 55, 0, 21, 161, 137, 9, 187, 107, 169, 187, 108, 152, 52, 149, 108, 36, 167]"
92,13,1523,27,10000,738,244,1279,"[72, 97, 18, 217, 120, 340, 120, 354, 346, 328, 1, 423, 324, 0, 146, 142, 205, 149, 426, 180, 10, 426, 186, 115, 412, 131, 115, 195, 235]"
93,13,2041,6087,5954,0,906,1135,"[148, 245, 12, 129, 98, 109, 61, 11, 192, 270, 252, 18, 91, 0, 238, 62, 153, 5, 378, 162, 261, 378, 188, 309, 47, 200, 209, 163, 253]"
94,13,2256,2015,6195,0,261,1995,"[435, 659, 251, 101, 559, 380, 28, 237, 442, 568, 458, 551, 500, 0, 22, 619, 453, 547, 665, 169, 113, 665, 612, 514, 60, 605, 477, 73, 117]"
95,13,1938,558,7575,0,1925,13,"[3, 4, 3, 1, 1, 2, 1, 1, 2, 0, 2, 1, 0, 0, 1, 3, 3, 2, 4, 3, 4, 4, 4, 3, 3, 4, 1, 2, 3]"
96,13,2083,1568,8090,0,1263,820,"[193, 157, 221, 96, 167, 113, 11, 171, 174, 17, 15, 112, 255, 0, 155, 85, 156, 117, 273, 238, 181, 273, 234, 90, 271, 162, 118, 7, 270]"
97,13,1632,1113,8609,0,985,647,"[183, 134, 89, 123, 85, 101, 165, 14, 151, 116, 140, 194, 15, 0, 70, 207, 32, 15, 215, 117, 37, 215, 123, 61, 13, 75, 158, 123, 181]"
98,13,2879,7033,4455,0,909,1970,"[145, 264, 356, 150, 444, 194, 558, 577, 153, 508, 1, 553, 23, 0, 366, 327, 431, 337, 656, 45, 355, 656, 429, 497, 329, 29, 616, 313, 511]"
99,13,1223,1051,4627,0,23,1200,"[42, 67, 289, 389, 326, 215, 86, 352, 62, 314, 232, 131, 4, 0, 358, 91, 251, 216, 400, 275, 188, 400, 301, 269, 88, 118, 181, 276, 138]"
100,13,1570,530,5667,0,281,1289,"[87, 428, 327, 356, 278, 95, 146, 178, 317, 383, 153, 198, 412, 0, 219, 338, 223, 254, 429, 427, 341, 429, 27, 375, 94, 213, 141, 255, 6]"
101,13,1952,1223,6396,0,550,1402,"[2, 123, 362, 384, 106, 425, 64, 161, 211, 39, 273, 249, 67, 0, 100, 440, 363, 464, 467, 30, 446, 467, 417, 50, 413, 406, 414, 344, 249]"
102,13,2330,1768,6958,0,71,2259,"[132, 418, 405, 41, 246, 641, 715, 214, 11, 84, 406, 58, 444, 0, 227, 518, 174, 145, 753, 316, 139, 753, 50, 89, 684, 70, 337, 125, 417]"
103,13,2643,1592,8009,0,1179,1464,"[189, 278, 96, 478, 452, 61, 282, 199, 340, 255, 141, 24, 375, 0, 392, 388, 151, 15, 488, 252, 0, 488, 252, 244, 174, 61, 44, 81, 285]"
104,13,1452,1205,8256,0,925,527,"[152, 83, 121, 42, 4, 43, 17, 112, 62, 157, 170, 31, 50, 0, 117, 84, 110, 1, 175, 67, 21, 175, 110, 172, 143, 19, 25, 61, 96]"
105,13,1798,109,9945,0,650,1148,"[279, 65, 289, 381, 252, 319, 331, 332, 365, 63, 63, 237, 52, 0, 188, 159, 127, 151, 382, 328, 161, 382, 198, 182, 302, 42, 191, 227, 106]"
106,13,1499,5953,5491,0,490,1009,"[213, 126, 106, 131, 40, 321, 111, 57, 293, 184, 130, 299, 268, 0, 260, 182, 129, 270, 336, 52, 276, 336, 175, 28, 234, 218, 172, 69, 216]"
107,13,1811,1413,5889,0,1427,384,"[106, 114, 41, 31, 53, 81, 42, 16, 26, 123, 61, 27, 81, 0, 49, 46, 85, 38, 128, 54, 42, 128, 4, 55, 87, 58, 120, 97, 126]"
108,13,1342,776,6455,0,807,535,"[9, 106, 78, 166, 136, 92, 43, 40, 139, 48, 70, 56, 65, 0, 108, 28, 121, 164, 178, 170, 37, 178, 47, 79, 22, 136, 173, 77, 98]"
109,13,1780,1303,6932,0,664,1116,"[361, 213, 45, 44, 294, 217, 13, 109, 261, 185, 22, 167, 300, 0, 201, 328, 273, 89, 372, 0, 316, 372, 33, 186, 195, 309, 368, 2, 152]"
110,13,1835,626,8141,0,1119,716,"[219, 181, 14, 77, 155, 91, 18, 64, 238, 26, 65, 73, 187, 0, 155, 196, 82, 21, 238, 223, 223, 238, 52, 188, 230, 32, 29, 216, 144]"
111,13,1282,45,9378,0,1161,121,"[4, 2, 26, 26, 7, 29, 34, 27, 9, 22, 28, 30, 14, 0, 15, 0, 7, 19, 40, 31, 13, 40, 23, 37, 18, 13, 36, 2, 34]"
112,13,2364,7238,4504,0,1445,919,"[94, 145, 287, 56, 15, 195, 77, 98, 284, 126, 89, 98, 209, 0, 187, 36, 60, 134, 306, 201, 216, 306, 77, 3, 222, 254, 43, 124, 36]"
113,13,1889,309,6084,0,1864,25,"[3, 2, 5, 8, 6, 0, 2, 6, 0, 7, 4, 1, 5, 0, 8, 6, 1, 5, 8, 6, 2, 8, 7, 4, 7, 5, 6, 2, 1]"
114,13,1658,1273,6469,0,1151,507,"[88, 56, 116, 136, 147, 7, 55, 110, 112, 114, 76, 26, 50, 0, 22, 156, 84, 115, 169, 36, 11, 169, 166, 87, 57, 163, 76, 6, 65]"
115,13,2803,1448,7824,0,547,2256,"[21, 627, 482, 181, 650, 439, 15, 376, 614, 428, 582, 531, 48, 0, 707, 450, 232, 664, 752, 644, 421, 752, 137, 40, 479, 158, 350, 159, 306]"
116,13,1479,34,9269,0,1290,189,"[36, 16, 45, 45, 50, 32, 50, 51, 4, 19, 3, 12, 37, 0, 59, 49, 17, 44, 63, 53, 0, 63, 50, 0, 49, 63, 12, 5, 45]"
117,13,2570,5693,6146,0,2441,129,"[15, 7, 1, 42, 9, 38, 4, 32, 22, 13, 43, 6, 6, 0, 10, 3, 21, 41, 43, 38, 3, 43, 20, 33, 34, 33, 34, 10, 17]"
118,13,2922,1106,7962,0,1187,1735,"[535, 384, 293, 37, 468, 269, 215, 482, 567, 165, 244, 3, 189, 0, 345, 433, 394, 574, 578, 379, 509, 578, 577, 327, 260, 32, 375, 216, 536]"
119,13,2661,2638,7985,0,1229,1432,"[159, 374, 363, 3, 212, 87, 145, 421, 329, 22, 162, 441, 163, 0, 470, 125, 166, 321, 477, 48, 132, 477, 327, 210, 334, 164, 20, 352, 321]"
0,14,3211,0,3211,0,2624,587,"[195, 185, 130, 10, 165, 195, 64, 137, 8, 42, 98, 8, 55, 186, 0, 15, 75, 134, 94, 46, 78, 56, 109, 175, 152, 33, 101, 97, 36]"
1,14,3828,3803,3236,0,150,3678,"[1226, 1033, 262, 1140, 462, 1226, 213, 1065, 142, 386, 414, 175, 562, 187, 0, 1147, 661, 566, 1139, 265, 1094, 474, 404, 37, 450, 384, 785, 1083, 229]"
2,14,4179,3088,4327,0,3063,1116,"[372, 239, 295, 55, 187, 372, 272, 154, 265, 97, 110, 50, 27, 98, 0, 58, 267, 243, 168, 156, 122, 78, 189, 109, 118, 108, 76, 86, 302]"
3,14,3929,3911,4345,0,2936,993,"[331, 256, 56, 104, 246, 331, 91, 171, 101, 42, 320, 171, 234, 306, 0, 173, 94, 3, 289, 110, 108, 270, 55, 34, 134, 314, 254, 82, 270]"
4,14,3826,2108,6063,0,772,3054,"[1018, 670, 686, 117, 480, 1018, 408, 683, 267, 1009, 835, 871, 199, 49, 0, 660, 798, 765, 567, 296, 864, 862, 149, 435, 154, 1006, 331, 697, 560]"
5,14,3347,871,8539,0,1084,2263,"[754, 43, 185, 454, 515, 754, 410, 567, 626, 30, 393, 9, 61, 463, 0, 583, 348, 30, 12, 298, 18, 253, 189, 58, 440, 264, 589, 365, 437]"
6,14,3741,6878,5402,0,3610,131,"[43, 27, 8, 36, 20, 43, 33, 33, 17, 5, 26, 25, 13, 7, 0, 32, 33, 27, 22, 27, 5, 28, 1, 11, 7, 7, 24, 25, 37]"
7,14,3418,3333,5487,0,610,2808,"[936, 161, 796, 626, 484, 936, 595, 366, 627, 6, 368, 402, 879, 214, 0, 792, 404, 384, 627, 16, 620, 518, 150, 481, 261, 163, 891, 16, 639]"
8,14,4026,1214,8299,0,3143,883,"[294, 267, 200, 79, 151, 294, 94, 48, 271, 59, 258, 131, 215, 180, 0, 92, 234, 16, 246, 3, 132, 95, 202, 133, 274, 262, 224, 282, 11]"
9,14,4406,6410,6295,0,3554,852,"[284, 274, 78, 246, 86, 284, 246, 207, 262, 12, 283, 265, 235, 200, 0, 4, 93, 92, 93, 77, 55, 6, 246, 88, 44, 4, 157, 33, 187]"
10,14,4227,2446,8076,0,1944,2283,"[761, 435, 301, 742, 129, 761, 563, 244, 423, 504, 336, 416, 745, 120, 0, 350, 415, 346, 426, 721, 479, 672, 206, 226, 179, 43, 370, 396, 588]"
11,14,4377,7480,4973,0,78,4299,"[1433, 1280, 1188, 423, 239, 1433, 1062, 637, 340, 1022, 880, 964, 1367, 181, 0, 414, 1157, 1429, 882, 473, 559, 825, 1226, 246, 886, 199, 259, 1358, 1294]"
12,14,3343,487,7829,0,43,3300,"[1100, 637, 985, 548, 598, 1100, 28, 403, 128, 684, 455, 323, 73, 682, 0, 937, 339, 272, 264, 566, 867, 865, 826, 396, 731, 728, 377, 934, 441]"
13,14,3527,7266,4090,0,1089,2438,"[812, 764, 516, 507, 546, 812, 440, 570, 374, 259, 612, 275, 784, 661, 0, 610, 631, 101, 75, 237, 120, 182, 9, 58, 255, 20, 272, 145, 336]"
14,14,3169,1553,5706,0,1156,2013,"[671, 125, 271, 455, 666, 671, 5, 472, 69, 524, 110, 647, 314, 473, 0, 328, 473, 576, 92, 519, 1, 581, 11, 266, 571, 315, 396, 624, 498]"
15,14,4654,1193,9167,0,1423,3231,"[1077, 618, 585, 597, 736, 1077, 779, 22, 265, 243, 710, 796, 920, 18, 0, 754, 209, 16, 856, 442, 624, 826, 737, 654, 207, 402, 206, 1012, 517]"
16,14,3091,6528,5730,0,2080,1011,"[337, 202, 126, 243, 270, 337, 130, 302, 144, 149, 78, 184, 324, 29, 0, 313, 78, 248, 39, 199, 303, 16, 258, 284, 256, 97, 331, 188, 48]"
17,14,4639,2160,8209,0,1474,3165,"[1055, 439, 549, 738, 509, 1055, 248, 747, 390, 409, 639, 455, 524, 904, 0, 246, 381, 1054, 970, 392, 385, 727, 613, 505, 807, 626, 286, 974, 41]"
18,14,3484,6701,4992,0,2681,803,"[267, 242, 238, 256, 69, 267, 154, 144, 201, 102, 150, 247, 266, 176, 0, 265, 185, 40, 122, 148, 23, 82, 109, 90, 194, 235, 186, 50, 47]"
19,14,4792,749,9035,0,3393,1399,"[466, 434, 285, 342, 361, 466, 201, 203, 356, 439, 326, 424, 453, 215, 0, 459, 408, 365, 443, 313, 272, 449, 342, 198, 432, 179, 382, 103, 158]"
20,14,3163,5244,6954,0,931,2232,"[744, 353, 442, 643, 418, 744, 627, 470, 451, 601, 88, 462, 327, 738, 0, 474, 293, 320, 487, 429, 184, 711, 26, 543, 491, 615, 710, 338, 37]"
21,14,4103,5796,5261,0,2863,1240,"[413, 411, 13, 140, 278, 413, 81, 368, 271, 54, 213, 84, 42, 185, 0, 111, 121, 88, 1, 358, 194, 391, 177, 356, 201, 239, 409, 294, 219]"
22,14,4836,3903,6194,0,85,4751,"[1583, 722, 192, 565, 1074, 1583, 1321, 379, 523, 209, 392, 511, 314, 1410, 0, 376, 815, 294, 30, 1309, 1201, 1348, 945, 689, 893, 1375, 1513, 988, 578]"
23,14,3876,1976,8094,0,526,3350,"[1116, 348, 765, 16, 687, 1116, 462, 1053, 332, 1079, 1070, 251, 911, 459, 0, 898, 1078, 225, 494, 537, 888, 821, 893, 58, 638, 240, 544, 49, 143]"
24,14,3342,7152,4284,0,1921,1421,"[473, 409, 89, 439, 298, 473, 311, 133, 88, 156, 67, 404, 162, 293, 0, 327, 214, 50, 35, 128, 42, 44, 377, 155, 51, 84, 431, 93, 281]"
25,14,3880,1018,7146,0,354,3526,"[1175, 973, 148, 718, 429, 1175, 806, 1167, 916, 406, 748, 951, 589, 1046, 0, 992, 604, 202, 959, 259, 62, 671, 845, 255, 617, 453, 315, 174, 399]"
26,14,3955,5315,5786,0,639,3316,"[1105, 676, 304, 962, 348, 1105, 279, 976, 1067, 1073, 59, 943, 881, 393, 0, 979, 225, 572, 870, 50, 58, 707, 13, 584, 855, 13, 749, 402, 709]"
27,14,3287,3246,5827,0,1526,1761,"[587, 514, 548, 192, 141, 587, 286, 135, 511, 389, 224, 548, 540, 342, 0, 557, 496, 320, 494, 303, 258, 119, 229, 357, 473, 385, 33, 152, 257]"
28,14,3705,742,8790,0,3436,269,"[89, 62, 78, 37, 38, 89, 74, 79, 89, 87, 25, 61, 46, 43, 0, 62, 76, 77, 27, 45, 45, 58, 58, 45, 70, 49, 23, 87, 60]"
29,14,4917,6480,7227,0,555,4362,"[1454, 342, 192, 1123, 861, 1454, 198, 1006, 858, 659, 379, 989, 1108, 266, 0, 523, 86, 1317, 1405, 816, 1301, 112, 33, 986, 405, 401, 1395, 427, 1079]"
30,14,4282,5022,6487,0,546,3736,"[1245, 137, 19, 461, 599, 1245, 136, 519, 841, 785, 1207, 1040, 1003, 666, 0, 150, 1022, 54, 1024, 598, 1166, 606, 391, 537, 491, 1217, 974, 1118, 895]"
31,14,3442,214,9715,0,2739,703,"[234, 217, 54, 47, 50, 234, 140, 71, 53, 116, 142, 230, 189, 88, 0, 3, 140, 109, 201, 97, 19, 206, 131, 107, 63, 168, 32, 62, 52]"
32,14,4051,6724,7042,0,2625,1426,"[475, 172, 104, 215, 425, 475, 175, 64, 269, 153, 386, 415, 422, 341, 0, 406, 10, 125, 433, 405, 411, 383, 233, 402, 389, 210, 207, 372, 432]"
33,14,3286,2492,7836,0,1462,1824,"[608, 254, 267, 478, 358, 608, 43, 339, 260, 55, 405, 176, 475, 428, 0, 222, 507, 216, 332, 485, 503, 242, 335, 448, 3, 225, 29, 578, 274]"
34,14,4981,5246,7571,0,4851,130,"[43, 9, 19, 37, 17, 43, 31, 5, 26, 6, 25, 20, 30, 14, 0, 17, 30, 12, 20, 39, 35, 20, 35, 39, 18, 37, 31, 14, 31]"
35,14,4841,5587,6825,0,1858,2983,"[994, 662, 661, 286, 814, 994, 184, 398, 201, 715, 232, 597, 69, 539, 0, 142, 395, 555, 887, 30, 895, 978, 34, 962, 791, 7, 681, 578, 936]"
36,14,3235,548,9512,0,27,3208,"[1069, 1019, 69, 615, 429, 1069, 478, 307, 768, 1018, 512, 290, 289, 39, 0, 649, 992, 246, 504, 991, 621, 87, 611, 405, 64, 929, 85, 983, 757]"
37,14,4611,7266,6857,0,3447,1164,"[388, 192, 165, 44, 13, 388, 359, 121, 81, 388, 195, 19, 75, 70, 0, 196, 242, 344, 13, 324, 183, 269, 123, 18, 80, 351, 102, 76, 372]"
38,14,4893,5132,6618,0,3234,1659,"[553, 273, 489, 435, 360, 553, 346, 357, 65, 311, 138, 1, 364, 463, 0, 331, 88, 400, 219, 374, 537, 326, 515, 495, 115, 43, 519, 383, 240]"
39,14,4275,1404,9489,0,3172,1103,"[367, 169, 88, 205, 321, 367, 341, 153, 239, 245, 97, 286, 201, 214, 0, 190, 342, 117, 212, 276, 327, 1, 128, 84, 348, 7, 157, 303, 351]"
40,14,4297,5445,8341,0,2489,1808,"[602, 103, 403, 487, 552, 602, 439, 254, 351, 410, 249, 582, 428, 56, 0, 516, 50, 472, 88, 587, 124, 481, 19, 162, 384, 213, 370, 76, 398]"
41,14,4412,5717,7036,0,1612,2800,"[933, 564, 830, 725, 352, 933, 522, 231, 580, 884, 421, 470, 715, 614, 0, 475, 151, 319, 165, 321, 679, 410, 575, 723, 771, 240, 278, 71, 610]"
42,14,4198,5278,5956,0,2006,2192,"[730, 159, 231, 559, 434, 730, 38, 201, 393, 300, 322, 448, 510, 68, 0, 62, 293, 632, 109, 480, 379, 207, 413, 226, 140, 651, 211, 435, 510]"
43,14,4970,1641,9285,0,4842,128,"[42, 33, 14, 18, 38, 42, 5, 12, 30, 12, 10, 21, 7, 27, 0, 37, 10, 16, 20, 27, 10, 0, 34, 42, 36, 18, 6, 20, 30]"
44,14,4164,7084,6365,0,4143,21,"[7, 7, 5, 0, 2, 7, 6, 5, 1, 6, 2, 7, 6, 0, 0, 7, 1, 3, 0, 1, 6, 0, 1, 0, 0, 2, 0, 5, 3]"
45,14,3654,2856,7163,0,1280,2374,"[791, 25, 650, 403, 135, 791, 621, 599, 720, 505, 306, 578, 17, 329, 0, 26, 740, 497, 369, 334, 183, 175, 614, 743, 495, 227, 686, 218, 610]"
46,14,4079,7076,4166,0,1231,2848,"[949, 545, 875, 309, 601, 949, 870, 846, 804, 721, 298, 945, 198, 410, 0, 867, 300, 461, 875, 586, 263, 83, 212, 147, 30, 106, 934, 610, 697]"
47,14,4511,1232,7445,0,3240,1271,"[423, 360, 156, 305, 78, 423, 186, 47, 383, 10, 197, 116, 182, 62, 0, 394, 53, 163, 272, 326, 44, 386, 70, 358, 121, 187, 143, 153, 414]"
48,14,4443,5054,6834,0,150,4293,"[1431, 76, 477, 603, 899, 1431, 536, 381, 783, 236, 942, 580, 437, 47, 0, 808, 214, 66, 167, 928, 1136, 885, 7, 1407, 649, 1287, 578, 1085, 341]"
49,14,4976,6711,5099,0,3374,1602,"[534, 202, 289, 88, 394, 534, 230, 113, 422, 223, 371, 358, 261, 26, 0, 291, 279, 353, 470, 289, 500, 97, 6, 261, 482, 90, 146, 171, 158]"
50,14,3956,666,8389,0,2459,1497,"[499, 36, 24, 53, 401, 499, 440, 349, 253, 441, 368, 413, 214, 19, 0, 270, 101, 146, 32, 273, 409, 361, 396, 449, 430, 223, 304, 119, 486]"
51,14,3418,7162,4645,0,138,3280,"[1093, 169, 102, 663, 940, 1093, 442, 572, 1016, 380, 61, 384, 1026, 749, 0, 237, 451, 704, 867, 559, 390, 1019, 875, 1054, 573, 502, 320, 573, 685]"
52,14,4560,1789,7416,0,2948,1612,"[537, 312, 235, 28, 140, 537, 129, 31, 8, 257, 405, 491, 184, 434, 0, 22, 98, 160, 317, 537, 419, 243, 151, 117, 352, 382, 348, 322, 163]"
53,14,3558,3336,7638,0,1537,2021,"[673, 282, 614, 478, 493, 673, 486, 93, 309, 665, 542, 84, 366, 161, 0, 33, 349, 321, 555, 235, 92, 554, 557, 205, 223, 601, 522, 0, 632]"
54,14,3493,5245,5886,0,2764,729,"[243, 204, 88, 163, 138, 243, 52, 235, 229, 141, 199, 132, 178, 209, 0, 26, 177, 56, 165, 55, 14, 163, 32, 171, 198, 46, 174, 24, 69]"
55,14,3219,3119,5986,0,2374,845,"[281, 94, 191, 173, 6, 281, 103, 149, 73, 224, 81, 275, 268, 218, 0, 268, 229, 138, 30, 271, 16, 14, 77, 215, 37, 206, 181, 222, 277]"
56,14,3777,2924,6839,0,3040,737,"[245, 12, 192, 163, 143, 245, 32, 66, 11, 84, 170, 165, 226, 233, 0, 233, 22, 204, 29, 229, 171, 124, 182, 134, 31, 154, 233, 74, 155]"
57,14,4164,5172,5831,0,3188,976,"[325, 73, 67, 85, 224, 325, 249, 227, 54, 82, 206, 165, 271, 153, 0, 100, 319, 108, 273, 200, 110, 191, 277, 80, 138, 250, 219, 304, 155]"
58,14,4745,1191,9385,0,2728,2017,"[672, 227, 205, 269, 403, 672, 135, 647, 388, 488, 90, 411, 586, 487, 0, 531, 329, 618, 375, 71, 340, 210, 89, 330, 59, 643, 245, 62, 529]"
59,14,3072,5506,6951,0,221,2851,"[950, 79, 769, 661, 919, 950, 544, 940, 696, 257, 794, 876, 577, 578, 0, 404, 41, 181, 491, 194, 799, 223, 281, 741, 192, 521, 549, 677, 899]"
60,14,3060,1522,8489,0,2555,505,"[168, 136, 9, 48, 164, 168, 103, 28, 99, 124, 26, 9, 3, 71, 0, 131, 47, 151, 50, 10, 91, 78, 41, 38, 97, 79, 69, 116, 4]"
61,14,3693,7488,4694,0,1102,2591,"[863, 54, 515, 634, 255, 863, 108, 109, 47, 463, 551, 488, 135, 462, 0, 598, 231, 107, 20, 66, 533, 345, 81, 197, 473, 128, 381, 412, 398]"
62,14,3883,771,7806,0,553,3330,"[1110, 31, 1016, 1033, 367, 1110, 212, 225, 912, 615, 590, 1068, 996, 654, 0, 733, 455, 772, 1, 1014, 1018, 351, 970, 95, 762, 522, 76, 478, 965]"
63,14,3632,6482,4956,0,2124,1508,"[502, 115, 195, 476, 74, 502, 300, 107, 289, 336, 125, 7, 228, 178, 0, 198, 165, 451, 91, 170, 181, 142, 189, 469, 74, 217, 201, 344, 296]"
64,14,4209,1521,7644,0,1187,3022,"[1007, 363, 316, 969, 298, 1007, 701, 160, 645, 996, 812, 843, 192, 61, 0, 776, 877, 168, 914, 46, 63, 697, 7, 721, 925, 424, 186, 187, 605]"
65,14,3092,303,10000,433,1351,1741,"[580, 361, 82, 90, 94, 580, 354, 402, 355, 228, 387, 34, 237, 486, 0, 563, 142, 212, 290, 433, 277, 355, 486, 428, 478, 332, 179, 29, 543]"
66,14,4167,6852,7315,0,3773,394,"[131, 113, 47, 78, 23, 131, 40, 112, 95, 115, 13, 101, 105, 114, 0, 2, 38, 120, 34, 16, 91, 45, 83, 23, 96, 28, 103, 69, 2]"
67,14,3525,2437,8403,0,1586,1939,"[646, 534, 354, 201, 19, 646, 129, 623, 184, 631, 569, 86, 277, 149, 0, 341, 53, 182, 97, 94, 511, 18, 113, 533, 232, 561, 230, 38, 34]"
68,14,4686,6725,6364,0,2329,2357,"[785, 657, 333, 262, 644, 785, 159, 546, 230, 242, 518, 122, 606, 285, 0, 79, 155, 674, 753, 340, 225, 461, 698, 103, 501, 739, 3, 514, 630]"
69,14,4556,42,10000,878,3079,1477,"[492, 397, 208, 481, 173, 492, 253, 327, 240, 155, 318, 399, 285, 481, 0, 132, 243, 192, 98, 183, 114, 91, 198, 30, 340, 423, 95, 213, 359]"
70,14,3787,5319,8468,0,487,3300,"[1100, 451, 68, 366, 957, 1100, 250, 454, 800, 1019, 231, 842, 522, 787, 0, 602, 378, 737, 744, 21, 938, 533, 957, 233, 116, 3, 655, 143, 803]"
71,14,4081,7033,5516,0,3945,136,"[45, 37, 23, 25, 42, 45, 17, 41, 18, 15, 22, 7, 31, 27, 0, 8, 3, 11, 21, 29, 19, 14, 19, 18, 1, 19, 19, 38, 17]"
72,14,4703,2630,7589,0,3628,1075,"[358, 222, 51, 273, 291, 358, 215, 103, 227, 247, 166, 280, 190, 64, 0, 75, 17, 267, 124, 29, 76, 91, 108, 160, 2, 125, 20, 265, 40]"
73,14,3825,7117,4297,0,517,3308,"[1102, 1092, 743, 969, 401, 1102, 237, 320, 69, 156, 1019, 270, 1086, 447, 0, 337, 460, 655, 1037, 885, 901, 1069, 987, 139, 534, 194, 975, 712, 274]"
74,14,3994,1266,7025,0,2628,1366,"[455, 307, 105, 413, 39, 455, 419, 232, 222, 423, 63, 317, 409, 254, 0, 74, 26, 385, 105, 375, 173, 409, 94, 383, 368, 6, 238, 214, 236]"
75,14,4623,6892,4756,0,3691,932,"[310, 201, 295, 31, 214, 310, 29, 10, 290, 189, 179, 213, 16, 181, 0, 58, 67, 238, 134, 96, 128, 227, 70, 261, 214, 147, 10, 60, 41]"
76,14,3675,3442,4989,0,2660,1015,"[338, 271, 266, 174, 78, 338, 40, 242, 157, 66, 95, 237, 307, 150, 0, 326, 115, 211, 59, 27, 310, 302, 193, 266, 71, 204, 194, 329, 223]"
77,14,4208,1200,7997,0,3553,655,"[218, 9, 105, 168, 34, 218, 144, 12, 176, 102, 30, 137, 197, 147, 0, 141, 19, 198, 52, 186, 196, 134, 98, 66, 131, 189, 108, 116, 158]"
78,14,3634,6215,5416,0,3238,396,"[132, 67, 75, 73, 131, 132, 29, 127, 83, 96, 33, 36, 44, 118, 0, 3, 71, 16, 73, 27, 122, 55, 61, 51, 70, 17, 129, 34, 91]"
79,14,3489,49,8856,0,949,2540,"[846, 46, 248, 767, 501, 846, 164, 303, 658, 73, 140, 346, 630, 547, 0, 98, 589, 257, 145, 162, 481, 97, 818, 440, 176, 341, 675, 704, 495]"
80,14,4418,5374,7900,0,1906,2512,"[837, 493, 626, 830, 496, 837, 634, 110, 492, 353, 728, 73, 421, 279, 0, 690, 475, 538, 427, 82, 25, 640, 438, 701, 251, 780, 178, 812, 425]"
81,14,3753,7159,4494,0,2230,1523,"[507, 257, 446, 448, 24, 507, 299, 210, 140, 425, 167, 462, 403, 370, 0, 59, 42, 412, 370, 389, 183, 188, 135, 499, 465, 237, 335, 235, 199]"
82,14,4620,2529,6585,0,1205,3415,"[1138, 605, 203, 18, 327, 1138, 848, 1021, 174, 343, 43, 433, 1128, 159, 0, 76, 280, 977, 807, 546, 559, 809, 270, 513, 188, 348, 895, 336, 1047]"
83,14,3782,395,9972,0,3724,58,"[19, 4, 16, 0, 12, 19, 16, 3, 9, 15, 7, 0, 6, 17, 0, 17, 6, 16, 12, 8, 4, 2, 7, 19, 1, 2, 8, 1, 17]"
84,14,4435,7309,7098,0,720,3715,"[1238, 573, 1010, 76, 35, 1238, 380, 10, 638, 158, 643, 571, 113, 82, 0, 967, 109, 26, 1117, 863, 613, 323, 426, 1014, 443, 1116, 101, 516, 521]"
85,14,4158,7168,4088,0,3679,479,"[159, 56, 104, 51, 37, 159, 93, 89, 101, 154, 2, 117, 117, 45, 0, 104, 111, 54, 145, 153, 81, 121, 142, 87, 61, 79, 127, 41, 37]"
86,14,4719,1308,7499,0,4055,664,"[221, 33, 65, 17, 211, 221, 10, 2, 141, 169, 133, 80, 117, 72, 0, 15, 49, 4, 103, 148, 95, 141, 22, 191, 45, 213, 66, 168, 46]"
87,14,4378,6908,4969,0,4080,298,"[99, 7, 45, 94, 74, 99, 82, 51, 85, 13, 0, 11, 12, 72, 0, 40, 81, 1, 3, 44, 92, 34, 39, 85, 55, 18, 90, 61, 57]"
88,14,3816,1334,7451,0,1213,2603,"[867, 183, 829, 587, 554, 867, 73, 73, 309, 214, 419, 804, 684, 471, 0, 229, 768, 514, 14, 650, 243, 521, 629, 668, 49, 681, 91, 206, 518]"
89,14,4396,6006,5841,0,1871,2525,"[841, 599, 804, 760, 115, 841, 659, 673, 454, 134, 23, 342, 525, 379, 0, 211, 503, 833, 523, 700, 209, 537, 626, 277, 685, 22, 708, 433, 554]"
90,14,3152,2219,6774,0,1805,1347,"[449, 334, 217, 72, 63, 449, 152, 372, 368, 116, 246, 369, 18, 385, 0, 383, 242, 201, 269, 196, 362, 54, 160, 113, 20, 360, 372, 206, 350]"
91,14,4383,6050,5107,0,1639,2744,"[914, 850, 449, 494, 150, 914, 617, 503, 452, 838, 672, 328, 290, 165, 0, 17, 351, 254, 189, 290, 361, 117, 380, 746, 346, 505, 780, 736, 830]"
92,14,3918,3026,5999,0,3563,355,"[118, 6, 67, 4, 53, 118, 71, 115, 69, 70, 103, 71, 65, 112, 0, 26, 113, 10, 42, 117, 42, 31, 49, 20, 56, 17, 50, 17, 2]"
93,14,3734,824,8909,0,519,3215,"[1071, 813, 134, 744, 553, 1071, 979, 85, 180, 931, 1019, 807, 82, 703, 0, 496, 122, 246, 1071, 454, 706, 133, 130, 903, 727, 486, 928, 28, 441]"
94,14,4843,6808,6944,0,1676,3167,"[1055, 1048, 186, 406, 269, 1055, 798, 477, 7, 779, 546, 730, 94, 1, 0, 1032, 99, 629, 61, 278, 850, 567, 553, 508, 957, 792, 1033, 114, 699]"
95,14,3893,3391,7446,0,167,3726,"[1242, 546, 1018, 871, 727, 1242, 225, 848, 729, 629, 571, 741, 210, 233, 0, 721, 539, 550, 973, 682, 1134, 713, 973, 1085, 935, 913, 1162, 1155, 360]"
96,14,4597,5488,6555,0,3971,626,"[208, 26, 161, 53, 157, 208, 41, 170, 105, 83, 80, 121, 106, 207, 0, 112, 70, 168, 27, 64, 162, 101, 27, 180, 0, 157, 23, 71, 173]"
97,14,3724,796,9483,0,3494,230,"[76, 23, 23, 58, 66, 76, 24, 67, 64, 43, 25, 67, 14, 76, 0, 34, 18, 27, 66, 39, 66, 58, 26, 20, 10, 48, 21, 23, 47]"
98,14,4651,5330,8804,0,2831,1820,"[606, 500, 402, 335, 149, 606, 101, 599, 224, 421, 424, 173, 299, 438, 0, 72, 520, 241, 352, 16, 95, 82, 516, 573, 564, 518, 74, 98, 379]"
99,14,3219,5393,6630,0,1090,2129,"[709, 519, 516, 704, 460, 709, 600, 589, 392, 393, 618, 90, 538, 382, 0, 105, 660, 696, 508, 490, 61, 358, 578, 684, 156, 337, 391, 267, 159]"
100,14,3965,3101,7494,0,376,3589,"[1196, 461, 43, 680, 430, 1196, 297, 715, 245, 156, 381, 256, 959, 575, 0, 496, 346, 376, 1118, 303, 453, 72, 902, 221, 524, 64, 523, 908, 685]"
101,14,4075,5758,5811,0,1947,2128,"[709, 85, 217, 618, 296, 709, 434, 449, 463, 588, 456, 541, 188, 202, 0, 52, 364, 572, 77, 160, 92, 498, 447, 642, 481, 178, 270, 584, 631]"
102,14,3888,952,8747,0,2087,1801,"[600, 403, 426, 30, 470, 600, 431, 20, 258, 531, 260, 555, 167, 82, 0, 448, 25, 17, 505, 74, 207, 498, 420, 36, 550, 218, 86, 78, 276]"
103,14,3075,5365,6457,0,3033,42,"[14, 2, 6, 13, 3, 14, 8, 4, 6, 0, 5, 11, 9, 12, 0, 6, 3, 7, 14, 9, 13, 13, 4, 1, 5, 13, 5, 13, 2]"
104,14,3525,646,9336,0,2232,1293,"[431, 386, 25, 93, 348, 431, 236, 92, 151, 2, 106, 86, 207, 239, 0, 39, 104, 172, 251, 427, 244, 180, 352, 293, 355, 254, 52, 56, 296]"
105,14,4534,6087,7783,0,773,3761,"[1253, 1128, 827, 656, 318, 1253, 543, 167, 838, 657, 873, 298, 321, 591, 0, 484, 580, 1240, 480, 405, 1149, 853, 475, 740, 420, 446, 1040, 223, 888]"
106,14,3680,6237,5226,0,3507,173,"[57, 25, 22, 39, 43, 57, 35, 18, 25, 18, 25, 9, 7, 30, 0, 18, 7, 35, 53, 9, 10, 17, 1, 34, 38, 3, 51, 38, 28]"
107,14,4866,2173,7919,0,104,4762,"[1587, 1463, 767, 280, 560, 1587, 1470, 1159, 803, 1061, 860, 751, 1135, 1330, 0, 38, 1379, 303, 1064, 436, 42, 1090, 692, 273, 1231, 224, 1510, 1544, 1568]"
108,14,4770,7213,5476,0,1449,3321,"[1107, 543, 486, 268, 758, 1107, 569, 64, 97, 37, 844, 363, 942, 92, 0, 373, 491, 79, 772, 632, 539, 4, 223, 157, 1011, 28, 355, 279, 1031]"
109,14,3820,2817,6479,0,373,3447,"[1149, 1104, 33, 907, 857, 1149, 621, 910, 439, 1039, 429, 496, 966, 58, 0, 606, 735, 320, 325, 843, 1121, 905, 556, 460, 413, 1133, 62, 384, 351]"
110,14,3159,2415,7223,0,2844,315,"[105, 94, 93, 55, 85, 105, 87, 72, 63, 58, 56, 6, 5, 71, 0, 53, 12, 45, 75, 101, 41, 98, 3, 29, 82, 45, 26, 39, 72]"
111,14,3311,1929,8605,0,1732,1579,"[526, 335, 105, 375, 442, 526, 84, 340, 402, 387, 442, 430, 156, 355, 0, 161, 210, 123, 230, 359, 503, 448, 257, 345, 369, 376, 98, 383, 264]"
112,14,3874,5369,7110,0,687,3187,"[1062, 706, 494, 456, 43, 1062, 793, 434, 376, 117, 816, 1033, 1013, 716, 0, 829, 685, 937, 767, 898, 699, 399, 862, 288, 351, 1048, 778, 209, 217]"
113,14,4706,6916,4900,0,2387,2319,"[773, 312, 384, 559, 542, 773, 531, 332, 385, 691, 351, 501, 58, 675, 0, 171, 195, 15, 703, 612, 471, 647, 265, 721, 422, 734, 615, 633, 693]"
114,14,4429,1852,7477,0,1247,3182,"[1060, 975, 529, 694, 675, 1060, 562, 684, 916, 603, 850, 970, 276, 525, 0, 179, 847, 21, 187, 633, 177, 852, 739, 78, 870, 357, 644, 709, 239]"
115,14,3809,5487,5799,0,3253,556,"[185, 152, 46, 151, 136, 185, 183, 111, 172, 90, 160, 50, 120, 132, 0, 46, 24, 20, 77, 117, 13, 183, 110, 183, 173, 131, 181, 37, 14]"
116,14,4504,617,9686,0,3255,1249,"[416, 116, 123, 81, 72, 416, 179, 15, 197, 5, 226, 204, 366, 164, 0, 408, 55, 22, 11, 59, 231, 66, 172, 149, 110, 15, 253, 337, 76]"
117,14,4493,7151,7028,0,977,3516,"[1172, 662, 810, 594, 184, 1172, 18, 147, 138, 1096, 1002, 118, 547, 540, 0, 1106, 410, 272, 955, 137, 176, 433, 1020, 1128, 476, 1067, 1103, 475, 777]"
118,14,4308,5866,5470,0,3590,718,"[239, 26, 104, 139, 195, 239, 8, 105, 223, 62, 49, 162, 16, 62, 0, 85, 124, 231, 165, 141, 154, 223, 202, 8, 33, 77, 199, 101, 186]"
119,14,3243,1397,7316,0,3000,243,"[81, 33, 43, 51, 64, 81, 44, 79, 22, 68, 18, 68, 57, 48, 0, 64, 46, 19, 21, 64, 4, 76, 1, 9, 25, 45, 2, 0, 23]"
0,15,6557,0,6557,0,5542,1015,"[283, 156, 132, 249, 325, 96, 58, 85, 338, 338, 305, 85, 61, 61, 186, 0, 105, 198, 72, 251, 161, 147, 331, 40, 242, 255, 120, 46, 29]"
1,15,5735,7227,5065,0,3538,2197,"[504, 710, 545, 471, 511, 102, 59, 650, 732, 732, 672, 469, 306, 703, 311, 0, 298, 726, 197, 200, 249, 687, 409, 35, 697, 670, 422, 141, 446]"
2,15,6115,6900,4280,0,3210,2905,"[30, 291, 890, 94, 165, 41, 310, 750, 968, 968, 223, 343, 177, 521, 439, 0, 653, 396, 754, 118, 813, 798, 483, 261, 149, 37, 510, 174, 953]"
3,15,5638,5503,4415,0,1530,4108,"[731, 1293, 1293, 581, 777, 355, 862, 239, 1369, 1369, 548, 472, 1066, 176, 425, 0, 1042, 1099, 50, 1002, 908, 1366, 1266, 686, 1093, 1179, 1301, 635, 380]"
4,15,5689,5495,4609,0,2942,2747,"[148, 152, 297, 880, 407, 232, 91, 218, 915, 915, 201, 560, 223, 172, 855, 0, 394, 581, 516, 696, 569, 30, 11, 436, 737, 208, 615, 824, 171]"
5,15,5911,50,10000,470,2029,3882,"[276, 978, 589, 542, 1169, 707, 120, 494, 1294, 1294, 705, 244, 876, 858, 401, 0, 518, 956, 78, 887, 7, 489, 639, 740, 397, 1118, 1254, 342, 89]"
6,15,5861,5917,9944,0,3587,2274,"[444, 491, 689, 285, 597, 17, 583, 30, 758, 758, 753, 288, 343, 199, 143, 0, 68, 217, 431, 176, 490, 71, 553, 590, 566, 168, 135, 616, 588]"
7,15,6181,5655,10000,470,5895,286,"[49, 3, 91, 37, 13, 95, 76, 93, 95, 95, 55, 50, 91, 82, 40, 0, 26, 60, 2, 22, 35, 29, 52, 47, 22, 57, 39, 11, 94]"
8,15,6810,6710,10000,100,2669,4141,"[511, 942, 161, 794, 951, 700, 388, 175, 1380, 1380, 8, 1009, 484, 750, 656, 0, 981, 1323, 807, 715, 978, 975, 200, 792, 979, 922, 1100, 1235, 688]"
9,15,5473,7353,8120,0,2909,2564,"[331, 296, 126, 77, 614, 786, 13, 819, 854, 854, 712, 438, 374, 405, 283, 0, 166, 687, 585, 156, 300, 353, 412, 771, 277, 40, 471, 465, 545]"
10,15,6594,6409,8305,0,4294,2300,"[514, 696, 256, 102, 730, 341, 720, 17, 766, 766, 624, 384, 197, 445, 41, 0, 407, 607, 196, 299, 5, 360, 225, 733, 268, 218, 524, 752, 542]"
11,15,6181,6357,8129,0,2508,3673,"[573, 552, 244, 444, 947, 234, 1057, 1213, 1224, 1224, 568, 971, 692, 1216, 112, 0, 1151, 731, 827, 703, 1029, 855, 798, 933, 1131, 24, 439, 977, 461]"
12,15,5208,7192,6145,0,2554,2654,"[211, 262, 111, 58, 691, 148, 188, 241, 884, 884, 636, 459, 800, 119, 364, 0, 719, 491, 468, 524, 596, 399, 484, 785, 463, 849, 67, 372, 347]"
13,15,6816,5682,7279,0,3521,3295,"[782, 126, 463, 945, 905, 740, 1049, 130, 1098, 1098, 99, 412, 50, 971, 318, 0, 419, 220, 303, 733, 527, 33, 253, 216, 502, 746, 565, 326, 10]"
14,15,5750,7195,5834,0,3135,2615,"[713, 363, 769, 111, 585, 806, 443, 567, 871, 871, 831, 532, 610, 86, 731, 0, 326, 331, 277, 405, 846, 11, 658, 236, 147, 471, 16, 847, 409]"
15,15,6658,6317,6175,0,1198,5460,"[735, 1815, 618, 1412, 1508, 624, 763, 241, 1820, 1820, 798, 1045, 1177, 1147, 108, 0, 1109, 327, 1801, 1623, 535, 1328, 1336, 1364, 876, 1698, 278, 805, 878]"
16,15,6420,7227,5368,0,4124,2296,"[122, 372, 613, 559, 557, 398, 179, 16, 765, 765, 649, 135, 211, 310, 694, 0, 68, 499, 473, 584, 178, 353, 285, 506, 763, 7, 167, 173, 151]"
17,15,5899,7436,3831,0,1169,4730,"[160, 726, 309, 1475, 512, 79, 189, 484, 1576, 1576, 1538, 109, 1039, 1498, 429, 0, 533, 1036, 1367, 837, 807, 1238, 678, 404, 1025, 350, 1325, 1393, 314]"
18,15,6904,3854,6881,0,4075,2829,"[348, 452, 511, 767, 845, 887, 359, 268, 943, 943, 166, 157, 452, 83, 555, 0, 562, 898, 207, 382, 52, 679, 462, 570, 121, 297, 236, 403, 782]"
19,15,5674,6230,6325,0,3701,1973,"[544, 464, 568, 405, 87, 462, 566, 248, 657, 657, 167, 150, 371, 310, 597, 0, 364, 310, 73, 592, 394, 131, 148, 284, 144, 222, 90, 68, 181]"
20,15,6635,7167,5793,0,1218,5417,"[1591, 360, 595, 1299, 644, 384, 1466, 1134, 1805, 1805, 344, 1799, 305, 738, 1029, 0, 1219, 1209, 1771, 1104, 1321, 516, 1188, 524, 711, 88, 1732, 1111, 892]"
21,15,5767,6352,5208,0,2315,3452,"[605, 1055, 1074, 818, 677, 420, 32, 691, 1150, 1150, 833, 229, 780, 168, 883, 0, 590, 985, 365, 215, 257, 265, 349, 104, 131, 803, 931, 989, 796]"
22,15,5958,5635,5531,0,1642,4316,"[1257, 405, 355, 929, 407, 1035, 919, 1015, 1438, 1438, 430, 1239, 193, 979, 237, 0, 384, 968, 763, 1425, 1194, 829, 433, 888, 1407, 888, 1030, 606, 193]"
23,15,5184,4633,6082,0,4788,396,"[35, 51, 100, 79, 20, 42, 100, 115, 132, 132, 119, 131, 101, 60, 55, 0, 15, 122, 19, 35, 54, 109, 69, 76, 126, 17, 105, 93, 86]"
24,15,5201,5888,5395,0,2700,2501,"[57, 766, 646, 243, 673, 291, 597, 592, 833, 833, 360, 564, 123, 378, 237, 0, 313, 579, 306, 60, 312, 563, 240, 799, 731, 232, 151, 821, 571]"
25,15,5836,6007,5224,0,2697,3139,"[583, 193, 120, 258, 757, 498, 355, 583, 1046, 1046, 989, 931, 178, 624, 170, 0, 301, 394, 299, 182, 241, 577, 113, 529, 214, 69, 358, 265, 243]"
26,15,5993,6349,4868,0,2967,3026,"[790, 386, 739, 189, 919, 446, 767, 700, 1008, 1008, 861, 607, 739, 741, 649, 0, 298, 670, 596, 888, 901, 697, 759, 632, 330, 822, 382, 251, 530]"
27,15,5275,1465,8678,0,5108,167,"[31, 41, 54, 18, 51, 11, 33, 44, 55, 55, 49, 40, 3, 51, 39, 0, 41, 13, 1, 43, 35, 44, 50, 16, 49, 48, 8, 2, 8]"
28,15,5931,6687,7922,0,1548,4383,"[261, 240, 328, 1057, 745, 1086, 1392, 40, 1461, 1461, 445, 736, 226, 460, 435, 0, 1305, 245, 721, 318, 127, 564, 429, 121, 744, 430, 907, 196, 695]"
29,15,6434,6158,8198,0,5585,849,"[86, 257, 146, 137, 229, 65, 262, 223, 283, 283, 3, 68, 157, 230, 129, 0, 276, 63, 188, 61, 53, 67, 211, 93, 73, 267, 253, 81, 82]"
30,15,5063,7499,5762,0,1628,3435,"[1135, 415, 503, 104, 358, 160, 746, 384, 1145, 1145, 486, 151, 43, 334, 1139, 0, 453, 97, 892, 749, 1034, 992, 511, 638, 963, 705, 258, 766, 996]"
31,15,5803,6876,4689,0,4405,1398,"[180, 175, 244, 58, 344, 415, 43, 68, 466, 466, 262, 28, 157, 343, 366, 0, 277, 120, 65, 327, 394, 116, 90, 97, 39, 90, 61, 357, 143]"
32,15,6424,6661,4452,0,2801,3623,"[568, 157, 139, 374, 1043, 755, 710, 317, 1207, 1207, 1196, 553, 8, 542, 84, 0, 278, 1074, 510, 1153, 853, 54, 1115, 509, 345, 467, 838, 888, 358]"
33,15,6564,6847,4169,0,1300,5264,"[759, 325, 669, 559, 1264, 377, 740, 174, 1754, 1754, 570, 1446, 1375, 1535, 685, 0, 434, 1471, 786, 120, 1412, 1329, 320, 455, 1269, 319, 585, 153, 1363]"
34,15,6552,3648,7073,0,3671,2881,"[279, 721, 30, 414, 223, 74, 57, 138, 960, 960, 314, 299, 136, 306, 133, 0, 616, 680, 536, 727, 883, 372, 658, 847, 876, 326, 582, 751, 839]"
35,15,5881,5937,7017,0,1150,4731,"[543, 822, 1436, 1383, 1417, 735, 852, 902, 1577, 1577, 339, 275, 101, 1395, 322, 0, 1466, 1161, 1247, 120, 1387, 1513, 1459, 559, 1426, 1383, 525, 790, 792]"
36,15,6654,7103,6568,0,6606,48,"[2, 3, 5, 16, 9, 10, 12, 7, 16, 16, 3, 14, 1, 15, 15, 0, 0, 0, 5, 11, 6, 3, 5, 6, 13, 1, 10, 8, 16]"
37,15,6204,6488,6284,0,4492,1712,"[466, 39, 547, 136, 531, 164, 8, 186, 570, 570, 377, 357, 60, 65, 360, 0, 293, 121, 378, 175, 501, 349, 428, 326, 8, 481, 399, 174, 180]"
38,15,6428,6993,5719,0,5591,837,"[94, 265, 46, 51, 255, 175, 244, 182, 279, 279, 166, 159, 38, 120, 226, 0, 163, 154, 118, 95, 68, 44, 88, 49, 12, 245, 1, 88, 245]"
39,15,5253,270,10000,702,123,5130,"[638, 719, 1012, 1123, 637, 1118, 80, 1583, 1710, 1710, 278, 1513, 1455, 1115, 574, 0, 604, 985, 973, 800, 548, 1557, 1390, 1292, 1646, 758, 1563, 29, 740]"
40,15,5353,6616,8737,0,4135,1218,"[3, 135, 16, 223, 363, 308, 317, 274, 406, 406, 36, 267, 36, 390, 206, 0, 32, 303, 275, 144, 387, 229, 269, 372, 227, 42, 40, 223, 112]"
41,15,5704,6819,7622,0,245,5459,"[78, 54, 1149, 785, 1485, 1472, 616, 299, 1819, 1819, 1111, 281, 536, 1481, 477, 0, 7, 1302, 1446, 990, 1133, 1408, 204, 1038, 49, 1035, 368, 1347, 310]"
42,15,6603,7039,7186,0,2963,3640,"[625, 812, 569, 82, 806, 347, 413, 653, 1213, 1213, 729, 847, 130, 142, 525, 0, 548, 391, 748, 110, 677, 456, 64, 466, 23, 202, 361, 888, 1193]"
43,15,6963,5069,9080,0,6306,657,"[153, 45, 18, 145, 34, 211, 54, 22, 219, 219, 101, 79, 18, 168, 181, 0, 155, 124, 74, 186, 52, 172, 133, 173, 74, 28, 22, 147, 83]"
44,15,6998,6850,9228,0,1578,5420,"[830, 1120, 320, 902, 1215, 885, 1351, 1621, 1806, 1806, 229, 1605, 1269, 956, 1131, 0, 1371, 830, 1742, 420, 1329, 338, 249, 1388, 419, 720, 1626, 1535, 515]"
45,15,6578,6033,9773,0,4072,2506,"[271, 639, 588, 729, 39, 520, 744, 568, 835, 835, 72, 197, 318, 480, 230, 0, 631, 397, 666, 326, 360, 795, 371, 15, 605, 424, 516, 794, 31]"
46,15,5785,6760,8798,0,2191,3594,"[1194, 850, 953, 668, 374, 889, 378, 241, 1198, 1198, 243, 756, 1098, 1019, 883, 0, 475, 468, 987, 984, 841, 578, 85, 918, 704, 405, 1089, 647, 724]"
47,15,5516,6319,7995,0,3790,1726,"[501, 183, 345, 44, 152, 492, 161, 333, 575, 575, 340, 74, 404, 422, 556, 0, 466, 319, 56, 232, 374, 490, 183, 425, 544, 413, 263, 12, 505]"
48,15,6190,5759,8426,0,4955,1235,"[138, 130, 23, 402, 322, 36, 363, 12, 411, 411, 65, 116, 303, 98, 78, 0, 75, 289, 307, 410, 148, 304, 322, 366, 171, 337, 99, 242, 260]"
49,15,6274,5052,9648,0,972,5302,"[791, 489, 1358, 1174, 1233, 1477, 653, 770, 1767, 1767, 265, 1082, 1127, 635, 563, 0, 1595, 811, 630, 409, 1061, 1380, 921, 1425, 1105, 812, 1295, 1746, 751]"
50,15,6276,5884,10000,40,2205,4071,"[16, 1305, 102, 92, 449, 806, 813, 236, 1357, 1357, 61, 614, 530, 1177, 844, 0, 891, 1249, 688, 376, 691, 186, 21, 170, 726, 1097, 1070, 74, 408]"
51,15,5012,6114,8898,0,1468,3544,"[263, 1122, 1003, 1099, 21, 859, 910, 163, 1181, 1181, 325, 964, 271, 1029, 100, 0, 371, 86, 46, 811, 490, 230, 307, 313, 860, 160, 420, 931, 242]"
52,15,5891,5714,9075,0,2656,3235,"[401, 311, 335, 845, 1057, 473, 298, 286, 1078, 1078, 979, 552, 821, 793, 525, 0, 42, 82, 192, 293, 477, 705, 1015, 567, 56, 112, 929, 61, 411]"
53,15,5847,5038,9884,0,2408,3439,"[691, 830, 855, 803, 981, 155, 415, 14, 1146, 1146, 167, 29, 580, 1002, 596, 0, 45, 980, 78, 606, 158, 243, 907, 996, 632, 1041, 358, 1082, 634]"
54,15,6182,6821,9245,0,3560,2622,"[861, 702, 35, 333, 121, 846, 840, 300, 874, 874, 272, 669, 268, 123, 223, 0, 676, 795, 333, 813, 54, 654, 824, 369, 497, 851, 97, 477, 291]"
55,15,5640,7105,7780,0,3513,2127,"[648, 518, 294, 647, 589, 176, 69, 129, 709, 709, 266, 521, 648, 657, 319, 0, 635, 500, 387, 274, 25, 67, 651, 498, 48, 367, 218, 459, 549]"
56,15,6972,5719,9033,0,459,6513,"[911, 1869, 1251, 478, 1426, 670, 1687, 1005, 2171, 2171, 110, 2139, 1335, 97, 1899, 0, 2035, 1311, 140, 606, 213, 1331, 669, 1610, 995, 2158, 2019, 1744, 1880]"
57,15,5768,5298,9503,0,2053,3715,"[734, 238, 315, 921, 568, 467, 461, 1085, 1238, 1238, 392, 596, 155, 695, 20, 0, 282, 777, 257, 983, 128, 1225, 507, 1047, 507, 1146, 310, 144, 619]"
58,15,6408,5383,10000,528,156,6252,"[1339, 1234, 1648, 739, 1560, 1505, 1026, 1557, 2084, 2084, 1964, 1362, 996, 145, 143, 0, 1564, 1148, 225, 581, 1419, 1658, 1566, 973, 679, 194, 390, 1934, 1878]"
59,15,6056,5559,10000,497,3886,2170,"[659, 390, 215, 571, 218, 578, 467, 610, 723, 723, 48, 706, 610, 267, 271, 0, 700, 526, 193, 141, 130, 307, 49, 391, 323, 326, 536, 352, 209]"
60,15,5710,5447,10000,263,3754,1956,"[247, 565, 353, 393, 494, 365, 248, 508, 652, 652, 415, 359, 490, 532, 533, 0, 193, 591, 545, 99, 555, 257, 144, 585, 417, 498, 353, 315, 191]"
61,15,5603,7227,8376,0,3604,1999,"[99, 605, 91, 392, 462, 331, 579, 663, 666, 666, 242, 126, 538, 471, 524, 0, 71, 126, 15, 614, 43, 593, 572, 203, 503, 380, 416, 300, 380]"
62,15,5766,6830,7312,0,725,5041,"[1438, 263, 1450, 1292, 565, 85, 104, 153, 1680, 1680, 1309, 819, 446, 1205, 360, 0, 1389, 4, 565, 1611, 1376, 1540, 256, 424, 1621, 881, 1395, 655, 553]"
63,15,6734,7168,6878,0,2922,3812,"[747, 914, 336, 138, 616, 693, 203, 777, 1270, 1270, 139, 739, 183, 306, 1119, 0, 16, 1187, 694, 1246, 687, 1059, 1100, 143, 62, 729, 189, 1126, 230]"
64,15,6645,5345,8178,0,4850,1795,"[331, 590, 549, 377, 60, 95, 298, 131, 598, 598, 484, 506, 505, 476, 523, 0, 170, 2, 265, 218, 271, 13, 534, 297, 247, 280, 143, 87, 236]"
65,15,6975,5319,9834,0,924,6051,"[83, 1933, 727, 192, 590, 640, 587, 1726, 2017, 2017, 1817, 1635, 1444, 452, 2015, 0, 165, 372, 580, 766, 1681, 506, 1574, 874, 17, 406, 376, 1710, 1011]"
66,15,5226,5138,9922,0,185,5041,"[780, 1108, 12, 687, 1320, 1266, 78, 877, 1680, 1680, 910, 962, 387, 181, 1182, 0, 1584, 116, 1268, 1159, 1623, 770, 585, 189, 755, 1143, 1290, 1403, 847]"
67,15,5372,6334,8960,0,5080,292,"[55, 35, 92, 83, 26, 88, 25, 35, 97, 97, 77, 54, 17, 31, 67, 0, 37, 24, 46, 55, 93, 28, 72, 78, 86, 89, 4, 19, 76]"
68,15,6359,7312,8007,0,3740,2619,"[794, 419, 393, 514, 266, 484, 487, 528, 873, 873, 629, 804, 10, 801, 170, 0, 428, 196, 288, 469, 187, 223, 463, 557, 496, 628, 784, 316, 27]"
69,15,6438,5493,8952,0,5780,658,"[60, 174, 148, 131, 133, 181, 93, 207, 219, 219, 22, 192, 83, 60, 70, 0, 190, 136, 114, 75, 83, 14, 115, 4, 19, 140, 92, 66, 39]"
70,15,5987,6872,8067,0,524,5463,"[1039, 323, 216, 1798, 729, 494, 1775, 879, 1821, 1821, 1539, 1140, 756, 1066, 365, 0, 1816, 1474, 1410, 1485, 355, 1534, 1272, 879, 567, 325, 560, 800, 1666]"
71,15,6236,7113,7190,0,532,5704,"[548, 362, 468, 1323, 659, 91, 1025, 1238, 1901, 1901, 1344, 808, 1537, 1536, 121, 0, 206, 508, 1546, 760, 697, 48, 631, 478, 1235, 722, 1758, 448, 480]"
72,15,5836,5332,7694,0,330,5506,"[1310, 1469, 491, 949, 1132, 1499, 63, 341, 1835, 1835, 763, 185, 101, 134, 717, 0, 556, 102, 1519, 494, 1019, 305, 505, 58, 107, 1394, 11, 1705, 995]"
73,15,5268,6365,6597,0,4940,328,"[105, 94, 57, 94, 74, 2, 88, 48, 109, 109, 15, 63, 80, 87, 13, 0, 92, 27, 101, 107, 20, 106, 40, 62, 76, 107, 68, 63, 34]"
74,15,5403,6901,5099,0,3284,2119,"[683, 300, 417, 658, 548, 384, 247, 11, 706, 706, 137, 306, 20, 697, 530, 0, 271, 107, 36, 248, 405, 562, 337, 377, 352, 326, 145, 211, 487]"
75,15,6591,5783,5907,0,41,6550,"[1475, 83, 1866, 2000, 1330, 1328, 952, 128, 2183, 2183, 1085, 198, 266, 1241, 838, 0, 436, 385, 1510, 2042, 1527, 1899, 2064, 914, 1281, 1914, 2008, 1337, 1463]"
76,15,5425,7466,3866,0,3834,1591,"[109, 58, 468, 84, 313, 137, 414, 281, 530, 530, 364, 268, 248, 471, 523, 0, 25, 69, 51, 80, 324, 382, 213, 339, 305, 35, 487, 524, 258]"
77,15,5139,1015,7990,0,812,4327,"[505, 247, 1351, 13, 704, 11, 1389, 89, 1442, 1442, 1062, 876, 84, 139, 239, 0, 1011, 885, 747, 764, 445, 739, 1010, 1023, 965, 990, 646, 1431, 1106]"
78,15,6332,6453,7869,0,796,5536,"[433, 1413, 1599, 620, 685, 1049, 266, 750, 1845, 1845, 288, 833, 812, 497, 763, 0, 592, 1838, 435, 1514, 555, 292, 1279, 1660, 600, 1291, 90, 84, 291]"
79,15,6411,5049,9231,0,1992,4419,"[1131, 10, 900, 701, 939, 719, 190, 830, 1473, 1473, 1282, 491, 1042, 951, 1213, 0, 653, 598, 202, 548, 1207, 42, 270, 1215, 390, 1153, 1211, 484, 1345]"
80,15,6908,5088,10000,1051,2720,4188,"[420, 1326, 681, 1330, 1036, 130, 626, 1025, 1396, 1396, 921, 801, 313, 92, 1310, 0, 1011, 330, 142, 313, 725, 370, 526, 71, 394, 657, 342, 477, 1324]"
81,15,5743,6232,9511,0,840,4903,"[700, 1402, 870, 999, 1107, 346, 466, 1254, 1634, 1634, 674, 510, 786, 1533, 1079, 0, 958, 789, 773, 1491, 1420, 950, 383, 669, 1027, 413, 762, 1399, 1049]"
82,15,5460,7365,7606,0,1761,3699,"[17, 967, 617, 1047, 1138, 327, 1183, 922, 1233, 1233, 992, 75, 823, 1211, 386, 0, 491, 1110, 1227, 938, 250, 1195, 461, 12, 447, 187, 827, 727, 1096]"
83,15,5735,6194,7147,0,3072,2663,"[405, 343, 805, 762, 289, 365, 430, 513, 887, 887, 251, 166, 454, 861, 513, 0, 26, 275, 696, 582, 340, 582, 841, 334, 870, 854, 151, 321, 228]"
84,15,5654,5085,7716,0,5125,529,"[139, 10, 12, 171, 27, 16, 143, 86, 176, 176, 98, 61, 143, 3, 175, 0, 144, 140, 97, 119, 2, 0, 72, 132, 95, 113, 101, 53, 56]"
85,15,6724,6419,8021,0,4450,2274,"[38, 254, 642, 642, 611, 116, 233, 674, 758, 758, 630, 325, 418, 144, 214, 0, 358, 401, 740, 281, 528, 206, 179, 676, 416, 160, 258, 116, 600]"
86,15,6760,5734,9047,0,5811,949,"[83, 196, 172, 291, 86, 249, 263, 310, 316, 316, 184, 63, 182, 45, 3, 0, 258, 296, 202, 309, 91, 224, 31, 2, 261, 231, 282, 154, 243]"
87,15,5148,7062,7133,0,682,4466,"[120, 905, 1251, 1189, 269, 1179, 970, 907, 1488, 1488, 728, 191, 1394, 1403, 1105, 0, 198, 835, 372, 546, 100, 1251, 1467, 1424, 1093, 1474, 1248, 979, 1035]"
88,15,6845,6407,7571,0,2882,3963,"[1290, 91, 1051, 1257, 306, 317, 518, 1295, 1321, 1321, 785, 427, 849, 1180, 154, 0, 525, 81, 729, 506, 91, 552, 1182, 1094, 106, 981, 1077, 889, 762]"
89,15,6588,5750,8409,0,2945,3643,"[749, 260, 24, 727, 879, 934, 391, 559, 1214, 1214, 840, 348, 393, 790, 773, 0, 934, 895, 1179, 155, 404, 102, 74, 128, 470, 758, 958, 613, 715]"
90,15,6346,7315,7440,0,530,5816,"[954, 25, 565, 945, 288, 1272, 762, 1372, 1938, 1938, 1488, 1445, 1193, 378, 1218, 0, 1554, 1513, 1664, 1607, 889, 1732, 682, 833, 1412, 1649, 388, 827, 1403]"
91,15,6014,7194,6260,0,5146,868,"[170, 75, 270, 42, 281, 19, 255, 257, 289, 289, 245, 44, 124, 239, 132, 0, 25, 174, 264, 228, 203, 68, 209, 201, 178, 159, 199, 155, 120]"
92,15,6698,7491,5467,0,6294,404,"[5, 48, 115, 95, 122, 129, 52, 130, 134, 134, 13, 44, 126, 32, 104, 0, 92, 1, 54, 116, 114, 95, 68, 25, 103, 97, 67, 84, 106]"
93,15,6712,6532,5647,0,4050,2662,"[854, 66, 260, 787, 705, 79, 99, 717, 887, 887, 296, 829, 637, 233, 132, 0, 299, 423, 503, 31, 234, 405, 609, 474, 879, 319, 458, 795, 822]"
94,15,5742,7002,4387,0,4004,1738,"[180, 72, 311, 568, 285, 261, 206, 209, 579, 579, 218, 238, 88, 278, 132, 0, 573, 85, 17, 368, 293, 228, 53, 433, 280, 546, 253, 115, 160]"
95,15,6161,1753,8795,0,1778,4383,"[907, 1220, 348, 301, 590, 1065, 1348, 1149, 1461, 1461, 368, 81, 157, 341, 233, 0, 1397, 606, 1336, 678, 798, 648, 34, 1040, 279, 345, 446, 200, 179]"
96,15,6987,5427,10000,355,2236,4751,"[1478, 363, 1075, 1385, 415, 973, 528, 1043, 1583, 1583, 1510, 1052, 1252, 102, 703, 0, 150, 672, 526, 1576, 1409, 1538, 1268, 606, 1086, 1036, 720, 356, 1393]"
97,15,6161,7181,8980,0,458,5703,"[324, 111, 1628, 1751, 614, 247, 16, 535, 1901, 1901, 146, 1182, 1899, 909, 968, 0, 742, 1518, 1139, 804, 1195, 533, 1140, 757, 1151, 1634, 677, 1637, 651]"
98,15,6164,6360,8784,0,1063,5101,"[577, 1487, 1672, 1139, 1024, 1475, 993, 374, 1700, 1700, 975, 69, 490, 97, 1189, 0, 847, 1353, 367, 807, 1019, 1675, 544, 1435, 1029, 1062, 1382, 1460, 820]"
99,15,6203,7034,7953,0,548,5655,"[1679, 1317, 283, 1274, 1709, 1254, 778, 1040, 1885, 1885, 363, 1670, 1686, 1786, 1139, 0, 1045, 1241, 357, 639, 566, 1121, 1090, 1356, 1117, 1056, 1678, 1052, 167]"
100,15,5965,7030,6888,0,1732,4233,"[986, 523, 454, 86, 657, 1063, 266, 1356, 1411, 1411, 485, 1079, 1123, 1402, 1118, 0, 6, 515, 1271, 903, 34, 918, 942, 1317, 60, 682, 958, 711, 92]"
101,15,5697,5591,6994,0,1394,4303,"[1221, 793, 1218, 548, 992, 329, 131, 1248, 1434, 1434, 692, 893, 1171, 723, 789, 0, 538, 869, 539, 861, 1196, 826, 195, 392, 1006, 1008, 575, 316, 808]"
102,15,5991,6849,6136,0,1563,4428,"[1155, 187, 855, 1416, 841, 1051, 1215, 859, 1476, 1476, 617, 999, 200, 940, 56, 0, 381, 740, 953, 459, 1307, 869, 77, 870, 1189, 8, 256, 1095, 1452]"
103,15,6225,5583,6778,0,4268,1957,"[146, 641, 463, 587, 386, 451, 272, 47, 652, 652, 502, 7, 535, 305, 436, 0, 132, 142, 511, 491, 598, 455, 201, 355, 180, 581, 149, 454, 105]"
104,15,6457,6049,7186,0,4194,2263,"[16, 118, 139, 366, 618, 715, 64, 541, 754, 754, 173, 540, 605, 108, 179, 0, 197, 127, 490, 323, 609, 555, 93, 40, 355, 266, 464, 121, 289]"
105,15,6435,5938,7683,0,4579,1856,"[253, 600, 465, 618, 589, 606, 349, 245, 618, 618, 228, 253, 288, 244, 263, 0, 549, 326, 112, 389, 312, 277, 389, 344, 272, 350, 142, 539, 380]"
106,15,6161,5020,8824,0,448,5713,"[660, 1145, 758, 331, 646, 799, 1863, 86, 1904, 1904, 1651, 1389, 51, 1809, 1890, 0, 131, 1137, 942, 1463, 848, 599, 219, 268, 484, 809, 151, 1516, 1650]"
107,15,6934,7476,8282,0,1770,5164,"[1129, 1216, 44, 888, 1573, 1669, 1670, 71, 1721, 1721, 729, 1364, 1469, 66, 365, 0, 1636, 1497, 1021, 267, 464, 1640, 812, 869, 604, 1709, 1518, 380, 394]"
108,15,6190,5133,9339,0,592,5598,"[742, 1334, 422, 922, 172, 299, 347, 575, 1866, 1866, 893, 671, 1275, 1724, 119, 0, 1564, 541, 979, 1388, 1051, 399, 1243, 1490, 420, 1222, 1741, 318, 633]"
109,15,6562,6352,9549,0,4552,2010,"[368, 101, 111, 478, 349, 147, 401, 371, 670, 670, 333, 402, 171, 13, 529, 0, 315, 141, 478, 667, 468, 604, 127, 437, 642, 652, 516, 128, 57]"
110,15,5617,5695,9471,0,616,5001,"[1176, 1650, 305, 215, 162, 67, 16, 1605, 1667, 1667, 1170, 646, 1062, 585, 911, 0, 703, 593, 237, 1275, 893, 104, 186, 1571, 1380, 1162, 185, 1376, 932]"
111,15,5131,6631,7971,0,1954,3177,"[8, 355, 281, 781, 486, 1026, 377, 334, 1059, 1059, 189, 707, 193, 943, 824, 0, 656, 860, 624, 297, 8, 11, 387, 31, 487, 553, 606, 19, 640]"
112,15,6521,5729,8763,0,192,6329,"[1284, 821, 1138, 116, 1335, 135, 1857, 805, 2109, 2109, 319, 153, 690, 525, 2057, 0, 940, 1645, 574, 725, 1876, 897, 1001, 579, 1200, 1003, 1680, 1551, 1930]"
113,15,5549,5668,8644,0,591,4958,"[727, 876, 579, 254, 1168, 1006, 1123, 907, 1652, 1652, 349, 519, 550, 80, 829, 0, 301, 1190, 869, 1551, 1553, 809, 937, 449, 1295, 515, 436, 393, 1313]"
114,15,5117,6221,7540,0,4108,1009,"[79, 51, 228, 71, 305, 223, 227, 237, 336, 336, 276, 294, 267, 264, 300, 0, 6, 141, 144, 48, 219, 182, 222, 6, 231, 210, 125, 170, 284]"
115,15,5667,6637,6570,0,3405,2262,"[219, 241, 78, 402, 681, 398, 76, 45, 754, 754, 613, 82, 615, 89, 543, 0, 34, 409, 138, 591, 481, 559, 142, 493, 562, 420, 167, 738, 512]"
116,15,6870,6085,7355,0,57,6813,"[1586, 1920, 1503, 923, 1326, 410, 2144, 731, 2271, 2271, 1704, 1266, 975, 2150, 1204, 0, 2135, 1813, 1154, 1, 845, 112, 1063, 1017, 661, 2044, 636, 992, 305]"
117,15,5761,6571,6545,0,4109,1652,"[520, 353, 0, 481, 16, 433, 364, 305, 550, 550, 263, 290, 524, 313, 64, 0, 314, 116, 463, 52, 550, 336, 527, 282, 117, 245, 278, 49, 433]"
118,15,6462,5391,7616,0,176,6286,"[1014, 471, 1816, 501, 1271, 89, 1052, 7, 2095, 2095, 1702, 1849, 308, 1107, 420, 0, 1750, 328, 505, 1112, 1203, 1760, 27, 1449, 1469, 1470, 1612, 1895, 1780]"
119,15,5572,6530,6658,0,1235,4337,"[236, 1236, 1007, 217, 340, 800, 1297, 652, 1445, 1445, 705, 356, 1005, 339, 275, 0, 1253, 1157, 788, 936, 739, 280, 1205, 1203, 1163, 279, 1427, 1377, 842]"
0,16,80,0,80,0,38,42,"[14, 13, 9, 6, 12, 0, 7, 7, 14, 12, 14, 3, 5, 3, 9, 2, 0, 12, 6, 6, 14, 13, 9, 14, 12, 2, 9, 6, 11]"
1,16,71,56,95,0,58,13,"[4, 1, 0, 0, 2, 3, 0, 0, 1, 1, 0, 1, 0, 3, 4, 4, 0, 1, 3, 0, 4, 4, 4, 4, 2, 4, 4, 3, 4]"
2,16,50,45,100,0,41,9,"[1, 0, 0, 1, 1, 2, 3, 0, 2, 0, 0, 3, 0, 2, 0, 0, 0, 1, 0, 0, 3, 2, 1, 3, 2, 1, 3, 1, 1]"
3,16,72,18,154,0,51,21,"[2, 6, 7, 6, 6, 6, 2, 1, 7, 1, 0, 7, 1, 2, 5, 6, 0, 6, 2, 5, 7, 6, 0, 7, 7, 0, 2, 7, 2]"
4,16,91,78,167,0,31,60,"[19, 3, 15, 10, 1, 20, 7, 6, 13, 10, 19, 20, 15, 4, 1, 3, 0, 3, 4, 17, 20, 20, 18, 20, 19, 18, 10, 5, 15]"
5,16,43,31,179,0,19,24,"[8, 4, 3, 6, 1, 0, 3, 6, 6, 6, 5, 7, 7, 8, 7, 1, 0, 6, 2, 4, 8, 8, 0, 8, 7, 6, 2, 4, 1]"
6,16,39,8,210,0,25,14,"[0, 0, 1, 1, 1, 3, 4, 1, 2, 2, 1, 4, 1, 4, 1, 1, 0, 0, 0, 3, 4, 1, 2, 4, 0, 1, 4, 1, 2]"
7,16,91,65,236,0,54,37,"[7, 6, 3, 11, 5, 0, 3, 9, 12, 12, 0, 5, 9, 3, 2, 10, 0, 9, 6, 1, 12, 12, 4, 12, 3, 12, 11, 10, 3]"
8,16,99,1,334,0,1,98,"[27, 28, 23, 5, 10, 5, 22, 18, 19, 14, 6, 25, 26, 17, 16, 29, 0, 8, 4, 15, 32, 4, 18, 32, 9, 7, 21, 1, 18]"
9,16,79,48,365,0,36,43,"[0, 9, 14, 8, 2, 6, 13, 3, 9, 0, 8, 7, 11, 5, 9, 5, 0, 2, 11, 2, 14, 4, 12, 14, 6, 11, 14, 12, 6]"
10,16,58,38,385,0,16,42,"[8, 12, 4, 6, 8, 8, 1, 6, 10, 8, 11, 5, 0, 1, 11, 3, 0, 12, 8, 14, 14, 5, 4, 14, 5, 3, 2, 1, 0]"
11,16,41,4,422,0,2,39,"[4, 10, 6, 4, 10, 12, 13, 12, 13, 7, 7, 1, 8, 4, 13, 4, 0, 3, 10, 4, 13, 3, 1, 13, 7, 6, 0, 8, 6]"
12,16,97,7,512,0,60,37,"[0, 2, 7, 12, 12, 6, 10, 10, 11, 12, 11, 11, 3, 1, 12, 2, 0, 4, 12, 7, 12, 4, 11, 12, 12, 8, 11, 2, 0]"
13,16,74,36,550,0,62,12,"[4, 1, 4, 2, 2, 3, 3, 3, 2, 0, 1, 4, 2, 0, 0, 3, 0, 3, 2, 4, 4, 3, 1, 4, 1, 1, 2, 1, 0]"
14,16,47,42,555,0,44,3,"[1, 0, 1, 1, 1, 0, 1, 0, 0, 0, 0, 0, 1, 0, 0, 0, 0, 0, 1, 0, 1, 1, 1, 1, 0, 0, 0, 0, 0]"
15,16,93,59,589,0,56,37,"[0, 1, 8, 5, 4, 2, 8, 8, 1, 8, 4, 0, 11, 3, 0, 11, 0, 2, 7, 9, 12, 8, 11, 12, 11, 4, 7, 0, 3]"
16,16,46,41,594,0,26,20,"[4, 5, 5, 2, 2, 4, 3, 3, 5, 2, 2, 1, 0, 5, 2, 0, 0, 5, 6, 2, 6, 3, 6, 6, 1, 2, 2, 0, 3]"
17,16,8,0,602,0,5,3,"[0, 0, 1, 0, 0, 1, 0, 1, 1, 1, 0, 1, 0, 0, 0, 0, 0, 0, 1, 0, 1, 0, 1, 1, 1, 1, 0, 1, 0]"
18,16,10,1,611,0,4,6,"[2, 1, 0, 2, 2, 0, 1, 1, 2, 2, 0, 1, 2, 0, 0, 2, 0, 0, 2, 2, 2, 2, 0, 2, 1, 2, 2, 2, 1]"
19,16,57,6,662,0,41,16,"[1, 4, 4, 5, 1, 4, 3, 3, 2, 5, 5, 5, 0, 0, 5, 0, 0, 0, 0, 5, 5, 4, 1, 5, 1, 5, 2, 0, 4]"
20,16,79,22,719,0,73,6,"[1, 2, 2, 0, 1, 0, 2, 0, 2, 2, 0, 0, 0, 0, 2, 0, 0, 0, 0, 0, 2, 2, 2, 2, 2, 0, 0, 0, 0]"
21,16,76,61,734,0,64,12,"[1, 0, 2, 4, 0, 0, 1, 1, 0, 1, 4, 0, 4, 4, 3, 0, 0, 3, 2, 2, 4, 3, 0, 4, 4, 1, 1, 0, 1]"
22,16,35,5,764,0,0,35,"[4, 6, 8, 1, 3, 7, 1, 8, 3, 6, 9, 0, 1, 3, 2, 11, 0, 10, 10, 7, 11, 8, 7, 11, 10, 10, 7, 11, 6]"
23,16,60,26,798,0,19,41,"[7, 6, 6, 3, 11, 10, 0, 8, 11, 12, 6, 6, 6, 5, 8, 4, 0, 3, 8, 4, 13, 0, 12, 13, 2, 13, 11, 5, 4]"
24,16,52,5,845,0,27,25,"[6, 7, 1, 7, 8, 1, 8, 3, 5, 0, 8, 2, 4, 7, 8, 8, 0, 8, 8, 5, 8, 6, 3, 8, 1, 4, 2, 4, 5]"
25,16,22,0,867,0,20,2,"[0, 0, 0, 0, 0, 0, 0, 0, 0, 0, 0, 0, 0, 0, 0, 0, 0, 0, 0, 0, 0, 0, 0, 0, 0, 0, 0, 0, 0]"
26,16,94,63,898,0,2,92,"[16, 28, 28, 0, 30, 10, 13, 24, 11, 26, 14, 26, 24, 9, 14, 29, 0, 1, 19, 28, 30, 20, 21, 30, 25, 13, 14, 11, 19]"
27,16,72,69,901,0,49,23,"[2, 6, 2, 6, 6, 3, 4, 4, 4, 2, 2, 5, 0, 6, 0, 1, 0, 2, 0, 0, 7, 1, 3, 7, 6, 0, 3, 5, 1]"
28,16,83,35,949,0,24,59,"[19, 3, 5, 16, 9, 12, 0, 19, 0, 1, 5, 18, 15, 19, 17, 2, 0, 18, 8, 6, 19, 17, 4, 19, 9, 5, 2, 18, 18]"
29,16,13,9,953,0,8,5,"[1, 0, 0, 1, 1, 0, 1, 0, 0, 0, 0, 1, 0, 0, 0, 0, 0, 1, 1, 0, 1, 0, 1, 1, 1, 0, 0, 1, 1]"
30,16,34,30,957,0,22,12,"[1, 3, 3, 3, 2, 1, 1, 1, 1, 3, 4, 4, 0, 2, 1, 3, 0, 0, 2, 3, 4, 3, 1, 4, 2, 2, 3, 3, 3]"
31,16,76,62,971,0,67,9,"[1, 3, 1, 3, 2, 3, 3, 3, 0, 2, 3, 0, 3, 1, 0, 2, 0, 0, 2, 0, 3, 0, 1, 3, 3, 0, 2, 3, 3]"
32,16,75,3,1043,0,75,0,"[0, 0, 0, 0, 0, 0, 0, 0, 0, 0, 0, 0, 0, 0, 0, 0, 0, 0, 0, 0, 0, 0, 0, 0, 0, 0, 0, 0, 0]"
33,16,58,26,1075,0,47,11,"[1, 1, 0, 3, 3, 1, 0, 3, 0, 3, 2, 0, 0, 3, 3, 3, 0, 0, 1, 2, 3, 0, 0, 3, 1, 1, 0, 0, 2]"
34,16,63,49,1089,0,54,9,"[3, 2, 2, 1, 0, 0, 2, 0, 0, 2, 3, 1, 3, 2, 0, 0, 0, 2, 3, 0, 3, 2, 2, 3, 2, 2, 1, 0, 0]"
35,16,34,2,1121,0,12,22,"[5, 3, 3, 6, 0, 4, 5, 2, 7, 1, 1, 2, 3, 7, 1, 0, 0, 1, 7, 7, 7, 4, 4, 7, 3, 2, 2, 4, 5]"
36,16,78,64,1135,0,68,10,"[3, 3, 2, 2, 0, 2, 2, 0, 3, 2, 0, 2, 0, 2, 2, 3, 0, 2, 3, 3, 3, 1, 2, 3, 1, 0, 0, 2, 2]"
37,16,4,2,1137,0,2,2,"[0, 0, 0, 0, 0, 0, 0, 0, 0, 0, 0, 0, 0, 0, 0, 0, 0, 0, 0, 0, 0, 0, 0, 0, 0, 0, 0, 0, 0]"
38,16,46,14,1169,0,12,34,"[6, 8, 8, 9, 10, 4, 3, 1, 8, 0, 5, 1, 11, 7, 5, 11, 0, 0, 6, 10, 11, 6, 7, 11, 6, 2, 7, 3, 4]"
39,16,23,16,1176,0,6,17,"[5, 3, 0, 0, 1, 0, 5, 3, 5, 1, 1, 5, 3, 0, 3, 3, 0, 5, 2, 2, 5, 4, 5, 5, 2, 4, 5, 1, 4]"
40,16,71,55,1192,0,27,44,"[12, 8, 6, 1, 8, 3, 10, 8, 7, 4, 3, 7, 8, 6, 11, 1, 0, 4, 6, 2, 14, 4, 11, 14, 5, 8, 8, 8, 10]"
41,16,25,14,1203,0,0,25,"[1, 4, 5, 8, 2, 2, 0, 7, 1, 2, 7, 0, 6, 7, 1, 6, 0, 7, 3, 0, 8, 5, 6, 8, 8, 7, 8, 3, 5]"
42,16,3,0,1206,0,1,2,"[0, 0, 0, 0, 0, 0, 0, 0, 0, 0, 0, 0, 0, 0, 0, 0, 0, 0, 0, 0, 0, 0, 0, 0, 0, 0, 0, 0, 0]"
43,16,6,1,1211,0,2,4,"[0, 0, 0, 1, 1, 0, 1, 0, 0, 0, 1, 1, 0, 0, 1, 1, 0, 1, 1, 1, 1, 0, 0, 1, 0, 1, 1, 0, 0]"
44,16,39,6,1244,0,20,19,"[4, 4, 5, 0, 6, 5, 1, 2, 4, 5, 5, 2, 0, 5, 1, 5, 0, 3, 4, 3, 6, 0, 3, 6, 1, 1, 6, 0, 4]"
45,16,44,0,1288,0,36,8,"[0, 2, 0, 2, 0, 0, 0, 1, 0, 2, 1, 1, 2, 0, 2, 2, 0, 2, 1, 0, 2, 2, 2, 2, 1, 0, 2, 1, 0]"
46,16,1,0,1245,0,0,1,"[0, 0, 0, 0, 0, 0, 0, 0, 0, 0, 0, 0, 0, 0, 0, 0, 0, 0, 0, 0, 0, 0, 0, 0, 0, 0, 0, 0, 0]"
47,16,23,2,1266,0,22,1,"[0, 0, 0, 0, 0, 0, 0, 0, 0, 0, 0, 0, 0, 0, 0, 0, 0, 0, 0, 0, 0, 0, 0, 0, 0, 0, 0, 0, 0]"
48,16,61,46,1281,0,51,10,"[3, 0, 0, 2, 0, 2, 0, 1, 2, 3, 3, 1, 1, 3, 2, 3, 0, 2, 3, 0, 3, 2, 2, 3, 2, 1, 2, 0, 2]"
49,16,57,30,1308,0,1,56,"[6, 15, 18, 9, 12, 4, 9, 15, 12, 1, 16, 7, 14, 9, 1, 8, 0, 2, 2, 8, 18, 15, 6, 18, 15, 0, 12, 13, 18]"
50,16,57,1,1364,0,30,27,"[1, 4, 8, 9, 4, 1, 5, 6, 1, 7, 7, 4, 9, 9, 4, 2, 0, 2, 9, 1, 9, 6, 2, 9, 3, 2, 0, 5, 3]"
51,16,11,5,1370,0,0,11,"[2, 1, 0, 3, 1, 2, 1, 3, 0, 1, 3, 2, 2, 2, 0, 1, 0, 2, 1, 3, 3, 1, 3, 3, 0, 1, 1, 2, 3]"
52,16,42,11,1401,0,14,28,"[6, 4, 2, 7, 9, 9, 6, 3, 6, 7, 8, 5, 9, 8, 4, 1, 0, 5, 5, 8, 9, 3, 6, 9, 6, 1, 6, 1, 2]"
53,16,96,17,1480,0,6,90,"[16, 23, 4, 29, 15, 30, 6, 23, 4, 6, 18, 22, 17, 27, 3, 19, 0, 14, 24, 24, 30, 5, 20, 30, 28, 21, 9, 16, 25]"
54,16,39,6,1513,0,10,29,"[0, 6, 8, 9, 8, 8, 3, 1, 7, 1, 3, 4, 9, 8, 4, 1, 0, 4, 5, 2, 9, 4, 0, 9, 6, 3, 0, 7, 9]"
55,16,64,53,1524,0,58,6,"[1, 0, 0, 1, 2, 2, 1, 1, 1, 1, 1, 1, 1, 0, 0, 0, 0, 2, 0, 1, 2, 0, 2, 2, 0, 1, 1, 0, 2]"
56,16,64,59,1529,0,37,27,"[4, 5, 6, 5, 7, 7, 7, 8, 4, 9, 8, 6, 6, 7, 6, 2, 0, 9, 5, 0, 9, 6, 6, 9, 8, 7, 6, 5, 7]"
57,16,16,3,1542,0,15,1,"[0, 0, 0, 0, 0, 0, 0, 0, 0, 0, 0, 0, 0, 0, 0, 0, 0, 0, 0, 0, 0, 0, 0, 0, 0, 0, 0, 0, 0]"
58,16,78,19,1601,0,15,63,"[21, 14, 4, 9, 15, 8, 13, 20, 0, 19, 12, 2, 20, 1, 2, 12, 0, 14, 18, 13, 21, 10, 8, 21, 17, 11, 0, 14, 19]"
59,16,37,8,1630,0,15,22,"[5, 4, 3, 2, 2, 1, 5, 5, 5, 2, 1, 1, 3, 1, 1, 1, 0, 3, 0, 7, 7, 7, 1, 7, 3, 3, 4, 4, 4]"
60,16,4,3,1631,0,2,2,"[0, 0, 0, 0, 0, 0, 0, 0, 0, 0, 0, 0, 0, 0, 0, 0, 0, 0, 0, 0, 0, 0, 0, 0, 0, 0, 0, 0, 0]"
61,16,17,8,1640,0,13,4,"[1, 0, 0, 0, 0, 1, 1, 0, 0, 0, 0, 1, 0, 0, 0, 0, 0, 0, 1, 0, 1, 1, 0, 1, 1, 1, 1, 1, 1]"
62,16,38,20,1658,0,11,27,"[6, 9, 9, 0, 0, 4, 4, 3, 8, 1, 8, 2, 5, 8, 6, 8, 0, 8, 0, 8, 9, 6, 1, 9, 3, 5, 4, 5, 8]"
63,16,18,18,1658,0,12,6,"[2, 0, 2, 2, 0, 0, 2, 0, 1, 0, 1, 0, 0, 0, 1, 2, 0, 0, 1, 0, 2, 1, 0, 2, 2, 0, 0, 0, 0]"
64,16,67,60,1665,0,28,39,"[3, 10, 1, 7, 1, 7, 13, 10, 0, 8, 9, 4, 4, 11, 1, 12, 0, 13, 5, 4, 13, 8, 5, 13, 0, 9, 6, 13, 9]"
65,16,56,2,1719,0,3,53,"[0, 4, 7, 1, 4, 11, 0, 6, 5, 11, 2, 15, 6, 9, 11, 4, 0, 8, 4, 17, 17, 12, 6, 17, 4, 1, 3, 5, 10]"
66,16,44,12,1751,0,42,2,"[0, 0, 0, 0, 0, 0, 0, 0, 0, 0, 0, 0, 0, 0, 0, 0, 0, 0, 0, 0, 0, 0, 0, 0, 0, 0, 0, 0, 0]"
67,16,95,74,1772,0,52,43,"[9, 9, 10, 0, 1, 7, 5, 7, 7, 6, 2, 7, 14, 4, 2, 14, 0, 6, 7, 1, 14, 0, 11, 14, 2, 2, 8, 8, 5]"
68,16,11,7,1776,0,3,8,"[1, 0, 1, 1, 1, 1, 2, 2, 1, 2, 0, 0, 2, 2, 2, 0, 0, 0, 2, 1, 2, 1, 0, 2, 2, 0, 0, 1, 1]"
69,16,4,1,1779,0,4,0,"[0, 0, 0, 0, 0, 0, 0, 0, 0, 0, 0, 0, 0, 0, 0, 0, 0, 0, 0, 0, 0, 0, 0, 0, 0, 0, 0, 0, 0]"
70,16,74,12,1841,0,23,51,"[5, 11, 12, 5, 6, 0, 8, 13, 2, 10, 11, 11, 0, 5, 17, 17, 0, 15, 12, 0, 17, 7, 1, 17, 9, 15, 15, 13, 2]"
71,16,41,8,1874,0,23,18,"[2, 1, 1, 4, 5, 6, 0, 2, 6, 1, 2, 5, 4, 5, 0, 3, 0, 2, 2, 4, 6, 1, 2, 6, 1, 3, 3, 6, 4]"
72,16,72,12,1934,0,69,3,"[0, 1, 0, 1, 1, 1, 1, 0, 0, 0, 0, 1, 1, 1, 1, 1, 0, 0, 1, 0, 1, 1, 1, 1, 0, 1, 1, 1, 0]"
73,16,92,36,1990,0,85,7,"[2, 2, 0, 2, 2, 1, 0, 1, 0, 2, 2, 1, 2, 2, 0, 2, 0, 0, 2, 1, 2, 2, 2, 2, 2, 0, 2, 0, 0]"
74,16,75,29,2036,0,59,16,"[2, 4, 0, 1, 1, 3, 0, 3, 1, 1, 3, 2, 4, 5, 2, 5, 0, 3, 0, 0, 5, 3, 4, 5, 4, 3, 1, 4, 3]"
75,16,38,29,2045,0,0,38,"[9, 5, 9, 5, 0, 0, 6, 1, 10, 3, 1, 7, 7, 3, 1, 6, 0, 1, 10, 10, 12, 5, 10, 12, 6, 7, 0, 5, 9]"
76,16,22,21,2046,0,15,7,"[0, 0, 2, 0, 1, 0, 2, 1, 0, 0, 0, 2, 1, 0, 2, 2, 0, 2, 0, 0, 2, 2, 0, 2, 1, 0, 1, 2, 2]"
77,16,1,0,2046,0,1,0,"[0, 0, 0, 0, 0, 0, 0, 0, 0, 0, 0, 0, 0, 0, 0, 0, 0, 0, 0, 0, 0, 0, 0, 0, 0, 0, 0, 0, 0]"
78,16,86,63,2069,0,18,68,"[11, 6, 6, 18, 0, 16, 12, 18, 17, 13, 20, 11, 6, 3, 8, 20, 0, 11, 15, 13, 22, 1, 6, 22, 22, 12, 9, 11, 15]"
79,16,99,86,2082,0,14,85,"[0, 2, 10, 4, 21, 15, 7, 2, 1, 26, 6, 6, 10, 16, 10, 26, 0, 4, 16, 17, 28, 24, 10, 28, 4, 17, 21, 21, 4]"
80,16,5,2,2085,0,4,1,"[0, 0, 0, 0, 0, 0, 0, 0, 0, 0, 0, 0, 0, 0, 0, 0, 0, 0, 0, 0, 0, 0, 0, 0, 0, 0, 0, 0, 0]"
81,16,32,9,2108,0,7,25,"[8, 8, 1, 5, 5, 7, 7, 3, 5, 4, 6, 8, 4, 8, 3, 1, 0, 2, 5, 7, 8, 2, 6, 8, 1, 1, 8, 4, 2]"
82,16,69,52,2125,0,33,36,"[1, 1, 1, 4, 8, 0, 3, 7, 6, 3, 10, 11, 5, 11, 0, 8, 0, 11, 0, 9, 12, 1, 0, 12, 5, 12, 7, 7, 6]"
83,16,37,1,2161,0,25,12,"[0, 4, 2, 4, 2, 4, 2, 4, 3, 0, 2, 4, 0, 3, 1, 2, 0, 4, 0, 2, 4, 2, 4, 4, 2, 0, 3, 2, 2]"
84,16,97,10,2248,0,68,29,"[4, 4, 5, 9, 1, 8, 4, 3, 2, 2, 3, 8, 8, 7, 2, 0, 0, 8, 8, 7, 9, 9, 9, 9, 1, 0, 8, 4, 3]"
85,16,0,0,2248,0,0,0,"[0, 0, 0, 0, 0, 0, 0, 0, 0, 0, 0, 0, 0, 0, 0, 0, 0, 0, 0, 0, 0, 0, 0, 0, 0, 0, 0, 0, 0]"
86,16,57,47,2258,0,38,19,"[4, 0, 5, 1, 5, 6, 5, 4, 2, 5, 4, 4, 3, 0, 0, 0, 0, 0, 1, 4, 6, 5, 4, 6, 1, 1, 4, 4, 0]"
87,16,7,3,2262,0,4,3,"[0, 1, 0, 1, 1, 1, 1, 1, 1, 1, 1, 1, 1, 0, 0, 1, 0, 0, 0, 1, 1, 1, 1, 1, 1, 0, 0, 1, 1]"
88,16,87,17,2332,0,51,36,"[7, 3, 1, 6, 10, 11, 11, 9, 3, 7, 6, 8, 6, 10, 7, 12, 0, 10, 7, 4, 12, 1, 4, 12, 7, 9, 1, 4, 4]"
89,16,66,46,2352,0,54,12,"[0, 2, 0, 1, 3, 0, 4, 2, 2, 0, 3, 0, 1, 0, 2, 3, 0, 4, 4, 4, 4, 4, 4, 4, 4, 1, 1, 4, 3]"
90,16,59,12,2399,0,4,55,"[13, 3, 16, 5, 3, 6, 14, 1, 14, 5, 12, 11, 13, 12, 8, 15, 0, 9, 16, 12, 18, 9, 17, 18, 12, 0, 11, 0, 18]"
91,16,73,40,2432,0,58,15,"[0, 4, 0, 0, 3, 3, 5, 0, 3, 3, 1, 1, 5, 3, 4, 3, 0, 1, 0, 2, 5, 5, 5, 5, 1, 0, 0, 3, 1]"
92,16,41,0,2473,0,17,24,"[8, 2, 5, 7, 5, 1, 6, 0, 5, 8, 8, 0, 7, 8, 6, 4, 0, 6, 4, 4, 8, 0, 3, 8, 3, 3, 3, 4, 5]"
93,16,8,4,2477,0,4,4,"[0, 0, 1, 1, 0, 0, 0, 0, 0, 0, 0, 0, 1, 1, 1, 1, 0, 1, 1, 0, 1, 0, 1, 1, 1, 0, 0, 0, 1]"
94,16,31,15,2493,0,19,12,"[1, 1, 3, 2, 2, 0, 0, 1, 0, 3, 4, 2, 2, 1, 1, 1, 0, 2, 1, 0, 4, 2, 0, 4, 0, 3, 1, 4, 3]"
95,16,44,34,2503,0,38,6,"[1, 1, 0, 0, 1, 2, 1, 0, 1, 0, 1, 1, 2, 1, 0, 1, 0, 1, 1, 2, 2, 2, 2, 2, 0, 1, 2, 1, 1]"
96,16,9,7,2505,0,7,2,"[0, 0, 0, 0, 0, 0, 0, 0, 0, 0, 0, 0, 0, 0, 0, 0, 0, 0, 0, 0, 0, 0, 0, 0, 0, 0, 0, 0, 0]"
97,16,99,81,2523,0,20,79,"[15, 21, 5, 1, 3, 11, 26, 25, 25, 19, 9, 2, 6, 5, 5, 2, 0, 17, 12, 19, 26, 5, 16, 26, 20, 10, 17, 22, 18]"
98,16,72,27,2568,0,39,33,"[10, 5, 1, 8, 6, 0, 1, 5, 2, 3, 10, 5, 11, 10, 0, 7, 0, 11, 3, 11, 11, 3, 7, 11, 3, 11, 11, 9, 6]"
99,16,74,45,2597,0,38,36,"[2, 5, 0, 0, 12, 3, 3, 3, 2, 1, 9, 12, 4, 7, 4, 7, 0, 7, 9, 4, 12, 10, 4, 12, 2, 4, 8, 3, 5]"
100,16,95,46,2646,0,29,66,"[0, 15, 15, 0, 20, 10, 15, 21, 7, 21, 2, 19, 17, 4, 12, 5, 0, 10, 7, 14, 22, 0, 12, 22, 12, 16, 5, 17, 12]"
101,16,86,36,2696,0,11,75,"[7, 19, 13, 19, 19, 11, 7, 21, 8, 6, 15, 13, 10, 14, 4, 17, 0, 8, 22, 0, 25, 5, 2, 25, 17, 3, 5, 16, 19]"
102,16,21,5,2712,0,21,0,"[0, 0, 0, 0, 0, 0, 0, 0, 0, 0, 0, 0, 0, 0, 0, 0, 0, 0, 0, 0, 0, 0, 0, 0, 0, 0, 0, 0, 0]"
103,16,25,20,2717,0,8,17,"[2, 1, 0, 3, 4, 1, 4, 3, 5, 3, 5, 5, 3, 1, 4, 2, 0, 0, 1, 5, 5, 1, 4, 5, 3, 4, 5, 1, 3]"
104,16,18,17,2718,0,8,10,"[3, 1, 1, 2, 0, 3, 1, 0, 3, 0, 2, 0, 2, 1, 2, 0, 0, 1, 3, 0, 3, 3, 3, 3, 0, 3, 0, 0, 3]"
105,16,21,16,2723,0,2,19,"[2, 0, 2, 5, 6, 0, 4, 6, 5, 5, 3, 3, 5, 6, 2, 0, 0, 5, 3, 6, 6, 6, 4, 6, 0, 1, 0, 2, 2]"
106,16,39,32,2730,0,30,9,"[1, 2, 3, 3, 3, 2, 2, 1, 0, 0, 3, 1, 3, 3, 2, 0, 0, 0, 1, 2, 3, 2, 2, 3, 0, 1, 2, 0, 2]"
107,16,30,17,2743,0,15,15,"[1, 0, 2, 0, 2, 2, 3, 4, 3, 2, 4, 0, 2, 5, 3, 5, 0, 5, 5, 3, 5, 3, 5, 5, 1, 3, 3, 0, 0]"
108,16,65,13,2795,0,36,29,"[2, 1, 5, 4, 2, 5, 8, 3, 3, 2, 9, 5, 4, 6, 5, 6, 0, 0, 3, 2, 9, 6, 6, 9, 9, 5, 8, 6, 4]"
109,16,13,5,2803,0,3,10,"[1, 1, 3, 3, 3, 0, 1, 0, 1, 0, 0, 2, 2, 3, 0, 1, 0, 2, 0, 1, 3, 1, 0, 3, 3, 3, 3, 2, 0]"
110,16,18,15,2806,0,13,5,"[0, 1, 1, 0, 1, 0, 0, 1, 0, 1, 1, 0, 0, 0, 1, 0, 0, 0, 0, 0, 1, 0, 0, 1, 0, 1, 0, 1, 1]"
111,16,78,68,2816,0,32,46,"[4, 2, 15, 14, 11, 10, 10, 11, 6, 12, 2, 15, 11, 2, 9, 1, 0, 9, 11, 4, 15, 6, 0, 15, 7, 1, 2, 4, 8]"
112,16,22,10,2828,0,12,10,"[0, 0, 3, 2, 3, 1, 1, 0, 0, 3, 3, 3, 1, 2, 0, 1, 0, 1, 3, 0, 3, 1, 2, 3, 3, 2, 0, 1, 3]"
113,16,81,4,2905,0,73,8,"[0, 0, 1, 1, 2, 2, 0, 2, 0, 2, 2, 2, 1, 2, 0, 0, 0, 1, 2, 2, 2, 0, 0, 2, 2, 0, 1, 0, 2]"
114,16,92,50,2947,0,12,80,"[24, 12, 17, 4, 0, 11, 16, 20, 26, 8, 0, 3, 0, 15, 26, 10, 0, 9, 17, 15, 26, 6, 7, 26, 1, 16, 18, 18, 11]"
115,16,32,7,2972,0,15,17,"[3, 1, 5, 0, 0, 4, 4, 3, 0, 5, 1, 5, 0, 2, 4, 5, 0, 4, 2, 4, 5, 0, 4, 5, 2, 5, 5, 0, 2]"
116,16,81,37,3016,0,5,76,"[24, 12, 7, 1, 23, 21, 8, 0, 21, 12, 22, 22, 24, 15, 2, 3, 0, 14, 12, 13, 25, 20, 13, 25, 5, 16, 0, 22, 22]"
117,16,32,31,3017,0,23,9,"[3, 3, 2, 1, 1, 0, 2, 3, 0, 0, 0, 0, 1, 3, 2, 1, 0, 1, 0, 2, 3, 1, 1, 3, 3, 1, 3, 0, 1]"
118,16,21,19,3019,0,3,18,"[0, 4, 2, 2, 5, 3, 5, 0, 3, 4, 0, 1, 5, 2, 0, 0, 0, 1, 1, 1, 6, 5, 3, 6, 6, 5, 2, 2, 2]"
119,16,53,40,3032,0,42,11,"[2, 1, 0, 2, 0, 2, 3, 0, 2, 3, 3, 2, 3, 1, 3, 3, 0, 2, 0, 2, 3, 1, 3, 3, 1, 0, 0, 1, 0]"
0,17,1458,0,1458,0,449,1009,"[156, 18, 59, 334, 49, 124, 170, 108, 83, 162, 58, 158, 335, 179, 181, 179, 237, 0, 241, 336, 133, 298, 328, 29, 118, 198, 336, 136, 327]"
1,17,2599,1390,2667,0,1331,1268,"[307, 26, 372, 393, 265, 306, 175, 370, 271, 16, 342, 21, 332, 225, 390, 90, 323, 0, 124, 422, 253, 159, 117, 240, 103, 200, 422, 103, 389]"
2,17,1936,854,3749,0,944,992,"[232, 119, 108, 47, 82, 176, 264, 34, 175, 317, 229, 189, 295, 269, 272, 123, 246, 0, 46, 330, 280, 241, 219, 318, 165, 239, 330, 119, 73]"
3,17,1761,1202,4308,0,968,793,"[139, 251, 45, 43, 75, 72, 0, 13, 64, 61, 39, 6, 32, 163, 49, 226, 116, 0, 262, 264, 53, 61, 105, 253, 258, 85, 264, 124, 178]"
4,17,1749,1725,4332,0,961,788,"[73, 124, 170, 73, 223, 1, 81, 174, 7, 76, 128, 126, 23, 247, 110, 245, 32, 0, 14, 262, 253, 68, 54, 179, 220, 102, 262, 13, 184]"
5,17,1054,11,5375,0,409,645,"[168, 40, 189, 161, 138, 151, 124, 130, 32, 12, 144, 206, 80, 152, 181, 99, 110, 0, 115, 215, 186, 160, 141, 65, 205, 73, 215, 186, 98]"
6,17,2146,2135,5386,0,836,1310,"[199, 154, 7, 24, 387, 96, 136, 304, 329, 246, 197, 310, 406, 219, 435, 129, 2, 0, 423, 436, 200, 366, 346, 149, 205, 204, 436, 376, 231]"
7,17,2834,2711,5509,0,1155,1679,"[488, 203, 481, 440, 24, 382, 340, 63, 21, 380, 80, 108, 240, 444, 51, 200, 281, 0, 554, 559, 555, 539, 65, 176, 447, 440, 559, 114, 181]"
8,17,2309,1153,6665,0,907,1402,"[43, 213, 359, 429, 123, 133, 280, 442, 368, 428, 437, 434, 173, 211, 209, 215, 90, 0, 84, 467, 29, 253, 181, 401, 65, 416, 467, 323, 331]"
9,17,1987,1923,6729,0,1323,664,"[140, 66, 102, 68, 41, 35, 118, 68, 106, 200, 151, 187, 221, 64, 186, 187, 113, 0, 162, 221, 164, 141, 165, 28, 168, 152, 221, 110, 62]"
10,17,1985,1051,7663,0,1623,362,"[60, 40, 106, 79, 24, 36, 94, 34, 80, 110, 59, 60, 44, 54, 23, 11, 88, 0, 11, 120, 89, 69, 39, 29, 86, 111, 120, 2, 64]"
11,17,1929,1156,8436,0,195,1734,"[243, 171, 39, 14, 537, 40, 40, 540, 225, 461, 274, 361, 571, 520, 456, 291, 457, 0, 193, 578, 425, 2, 576, 21, 486, 511, 578, 30, 263]"
12,17,1440,1138,8738,0,587,853,"[89, 239, 106, 149, 88, 149, 250, 149, 69, 199, 43, 53, 100, 198, 194, 225, 257, 0, 43, 284, 250, 13, 53, 239, 104, 265, 284, 104, 47]"
13,17,2074,740,10000,72,1715,359,"[29, 4, 43, 67, 9, 30, 92, 3, 113, 97, 90, 89, 57, 50, 117, 42, 25, 0, 96, 119, 63, 55, 106, 18, 59, 28, 119, 13, 112]"
14,17,1483,6613,4870,0,231,1252,"[416, 289, 205, 234, 257, 386, 176, 129, 97, 327, 315, 60, 318, 287, 299, 312, 9, 0, 109, 417, 128, 375, 122, 258, 164, 2, 417, 145, 188]"
15,17,1652,1040,5482,0,147,1505,"[19, 361, 478, 69, 169, 55, 380, 295, 463, 151, 491, 106, 166, 405, 384, 257, 208, 0, 274, 501, 113, 224, 373, 465, 213, 54, 501, 147, 138]"
16,17,2868,1281,7069,0,1932,936,"[128, 6, 257, 280, 310, 1, 176, 222, 77, 267, 260, 102, 275, 216, 78, 112, 184, 0, 11, 312, 4, 58, 291, 93, 50, 289, 312, 159, 125]"
17,17,2024,146,8947,0,1824,200,"[34, 28, 7, 18, 32, 15, 25, 15, 1, 54, 12, 33, 16, 40, 22, 29, 35, 0, 5, 66, 12, 53, 26, 31, 12, 51, 66, 1, 17]"
18,17,2217,6218,4946,0,154,2063,"[660, 65, 603, 685, 573, 112, 406, 18, 15, 406, 274, 110, 33, 380, 169, 453, 669, 0, 317, 687, 272, 637, 150, 409, 49, 140, 687, 249, 321]"
19,17,2924,1363,6507,0,1699,1225,"[3, 276, 316, 270, 175, 394, 240, 128, 293, 43, 199, 148, 297, 272, 36, 76, 177, 0, 239, 408, 32, 19, 334, 280, 353, 108, 408, 126, 102]"
20,17,2415,1071,7851,0,2079,336,"[108, 44, 103, 4, 55, 108, 65, 85, 22, 57, 61, 68, 112, 20, 99, 30, 60, 0, 41, 112, 110, 55, 4, 94, 38, 12, 112, 64, 59]"
21,17,1793,841,8803,0,263,1530,"[390, 73, 438, 487, 58, 42, 96, 358, 409, 200, 117, 145, 374, 177, 70, 214, 406, 0, 177, 510, 327, 280, 267, 83, 328, 378, 510, 70, 421]"
22,17,2971,5490,6284,0,1467,1504,"[128, 159, 145, 473, 303, 302, 171, 85, 137, 311, 497, 496, 386, 76, 88, 170, 67, 0, 238, 501, 474, 216, 282, 56, 347, 484, 501, 229, 371]"
23,17,2824,2323,6785,0,1792,1032,"[26, 40, 328, 248, 270, 204, 295, 177, 196, 336, 73, 72, 313, 17, 136, 273, 88, 0, 171, 344, 96, 176, 72, 37, 74, 73, 344, 184, 110]"
24,17,1455,7,8233,0,230,1225,"[266, 41, 234, 7, 386, 6, 308, 86, 260, 355, 270, 68, 205, 223, 237, 394, 273, 0, 89, 408, 257, 403, 316, 136, 27, 314, 408, 195, 389]"
25,17,2407,1089,9551,0,197,2210,"[295, 130, 730, 624, 188, 72, 368, 623, 193, 514, 719, 138, 314, 586, 423, 8, 504, 0, 53, 736, 149, 170, 440, 568, 341, 147, 736, 457, 301]"
26,17,1173,190,10000,534,751,422,"[103, 4, 136, 24, 114, 31, 134, 140, 136, 8, 3, 22, 114, 51, 47, 62, 126, 0, 34, 140, 48, 33, 22, 43, 1, 1, 140, 25, 47]"
27,17,1621,6383,5238,0,755,866,"[244, 262, 246, 53, 229, 255, 54, 173, 256, 259, 86, 6, 121, 183, 138, 99, 65, 0, 26, 288, 44, 173, 205, 248, 163, 66, 288, 140, 275]"
28,17,1667,463,6442,0,1033,634,"[50, 171, 17, 17, 95, 88, 174, 185, 134, 146, 77, 89, 16, 64, 125, 105, 23, 0, 115, 211, 186, 201, 81, 32, 163, 78, 211, 203, 89]"
29,17,1897,64,8275,0,1803,94,"[11, 9, 29, 3, 15, 30, 9, 4, 3, 23, 26, 7, 25, 27, 15, 5, 14, 0, 1, 31, 27, 22, 15, 29, 18, 21, 31, 7, 17]"
30,17,1056,102,9229,0,483,573,"[105, 42, 87, 164, 16, 51, 52, 155, 11, 31, 141, 144, 150, 174, 2, 25, 48, 0, 113, 191, 14, 92, 117, 72, 184, 164, 191, 59, 36]"
31,17,1016,667,9578,0,892,124,"[39, 16, 35, 28, 13, 11, 14, 28, 13, 3, 34, 4, 19, 37, 36, 28, 26, 0, 26, 41, 41, 17, 22, 31, 4, 8, 41, 28, 1]"
32,17,1248,17,10000,809,1141,107,"[19, 12, 28, 23, 17, 6, 18, 9, 18, 26, 3, 22, 3, 30, 10, 21, 21, 0, 33, 35, 32, 3, 31, 14, 31, 33, 35, 22, 35]"
33,17,1346,5951,5395,0,209,1137,"[160, 2, 330, 339, 333, 46, 222, 307, 368, 163, 324, 235, 261, 339, 146, 101, 198, 0, 119, 379, 351, 313, 329, 269, 97, 1, 379, 264, 197]"
34,17,1669,432,6632,0,535,1134,"[336, 264, 91, 325, 39, 272, 101, 204, 236, 85, 232, 278, 314, 2, 173, 111, 105, 0, 44, 378, 229, 193, 260, 149, 109, 330, 378, 263, 172]"
35,17,2649,1414,7867,0,2561,88,"[28, 9, 11, 2, 18, 20, 18, 6, 16, 10, 9, 26, 5, 26, 25, 15, 17, 0, 6, 29, 13, 17, 28, 19, 0, 19, 29, 8, 16]"
36,17,1304,968,8203,0,780,524,"[150, 71, 134, 55, 57, 129, 51, 117, 29, 98, 140, 26, 69, 12, 57, 146, 63, 0, 140, 174, 104, 30, 82, 57, 163, 146, 174, 68, 165]"
37,17,2256,1976,8483,0,575,1681,"[203, 91, 539, 328, 395, 490, 79, 281, 447, 21, 435, 47, 50, 496, 414, 277, 4, 0, 31, 560, 424, 139, 340, 338, 431, 528, 560, 36, 229]"
38,17,1858,1289,9052,0,597,1261,"[82, 206, 390, 240, 300, 416, 69, 133, 417, 105, 280, 346, 413, 301, 21, 47, 122, 0, 47, 420, 206, 169, 385, 45, 239, 47, 420, 34, 415]"
39,17,2715,5676,6091,0,1985,730,"[173, 75, 159, 96, 180, 202, 27, 68, 223, 129, 96, 124, 211, 219, 137, 187, 78, 0, 33, 243, 143, 61, 79, 206, 171, 114, 243, 93, 115]"
40,17,1387,1053,6425,0,1246,141,"[24, 44, 37, 13, 21, 25, 29, 29, 33, 32, 33, 2, 16, 22, 15, 14, 34, 0, 27, 47, 22, 44, 44, 42, 44, 35, 47, 6, 33]"
41,17,2070,289,8206,0,1365,705,"[173, 183, 61, 13, 120, 38, 90, 71, 227, 59, 94, 190, 78, 201, 225, 197, 202, 0, 27, 235, 141, 25, 145, 199, 16, 149, 235, 92, 213]"
42,17,1093,337,8962,0,132,961,"[153, 309, 247, 236, 33, 201, 276, 229, 168, 102, 163, 124, 205, 288, 277, 4, 96, 0, 299, 320, 57, 212, 160, 253, 37, 183, 320, 96, 128]"
43,17,1292,1290,8964,0,777,515,"[131, 96, 52, 89, 90, 121, 53, 87, 145, 26, 17, 36, 3, 71, 170, 43, 139, 0, 144, 171, 23, 167, 68, 108, 10, 97, 171, 64, 11]"
44,17,1297,262,9999,0,1121,176,"[29, 14, 22, 13, 58, 55, 25, 7, 17, 47, 55, 43, 57, 1, 24, 5, 29, 0, 39, 58, 52, 6, 53, 56, 13, 54, 58, 14, 21]"
45,17,1565,7045,4519,0,380,1185,"[229, 97, 15, 154, 93, 95, 174, 134, 293, 74, 368, 6, 340, 110, 186, 133, 26, 0, 154, 395, 379, 326, 207, 7, 234, 205, 395, 48, 156]"
46,17,1712,1561,4670,0,268,1444,"[193, 18, 193, 194, 347, 14, 325, 259, 349, 241, 58, 97, 138, 67, 326, 336, 349, 0, 477, 481, 142, 401, 39, 228, 414, 76, 481, 154, 241]"
47,17,2474,700,6444,0,1315,1159,"[386, 208, 356, 262, 73, 347, 325, 219, 282, 319, 17, 264, 0, 140, 248, 148, 173, 0, 216, 386, 134, 104, 17, 266, 269, 341, 386, 2, 216]"
48,17,1013,48,7409,0,534,479,"[33, 112, 56, 13, 87, 104, 39, 16, 21, 143, 16, 139, 34, 134, 124, 72, 18, 0, 110, 159, 33, 100, 24, 21, 26, 125, 159, 107, 139]"
49,17,2345,1609,8145,0,1014,1331,"[391, 297, 244, 63, 237, 251, 371, 66, 284, 14, 20, 3, 335, 244, 186, 136, 256, 0, 75, 443, 103, 96, 174, 25, 23, 147, 443, 410, 196]"
50,17,1880,778,9247,0,870,1010,"[188, 190, 131, 115, 253, 105, 146, 136, 208, 48, 251, 77, 233, 290, 139, 288, 202, 0, 222, 336, 72, 36, 183, 283, 10, 8, 336, 335, 206]"
51,17,2407,5201,6453,0,538,1869,"[101, 129, 41, 391, 580, 381, 175, 472, 615, 32, 570, 385, 66, 249, 580, 152, 438, 0, 321, 623, 323, 459, 530, 335, 252, 120, 623, 182, 40]"
52,17,1229,1019,6663,0,1195,34,"[2, 6, 4, 10, 11, 6, 3, 8, 4, 7, 5, 10, 0, 3, 1, 3, 11, 0, 3, 11, 10, 11, 6, 1, 6, 7, 11, 10, 3]"
53,17,1550,625,7588,0,1503,47,"[6, 15, 1, 5, 11, 2, 3, 14, 15, 3, 0, 15, 2, 7, 9, 10, 13, 0, 9, 15, 14, 5, 5, 13, 7, 14, 15, 0, 15]"
54,17,1873,712,8749,0,1710,163,"[30, 5, 30, 29, 2, 50, 28, 22, 23, 9, 11, 53, 19, 44, 52, 43, 1, 0, 8, 54, 23, 25, 29, 42, 33, 26, 54, 2, 20]"
55,17,1340,467,9622,0,619,721,"[13, 14, 30, 158, 115, 52, 212, 196, 132, 43, 197, 76, 79, 195, 194, 93, 47, 0, 94, 240, 10, 48, 76, 218, 36, 236, 240, 38, 122]"
56,17,1006,28,10000,600,642,364,"[75, 80, 47, 118, 28, 113, 71, 71, 37, 54, 93, 121, 18, 68, 18, 25, 10, 0, 108, 121, 80, 112, 107, 52, 58, 121, 121, 107, 115]"
57,17,1187,6726,4461,0,38,1149,"[309, 86, 200, 383, 271, 50, 123, 267, 368, 117, 353, 293, 75, 67, 305, 78, 7, 0, 257, 383, 325, 267, 248, 79, 88, 219, 383, 83, 211]"
58,17,1699,246,5914,0,1457,242,"[9, 47, 69, 47, 58, 6, 21, 22, 68, 54, 66, 47, 48, 6, 63, 49, 8, 0, 70, 80, 54, 8, 50, 32, 64, 24, 80, 54, 7]"
59,17,1808,1442,6280,0,1461,347,"[61, 6, 33, 7, 49, 18, 5, 102, 90, 87, 113, 25, 68, 97, 48, 41, 78, 0, 28, 115, 44, 75, 69, 37, 80, 111, 115, 59, 56]"
60,17,2195,1265,7210,0,990,1205,"[209, 299, 214, 76, 205, 84, 237, 311, 143, 106, 161, 313, 70, 191, 320, 123, 355, 0, 256, 401, 332, 163, 396, 179, 80, 4, 401, 49, 86]"
61,17,1231,160,8281,0,1107,124,"[34, 10, 9, 27, 37, 4, 36, 28, 7, 31, 28, 29, 38, 21, 5, 29, 28, 0, 38, 41, 0, 17, 15, 34, 13, 29, 41, 19, 11]"
62,17,1295,756,8820,0,1091,204,"[65, 55, 32, 30, 64, 38, 12, 35, 4, 34, 36, 0, 25, 63, 8, 30, 60, 0, 36, 68, 22, 6, 8, 20, 43, 46, 68, 55, 36]"
63,17,2401,7166,4055,0,1878,523,"[33, 2, 41, 21, 119, 155, 5, 115, 140, 16, 79, 58, 86, 109, 0, 53, 99, 0, 85, 174, 88, 116, 55, 65, 32, 22, 174, 149, 9]"
64,17,2653,62,6646,0,2103,550,"[121, 4, 157, 106, 179, 158, 146, 172, 69, 64, 100, 58, 81, 105, 99, 67, 98, 0, 121, 183, 66, 14, 105, 26, 81, 46, 183, 14, 32]"
65,17,1325,1159,6812,0,1188,137,"[16, 41, 40, 36, 17, 10, 7, 14, 15, 17, 17, 15, 21, 15, 21, 44, 37, 0, 23, 45, 18, 7, 32, 7, 43, 22, 45, 18, 1]"
66,17,2561,1847,7526,0,2032,529,"[33, 110, 7, 104, 92, 71, 46, 85, 74, 101, 117, 160, 171, 53, 160, 79, 116, 0, 84, 176, 147, 85, 117, 119, 29, 10, 176, 49, 161]"
67,17,1744,1509,7761,0,582,1162,"[279, 316, 109, 7, 90, 172, 284, 125, 56, 335, 297, 98, 297, 297, 319, 93, 92, 0, 107, 387, 220, 119, 131, 145, 384, 233, 387, 33, 252]"
68,17,2611,843,9529,0,2103,508,"[41, 47, 7, 160, 29, 134, 133, 106, 12, 49, 101, 60, 108, 135, 71, 13, 94, 0, 78, 169, 115, 111, 91, 71, 40, 108, 169, 169, 59]"
69,17,2938,5488,6979,0,1259,1679,"[291, 431, 526, 377, 366, 239, 465, 536, 128, 256, 461, 219, 522, 483, 227, 536, 488, 0, 405, 559, 78, 82, 232, 508, 478, 516, 559, 181, 45]"
70,17,1621,1263,7337,0,860,761,"[59, 19, 197, 236, 90, 87, 90, 109, 194, 205, 0, 91, 11, 194, 223, 140, 186, 0, 33, 253, 92, 245, 51, 56, 99, 152, 253, 159, 188]"
71,17,2588,567,9358,0,832,1756,"[158, 236, 142, 183, 73, 56, 264, 173, 543, 576, 52, 388, 188, 110, 469, 361, 103, 0, 271, 585, 29, 354, 395, 5, 528, 435, 585, 305, 312]"
72,17,2978,7071,5265,0,1565,1413,"[390, 114, 36, 210, 79, 27, 30, 45, 230, 353, 137, 438, 283, 196, 467, 377, 463, 0, 192, 471, 461, 328, 62, 277, 230, 373, 471, 138, 258]"
73,17,1676,677,6264,0,189,1487,"[267, 455, 244, 74, 329, 294, 421, 106, 483, 246, 355, 406, 331, 357, 352, 381, 331, 0, 125, 495, 82, 51, 491, 215, 102, 230, 495, 427, 63]"
74,17,1738,1512,6490,0,1398,340,"[78, 56, 12, 49, 58, 80, 41, 72, 73, 91, 99, 61, 21, 6, 104, 50, 71, 0, 50, 113, 22, 28, 108, 107, 110, 49, 113, 96, 85]"
75,17,2219,1212,7497,0,1057,1162,"[267, 111, 385, 333, 130, 258, 361, 244, 66, 377, 383, 347, 135, 268, 284, 313, 324, 0, 131, 387, 104, 128, 162, 251, 201, 86, 387, 204, 180]"
76,17,2792,2568,7721,0,2575,217,"[12, 20, 45, 64, 46, 10, 16, 24, 17, 30, 1, 56, 49, 13, 47, 61, 41, 0, 5, 72, 69, 67, 63, 40, 36, 60, 72, 46, 58]"
77,17,1762,1633,7850,0,1747,15,"[0, 4, 5, 5, 2, 3, 4, 0, 4, 5, 4, 3, 0, 2, 2, 5, 2, 0, 2, 5, 0, 1, 1, 3, 0, 5, 5, 3, 1]"
78,17,1693,759,8784,0,1507,186,"[54, 9, 21, 37, 25, 15, 14, 1, 8, 7, 57, 8, 61, 22, 4, 60, 32, 0, 55, 62, 18, 27, 57, 21, 40, 14, 62, 52, 33]"
79,17,2502,6778,4508,0,666,1836,"[431, 104, 204, 497, 420, 548, 322, 399, 341, 345, 121, 55, 245, 526, 301, 248, 137, 0, 53, 612, 21, 299, 477, 477, 34, 263, 612, 563, 474]"
80,17,2547,354,6701,0,551,1996,"[292, 245, 638, 164, 346, 632, 482, 14, 258, 4, 21, 132, 231, 335, 639, 639, 407, 0, 269, 665, 96, 57, 435, 629, 352, 488, 665, 137, 391]"
81,17,2162,967,7896,0,1497,665,"[195, 113, 40, 32, 80, 194, 131, 212, 121, 4, 118, 180, 11, 181, 93, 139, 164, 0, 207, 221, 44, 207, 151, 42, 116, 212, 221, 19, 40]"
82,17,2290,432,9754,0,758,1532,"[61, 251, 187, 419, 286, 276, 54, 458, 238, 228, 270, 322, 420, 429, 404, 86, 321, 0, 66, 510, 462, 39, 122, 203, 391, 113, 510, 311, 315]"
83,17,1054,224,10000,584,218,836,"[172, 43, 131, 11, 99, 91, 270, 29, 161, 265, 14, 72, 110, 170, 223, 163, 78, 0, 172, 278, 145, 38, 163, 49, 241, 238, 278, 111, 163]"
84,17,2482,6820,5662,0,2454,28,"[6, 5, 9, 3, 1, 8, 6, 7, 0, 8, 1, 6, 6, 3, 0, 9, 4, 0, 8, 9, 2, 0, 5, 8, 6, 4, 9, 0, 5]"
85,17,1430,192,6900,0,1345,85,"[20, 27, 6, 12, 17, 11, 5, 9, 8, 11, 18, 18, 11, 5, 10, 1, 0, 0, 27, 28, 18, 17, 22, 24, 4, 11, 28, 24, 23]"
86,17,1897,1110,7687,0,1516,381,"[98, 125, 123, 6, 81, 7, 120, 125, 77, 87, 76, 61, 55, 39, 9, 126, 90, 0, 109, 127, 37, 59, 93, 7, 26, 83, 127, 80, 4]"
87,17,2254,737,9204,0,502,1752,"[185, 293, 285, 579, 331, 516, 367, 243, 42, 452, 228, 66, 549, 199, 179, 445, 148, 0, 407, 584, 172, 571, 286, 195, 322, 382, 584, 421, 81]"
88,17,1694,173,10000,725,1116,578,"[87, 179, 59, 165, 134, 38, 115, 116, 161, 98, 83, 43, 52, 127, 172, 104, 132, 0, 52, 192, 158, 122, 30, 57, 70, 178, 192, 90, 10]"
89,17,1500,5599,5901,0,1236,264,"[88, 33, 76, 56, 12, 16, 74, 6, 4, 38, 31, 30, 4, 39, 37, 22, 81, 0, 20, 88, 86, 87, 77, 70, 80, 46, 88, 45, 63]"
90,17,1343,699,6545,0,850,493,"[21, 66, 61, 97, 92, 28, 137, 93, 159, 34, 138, 157, 88, 18, 159, 121, 164, 0, 48, 164, 92, 155, 41, 148, 106, 37, 164, 161, 127]"
91,17,2953,310,9188,0,2853,100,"[27, 24, 0, 21, 20, 28, 10, 24, 9, 1, 17, 4, 8, 29, 12, 11, 10, 0, 12, 33, 30, 13, 18, 2, 4, 16, 33, 16, 0]"
92,17,2215,6019,5384,0,2017,198,"[14, 50, 23, 47, 23, 3, 46, 9, 40, 57, 58, 41, 55, 24, 38, 29, 32, 0, 9, 66, 30, 5, 33, 35, 57, 4, 66, 4, 35]"
93,17,1708,364,6728,0,1409,299,"[13, 58, 44, 44, 89, 72, 38, 89, 11, 88, 47, 54, 4, 9, 30, 40, 68, 0, 85, 99, 86, 77, 45, 47, 69, 71, 99, 61, 47]"
94,17,1369,549,7548,0,439,930,"[5, 293, 292, 5, 83, 121, 259, 240, 115, 287, 261, 54, 82, 79, 230, 66, 288, 0, 230, 310, 27, 121, 264, 289, 84, 36, 310, 175, 232]"
95,17,2851,1886,8513,0,2345,506,"[73, 129, 35, 157, 150, 48, 60, 65, 66, 152, 10, 125, 11, 108, 7, 124, 84, 0, 7, 168, 83, 16, 151, 100, 31, 152, 168, 120, 155]"
96,17,2927,5201,6239,0,2684,243,"[45, 51, 5, 23, 29, 77, 21, 46, 76, 4, 75, 62, 81, 47, 51, 19, 76, 0, 51, 81, 35, 71, 2, 16, 77, 42, 81, 72, 45]"
97,17,2735,1105,7869,0,832,1903,"[420, 612, 602, 240, 400, 405, 319, 472, 63, 458, 579, 234, 491, 276, 393, 442, 23, 0, 242, 634, 576, 138, 103, 160, 283, 207, 634, 533, 407]"
98,17,1725,1026,8568,0,57,1668,"[330, 108, 350, 209, 378, 311, 117, 255, 387, 61, 330, 194, 265, 177, 490, 189, 336, 0, 434, 556, 273, 528, 515, 349, 482, 249, 556, 199, 359]"
99,17,1306,743,9131,0,917,389,"[76, 36, 34, 1, 70, 40, 18, 11, 63, 10, 6, 4, 88, 119, 8, 23, 92, 0, 72, 129, 116, 122, 95, 71, 18, 129, 129, 18, 0]"
100,17,1683,682,10000,132,811,872,"[92, 202, 242, 72, 141, 91, 109, 91, 260, 131, 157, 275, 209, 134, 138, 4, 289, 0, 132, 290, 39, 177, 263, 275, 264, 211, 290, 11, 87]"
101,17,2475,5641,6834,0,1323,1152,"[125, 128, 11, 207, 224, 381, 170, 270, 32, 293, 85, 241, 195, 370, 146, 240, 207, 0, 120, 384, 330, 18, 115, 151, 331, 161, 384, 358, 228]"
102,17,2663,2312,7185,0,171,2492,"[313, 318, 692, 266, 734, 619, 479, 77, 435, 430, 780, 479, 350, 560, 677, 17, 824, 0, 556, 830, 42, 133, 441, 145, 372, 236, 830, 539, 186]"
103,17,2368,710,8843,0,1861,507,"[168, 65, 157, 23, 134, 159, 145, 29, 39, 75, 153, 158, 151, 122, 31, 111, 70, 0, 7, 169, 4, 20, 125, 34, 17, 1, 169, 162, 156]"
104,17,2383,6181,5045,0,2249,134,"[44, 35, 11, 25, 43, 12, 36, 3, 15, 3, 44, 11, 27, 26, 40, 2, 41, 0, 33, 44, 10, 13, 4, 15, 22, 17, 44, 11, 30]"
105,17,2910,650,7305,0,4,2906,"[727, 21, 947, 245, 242, 617, 757, 302, 645, 685, 898, 465, 262, 522, 649, 242, 190, 0, 883, 968, 193, 414, 563, 511, 224, 496, 968, 870, 618]"
106,17,2223,291,9237,0,699,1524,"[163, 246, 252, 188, 30, 290, 284, 20, 52, 468, 45, 170, 407, 253, 37, 478, 42, 0, 164, 508, 209, 431, 436, 347, 497, 292, 508, 120, 351]"
107,17,2313,5425,6125,0,1552,761,"[138, 229, 84, 74, 88, 215, 45, 227, 240, 68, 236, 202, 4, 78, 64, 73, 97, 0, 174, 253, 148, 22, 109, 124, 233, 41, 253, 245, 57]"
108,17,1227,752,6600,0,51,1176,"[239, 41, 263, 271, 37, 313, 327, 300, 94, 124, 289, 124, 244, 44, 392, 3, 85, 0, 58, 392, 50, 284, 328, 149, 217, 281, 392, 107, 48]"
109,17,1662,341,7921,0,1428,234,"[54, 47, 72, 60, 73, 76, 38, 65, 61, 37, 2, 42, 45, 23, 74, 11, 4, 0, 76, 78, 78, 47, 59, 56, 10, 58, 78, 55, 9]"
110,17,1743,1731,7933,0,989,754,"[121, 75, 236, 84, 68, 204, 18, 63, 85, 111, 117, 178, 221, 34, 64, 50, 177, 0, 190, 251, 98, 130, 178, 53, 27, 65, 251, 90, 212]"
111,17,2501,240,10000,194,47,2454,"[477, 291, 683, 520, 206, 140, 43, 228, 11, 710, 542, 784, 606, 621, 507, 51, 398, 0, 357, 818, 333, 724, 120, 799, 106, 56, 818, 19, 473]"
112,17,1322,5273,6049,0,401,921,"[12, 194, 245, 115, 177, 134, 171, 227, 157, 23, 289, 59, 123, 32, 285, 240, 130, 0, 168, 307, 263, 184, 124, 36, 192, 37, 307, 254, 66]"
113,17,2105,1576,6578,0,968,1137,"[157, 164, 138, 353, 251, 169, 224, 366, 80, 301, 88, 83, 173, 363, 63, 124, 260, 0, 283, 379, 205, 191, 264, 26, 375, 295, 379, 83, 280]"
114,17,1592,910,7260,0,733,859,"[71, 76, 31, 74, 3, 184, 272, 99, 239, 89, 205, 114, 173, 133, 155, 105, 48, 0, 231, 286, 115, 38, 265, 63, 79, 198, 286, 142, 35]"
115,17,2214,875,8599,0,1335,879,"[26, 157, 18, 8, 139, 3, 269, 234, 237, 95, 230, 273, 24, 11, 55, 203, 193, 0, 175, 293, 136, 68, 21, 21, 288, 94, 293, 14, 127]"
116,17,1530,113,10000,16,102,1428,"[164, 44, 225, 434, 180, 53, 73, 308, 280, 91, 400, 381, 464, 252, 425, 476, 17, 0, 266, 476, 400, 83, 122, 195, 130, 237, 476, 360, 340]"
117,17,1850,7054,4796,0,457,1393,"[372, 60, 440, 156, 141, 345, 85, 238, 152, 94, 103, 314, 447, 300, 368, 98, 294, 0, 294, 464, 265, 253, 358, 241, 80, 334, 464, 384, 420]"
118,17,2635,554,6877,0,906,1729,"[414, 270, 377, 157, 260, 490, 93, 68, 534, 560, 420, 165, 387, 233, 338, 281, 335, 0, 148, 576, 174, 262, 526, 66, 330, 477, 576, 527, 179]"
119,17,2463,1992,7348,0,2193,270,"[47, 72, 11, 40, 70, 80, 90, 24, 45, 85, 63, 15, 3, 84, 15, 87, 81, 0, 29, 90, 19, 63, 64, 38, 86, 23, 90, 36, 49]"
0,18,2574,0,2574,0,2043,531,"[102, 161, 42, 46, 25, 175, 149, 148, 54, 58, 177, 155, 98, 177, 75, 118, 0, 7, 0, 94, 21, 177, 28, 36, 101, 65, 102, 54, 144]"
1,18,1509,847,3236,0,747,762,"[95, 129, 114, 149, 107, 249, 140, 98, 237, 71, 193, 102, 174, 254, 172, 149, 232, 59, 0, 136, 137, 254, 215, 232, 141, 108, 7, 218, 145]"
2,18,2583,722,5097,0,2282,301,"[9, 68, 68, 92, 34, 35, 51, 8, 54, 37, 21, 62, 9, 100, 80, 42, 4, 77, 0, 96, 82, 100, 94, 8, 71, 97, 17, 51, 43]"
3,18,1075,1064,5108,0,469,606,"[5, 109, 193, 7, 8, 92, 43, 135, 96, 51, 179, 190, 193, 202, 41, 136, 171, 90, 0, 78, 187, 202, 71, 9, 39, 170, 193, 124, 127]"
4,18,2525,476,7157,0,461,2064,"[101, 165, 364, 429, 24, 325, 251, 225, 274, 292, 119, 444, 423, 688, 361, 616, 306, 621, 0, 188, 89, 688, 293, 586, 163, 254, 482, 259, 605]"
5,18,2629,309,9477,0,2193,436,"[73, 85, 9, 139, 62, 94, 40, 24, 39, 23, 133, 113, 133, 145, 92, 22, 145, 118, 0, 29, 87, 145, 122, 129, 81, 116, 74, 140, 29]"
6,18,1715,5839,5353,0,1567,148,"[33, 14, 26, 31, 15, 5, 24, 2, 18, 36, 40, 40, 22, 49, 46, 3, 17, 31, 0, 28, 14, 49, 19, 1, 15, 0, 14, 5, 42]"
7,18,2782,1820,6315,0,92,2690,"[133, 207, 465, 638, 412, 822, 332, 4, 339, 259, 519, 866, 579, 896, 88, 763, 448, 123, 0, 86, 405, 896, 199, 355, 633, 862, 814, 421, 600]"
8,18,1938,895,7358,0,1089,849,"[133, 126, 208, 101, 124, 11, 250, 280, 82, 254, 250, 208, 121, 283, 39, 77, 177, 262, 0, 277, 159, 283, 154, 272, 249, 182, 126, 7, 29]"
9,18,2198,1614,7942,0,42,2156,"[154, 477, 468, 405, 565, 662, 258, 237, 151, 292, 181, 446, 329, 718, 303, 160, 680, 388, 0, 263, 575, 718, 338, 634, 403, 365, 83, 529, 118]"
10,18,1811,1176,8577,0,7,1804,"[514, 313, 428, 568, 471, 361, 469, 237, 78, 462, 91, 512, 65, 601, 573, 471, 546, 288, 0, 497, 564, 601, 190, 588, 211, 86, 85, 345, 188]"
11,18,1184,518,9243,0,124,1060,"[8, 160, 188, 324, 314, 218, 5, 344, 257, 160, 38, 284, 333, 353, 302, 62, 123, 200, 0, 208, 80, 353, 297, 203, 115, 202, 346, 106, 241]"
12,18,1602,1279,9566,0,1010,592,"[70, 80, 141, 165, 79, 46, 163, 183, 37, 149, 89, 177, 57, 197, 192, 116, 188, 49, 0, 182, 141, 197, 169, 63, 163, 5, 167, 51, 70]"
13,18,2467,5025,7008,0,533,1934,"[190, 306, 253, 38, 361, 34, 545, 148, 517, 619, 43, 209, 483, 644, 514, 73, 312, 470, 0, 129, 67, 644, 283, 66, 189, 181, 119, 489, 265]"
14,18,2329,512,8825,0,134,2195,"[64, 511, 15, 690, 529, 602, 403, 558, 563, 317, 37, 258, 647, 731, 401, 426, 195, 654, 0, 325, 96, 731, 489, 117, 63, 725, 62, 283, 337]"
15,18,2467,6829,4463,0,1522,945,"[194, 79, 96, 171, 148, 33, 256, 86, 287, 130, 245, 162, 147, 315, 226, 228, 117, 21, 0, 238, 272, 315, 217, 67, 39, 158, 300, 16, 192]"
16,18,1858,1651,4670,0,1360,498,"[101, 165, 2, 24, 105, 22, 63, 22, 65, 87, 55, 69, 127, 166, 18, 113, 144, 117, 0, 166, 78, 166, 78, 55, 74, 106, 127, 29, 10]"
17,18,2184,1629,5225,0,1515,669,"[113, 93, 73, 127, 159, 171, 185, 140, 183, 176, 62, 122, 174, 223, 154, 81, 162, 142, 0, 132, 146, 223, 19, 203, 77, 140, 179, 208, 164]"
18,18,1840,1135,5930,0,1375,465,"[57, 2, 35, 129, 118, 77, 87, 46, 66, 11, 155, 91, 4, 155, 68, 84, 41, 85, 0, 130, 140, 155, 42, 42, 76, 89, 39, 76, 58]"
19,18,2059,175,7814,0,1546,513,"[96, 50, 126, 168, 63, 140, 37, 168, 55, 171, 149, 16, 143, 171, 121, 0, 132, 91, 0, 115, 46, 171, 71, 170, 28, 103, 9, 38, 56]"
20,18,1194,809,8199,0,238,956,"[311, 160, 47, 201, 215, 244, 235, 263, 169, 87, 186, 45, 273, 318, 88, 108, 228, 303, 0, 43, 14, 318, 27, 38, 81, 89, 270, 75, 212]"
21,18,2208,891,9516,0,1925,283,"[7, 36, 41, 51, 35, 69, 62, 86, 93, 24, 76, 8, 93, 94, 20, 83, 38, 43, 0, 64, 37, 94, 15, 75, 4, 14, 85, 94, 13]"
22,18,1788,6843,4461,0,1318,470,"[4, 96, 133, 56, 121, 50, 92, 135, 44, 8, 99, 49, 61, 156, 126, 88, 126, 68, 0, 58, 103, 156, 77, 63, 133, 136, 39, 33, 151]"
23,18,2203,1699,4965,0,729,1474,"[201, 264, 195, 171, 116, 96, 461, 310, 418, 150, 248, 297, 29, 491, 308, 112, 150, 333, 0, 341, 67, 491, 82, 328, 51, 69, 305, 252, 236]"
24,18,1599,817,5747,0,223,1376,"[184, 357, 368, 42, 235, 347, 399, 365, 441, 148, 142, 217, 271, 458, 277, 268, 216, 0, 0, 200, 324, 458, 239, 59, 241, 382, 402, 436, 141]"
25,18,2850,2610,5987,0,1212,1638,"[372, 255, 206, 91, 395, 481, 327, 518, 286, 231, 144, 281, 116, 546, 120, 369, 344, 355, 0, 73, 528, 546, 178, 160, 206, 432, 291, 543, 234]"
26,18,2875,1281,7581,0,962,1913,"[445, 245, 154, 106, 58, 145, 403, 495, 611, 458, 381, 594, 450, 637, 451, 235, 481, 272, 0, 268, 74, 637, 296, 413, 74, 361, 17, 435, 281]"
27,18,2057,1150,8488,0,201,1856,"[441, 341, 317, 259, 247, 104, 419, 31, 438, 586, 537, 167, 184, 618, 57, 291, 476, 528, 0, 334, 502, 618, 347, 216, 451, 530, 287, 565, 282]"
28,18,1069,971,8586,0,72,997,"[62, 282, 234, 152, 38, 311, 108, 207, 99, 50, 257, 130, 137, 332, 105, 304, 51, 22, 0, 172, 77, 332, 31, 109, 258, 107, 205, 27, 79]"
29,18,1596,589,9593,0,1306,290,"[89, 57, 74, 79, 7, 57, 79, 26, 54, 70, 57, 95, 23, 96, 40, 14, 9, 19, 0, 85, 79, 96, 75, 31, 3, 47, 21, 78, 5]"
30,18,2920,7384,5129,0,741,2179,"[62, 548, 381, 552, 359, 695, 696, 220, 685, 647, 626, 253, 698, 726, 560, 532, 53, 64, 0, 438, 334, 726, 113, 336, 571, 242, 384, 589, 79]"
31,18,2691,1114,6706,0,1224,1467,"[363, 473, 170, 117, 364, 272, 274, 439, 16, 385, 185, 453, 412, 489, 206, 304, 393, 225, 0, 429, 297, 489, 385, 237, 78, 228, 114, 433, 175]"
32,18,2596,1127,8175,0,2560,36,"[8, 11, 4, 0, 10, 0, 11, 2, 6, 6, 2, 0, 7, 12, 2, 3, 6, 10, 0, 2, 3, 12, 0, 12, 0, 5, 10, 1, 1]"
33,18,1372,1343,8204,0,179,1193,"[62, 377, 39, 172, 149, 89, 394, 233, 29, 171, 331, 307, 60, 397, 106, 172, 227, 207, 0, 131, 103, 397, 205, 87, 259, 13, 381, 150, 206]"
34,18,2891,6547,4548,0,2871,20,"[0, 1, 0, 3, 4, 6, 1, 5, 0, 3, 3, 3, 2, 6, 4, 4, 2, 1, 0, 6, 1, 6, 0, 2, 1, 2, 1, 2, 6]"
35,18,2650,1800,5398,0,2318,332,"[81, 102, 12, 39, 100, 13, 30, 32, 50, 39, 32, 26, 40, 110, 95, 73, 99, 65, 0, 40, 11, 110, 101, 54, 96, 53, 91, 29, 105]"
36,18,2923,339,7982,0,702,2221,"[609, 115, 356, 315, 268, 739, 7, 672, 237, 539, 341, 512, 565, 740, 600, 498, 491, 686, 0, 424, 251, 740, 172, 48, 383, 89, 326, 701, 325]"
37,18,2186,1129,9039,0,641,1545,"[9, 330, 347, 32, 514, 390, 385, 481, 373, 337, 154, 424, 149, 515, 346, 14, 57, 226, 0, 447, 365, 515, 75, 143, 403, 462, 5, 441, 287]"
38,18,1664,101,10000,602,129,1535,"[493, 346, 358, 46, 462, 134, 275, 314, 143, 431, 274, 479, 246, 511, 463, 410, 66, 245, 0, 367, 2, 511, 210, 71, 71, 410, 50, 113, 434]"
39,18,1136,5945,5191,0,756,380,"[93, 122, 45, 73, 67, 118, 109, 100, 62, 87, 15, 17, 78, 126, 104, 24, 8, 85, 0, 13, 20, 126, 28, 40, 109, 40, 122, 122, 19]"
40,18,2042,1779,5454,0,10,2032,"[390, 147, 230, 191, 118, 54, 503, 255, 58, 631, 265, 656, 467, 677, 402, 9, 64, 54, 0, 232, 89, 677, 493, 323, 250, 639, 209, 129, 370]"
41,18,1099,277,6276,0,734,365,"[37, 106, 46, 64, 0, 101, 20, 29, 93, 38, 72, 30, 2, 121, 99, 28, 108, 19, 0, 28, 12, 121, 98, 12, 103, 54, 40, 2, 5]"
42,18,2463,676,8063,0,1485,978,"[70, 261, 69, 227, 180, 209, 225, 167, 198, 225, 109, 86, 129, 326, 46, 318, 250, 39, 0, 315, 140, 326, 225, 287, 41, 325, 216, 294, 106]"
43,18,1314,205,9172,0,928,386,"[35, 11, 21, 62, 67, 64, 98, 51, 63, 15, 62, 77, 36, 128, 114, 47, 22, 37, 0, 108, 75, 128, 128, 8, 62, 34, 8, 8, 97]"
44,18,2252,5871,5553,0,810,1442,"[48, 405, 284, 102, 33, 344, 288, 425, 368, 282, 60, 251, 161, 480, 452, 12, 336, 75, 0, 71, 458, 480, 197, 163, 257, 136, 456, 345, 63]"
45,18,2609,1032,7130,0,2004,605,"[72, 156, 97, 51, 17, 15, 166, 66, 151, 60, 166, 39, 90, 201, 148, 166, 81, 3, 0, 194, 143, 201, 171, 164, 80, 57, 139, 61, 40]"
46,18,1124,190,8064,0,182,942,"[212, 119, 148, 241, 140, 98, 300, 156, 121, 281, 88, 285, 137, 314, 284, 10, 225, 26, 0, 172, 273, 314, 296, 14, 268, 72, 149, 15, 9]"
47,18,2988,5717,5335,0,919,2069,"[614, 683, 115, 37, 150, 76, 573, 305, 396, 177, 536, 216, 639, 689, 550, 424, 70, 199, 0, 434, 229, 689, 652, 631, 309, 584, 48, 629, 389]"
48,18,1257,556,6036,0,1167,90,"[6, 22, 13, 11, 8, 5, 8, 6, 11, 18, 10, 17, 27, 30, 2, 11, 18, 8, 0, 11, 25, 30, 18, 26, 24, 20, 3, 4, 14]"
49,18,2048,712,7372,0,1687,361,"[78, 49, 48, 110, 3, 36, 119, 102, 106, 45, 37, 52, 94, 120, 85, 101, 8, 50, 0, 9, 89, 120, 5, 25, 88, 104, 22, 29, 0]"
50,18,2455,907,8920,0,1960,495,"[125, 72, 132, 110, 93, 162, 96, 42, 109, 113, 147, 38, 99, 165, 24, 163, 122, 1, 0, 0, 51, 165, 88, 141, 79, 110, 92, 138, 71]"
51,18,1619,1273,9266,0,195,1424,"[458, 409, 311, 209, 384, 408, 341, 220, 385, 444, 114, 86, 377, 474, 6, 386, 321, 14, 0, 385, 173, 474, 87, 440, 27, 66, 69, 15, 415]"
52,18,1588,252,10000,602,5,1583,"[258, 186, 103, 377, 248, 144, 311, 407, 474, 286, 400, 320, 412, 527, 427, 127, 510, 361, 0, 297, 394, 527, 413, 479, 277, 265, 318, 195, 293]"
53,18,2140,5548,6592,0,1315,825,"[165, 237, 121, 41, 122, 156, 6, 158, 38, 19, 248, 83, 4, 275, 157, 143, 39, 120, 0, 33, 226, 275, 27, 72, 208, 205, 30, 143, 86]"
54,18,2111,1953,6750,0,1457,654,"[53, 92, 70, 70, 43, 162, 212, 54, 31, 49, 15, 211, 167, 218, 170, 29, 153, 197, 0, 7, 107, 218, 117, 46, 156, 173, 218, 216, 188]"
55,18,2885,1300,8335,0,1627,1258,"[372, 213, 14, 171, 349, 215, 290, 163, 13, 226, 27, 121, 22, 419, 202, 28, 366, 170, 0, 305, 185, 419, 187, 240, 104, 181, 325, 15, 73]"
56,18,1474,94,9715,0,1033,441,"[19, 61, 138, 25, 25, 145, 48, 7, 135, 64, 16, 108, 96, 147, 147, 50, 61, 78, 0, 33, 137, 147, 101, 114, 8, 2, 113, 19, 127]"
57,18,1847,6645,4917,0,183,1664,"[519, 425, 371, 491, 406, 418, 417, 405, 343, 436, 462, 444, 296, 554, 117, 325, 273, 137, 0, 13, 386, 554, 190, 27, 208, 75, 293, 289, 402]"
58,18,2736,1715,5938,0,2334,402,"[112, 120, 45, 121, 51, 67, 80, 31, 89, 99, 124, 31, 37, 134, 118, 18, 20, 33, 0, 88, 95, 134, 28, 86, 100, 34, 97, 72, 26]"
59,18,2988,2033,6893,0,1092,1896,"[497, 197, 594, 419, 382, 258, 38, 250, 83, 551, 82, 585, 135, 632, 436, 359, 253, 469, 0, 256, 315, 632, 298, 440, 443, 390, 576, 237, 62]"
60,18,2762,2256,7399,0,1555,1207,"[393, 379, 231, 98, 325, 344, 298, 57, 48, 303, 360, 218, 243, 402, 91, 98, 235, 224, 0, 189, 168, 402, 67, 70, 69, 288, 226, 50, 360]"
61,18,2000,956,8443,0,674,1326,"[23, 146, 240, 219, 289, 281, 16, 143, 67, 142, 194, 42, 105, 442, 59, 317, 250, 308, 0, 48, 41, 442, 29, 96, 201, 387, 228, 57, 81]"
62,18,2074,1453,9064,0,1993,81,"[3, 11, 20, 14, 13, 15, 19, 10, 9, 20, 15, 14, 26, 27, 16, 12, 0, 20, 0, 20, 23, 27, 7, 5, 16, 3, 22, 16, 1]"
63,18,1080,235,9909,0,411,669,"[25, 132, 104, 171, 127, 222, 140, 214, 108, 203, 175, 75, 119, 223, 183, 150, 133, 72, 0, 153, 163, 223, 171, 81, 95, 1, 178, 176, 177]"
64,18,2205,6933,5181,0,1707,498,"[41, 132, 160, 118, 21, 134, 74, 63, 125, 29, 101, 137, 95, 166, 1, 62, 93, 126, 0, 97, 10, 166, 0, 32, 72, 61, 6, 145, 70]"
65,18,1089,242,6028,0,842,247,"[47, 63, 14, 51, 9, 29, 3, 25, 12, 32, 63, 69, 79, 82, 26, 70, 73, 33, 0, 53, 21, 82, 36, 54, 49, 24, 45, 47, 18]"
66,18,2319,1322,7025,0,1515,804,"[198, 115, 186, 42, 27, 118, 226, 184, 4, 198, 187, 221, 258, 268, 115, 101, 101, 223, 0, 52, 48, 268, 36, 213, 54, 257, 198, 71, 72]"
67,18,2481,2238,7268,0,2067,414,"[58, 86, 110, 125, 80, 134, 87, 85, 4, 94, 32, 92, 14, 138, 53, 10, 113, 74, 0, 46, 31, 138, 31, 13, 124, 46, 33, 25, 121]"
68,18,2806,184,9890,0,350,2456,"[603, 637, 191, 704, 531, 191, 670, 548, 456, 738, 753, 59, 389, 818, 405, 599, 484, 582, 0, 200, 175, 818, 277, 273, 25, 530, 71, 293, 14]"
69,18,2663,5641,6912,0,714,1949,"[342, 183, 213, 40, 152, 71, 357, 106, 65, 0, 473, 561, 300, 649, 493, 85, 533, 555, 0, 341, 75, 649, 549, 389, 177, 187, 641, 390, 328]"
70,18,1564,129,8347,0,870,694,"[43, 94, 153, 146, 91, 5, 100, 161, 206, 181, 70, 162, 50, 231, 21, 98, 216, 42, 0, 97, 65, 231, 176, 44, 163, 52, 54, 215, 65]"
71,18,1953,1372,8928,0,1541,412,"[71, 5, 110, 54, 122, 43, 0, 66, 28, 8, 25, 19, 41, 137, 130, 14, 48, 18, 0, 19, 131, 137, 25, 127, 111, 29, 8, 106, 136]"
72,18,2435,5249,6114,0,1633,802,"[58, 98, 91, 11, 245, 196, 17, 141, 44, 19, 61, 186, 251, 267, 246, 134, 55, 30, 0, 59, 35, 267, 80, 184, 26, 84, 96, 189, 258]"
73,18,2397,566,7945,0,467,1930,"[277, 62, 36, 217, 113, 205, 153, 309, 556, 164, 37, 33, 230, 643, 257, 366, 150, 549, 0, 278, 402, 643, 145, 292, 335, 408, 27, 26, 89]"
74,18,1849,928,8866,0,929,920,"[271, 227, 172, 259, 13, 249, 30, 65, 229, 234, 82, 260, 89, 306, 123, 273, 269, 231, 0, 247, 304, 306, 22, 211, 2, 257, 67, 241, 264]"
75,18,2447,5991,5322,0,1850,597,"[101, 31, 85, 58, 3, 42, 135, 175, 49, 145, 125, 27, 162, 199, 41, 16, 36, 59, 0, 53, 167, 199, 180, 130, 124, 47, 87, 61, 2]"
76,18,2584,2219,5687,0,1435,1149,"[317, 371, 180, 109, 329, 372, 278, 189, 260, 331, 94, 17, 5, 383, 172, 50, 301, 83, 0, 60, 144, 383, 159, 90, 250, 290, 286, 91, 315]"
77,18,2726,127,8286,0,1884,842,"[235, 81, 160, 178, 259, 269, 238, 201, 37, 114, 81, 279, 211, 280, 221, 168, 13, 107, 0, 276, 92, 280, 22, 16, 183, 158, 278, 12, 265]"
78,18,1627,1189,8724,0,1625,2,"[0, 0, 0, 0, 0, 0, 0, 0, 0, 0, 0, 0, 0, 0, 0, 0, 0, 0, 0, 0, 0, 0, 0, 0, 0, 0, 0, 0, 0]"
79,18,1915,1066,9573,0,863,1052,"[84, 187, 25, 247, 338, 258, 24, 28, 262, 33, 339, 115, 221, 350, 329, 330, 281, 286, 0, 37, 68, 350, 186, 255, 201, 120, 325, 291, 305]"
80,18,2252,6258,5567,0,819,1433,"[348, 416, 74, 206, 15, 253, 379, 168, 451, 471, 82, 188, 178, 477, 304, 442, 82, 244, 0, 110, 425, 477, 289, 45, 188, 289, 330, 212, 62]"
81,18,1722,542,6747,0,696,1026,"[31, 67, 32, 94, 176, 66, 320, 236, 209, 131, 171, 311, 93, 342, 220, 165, 213, 109, 0, 228, 85, 342, 247, 331, 127, 264, 204, 316, 147]"
82,18,1061,333,7475,0,399,662,"[86, 18, 119, 191, 31, 144, 143, 205, 195, 214, 27, 53, 113, 220, 112, 143, 139, 55, 0, 114, 5, 220, 27, 84, 118, 0, 5, 97, 114]"
83,18,2327,1236,8566,0,540,1787,"[593, 483, 102, 355, 105, 338, 570, 7, 203, 503, 278, 511, 223, 595, 16, 478, 319, 436, 0, 582, 560, 595, 227, 178, 289, 316, 10, 422, 289]"
84,18,1859,1705,8720,0,977,882,"[169, 157, 162, 145, 76, 125, 7, 21, 280, 279, 168, 218, 165, 294, 122, 240, 132, 92, 0, 65, 224, 294, 221, 231, 154, 26, 243, 260, 49]"
85,18,1391,731,9380,0,358,1033,"[243, 114, 247, 160, 318, 287, 130, 292, 204, 62, 184, 275, 232, 344, 41, 155, 283, 285, 0, 13, 157, 344, 126, 238, 117, 16, 52, 17, 178]"
86,18,2308,6468,5220,0,648,1660,"[121, 434, 182, 552, 34, 247, 133, 428, 234, 144, 351, 51, 389, 553, 8, 436, 9, 534, 0, 328, 52, 553, 504, 390, 97, 517, 438, 429, 263]"
87,18,1273,559,5934,0,569,704,"[229, 131, 68, 144, 115, 43, 160, 216, 44, 195, 55, 216, 17, 234, 94, 90, 10, 218, 0, 19, 100, 234, 203, 76, 147, 89, 123, 100, 37]"
88,18,1119,942,6111,0,120,999,"[18, 288, 105, 154, 232, 305, 171, 14, 233, 25, 141, 285, 31, 333, 299, 56, 158, 206, 0, 233, 181, 333, 244, 249, 44, 86, 238, 311, 38]"
89,18,2936,770,8277,0,85,2851,"[103, 230, 242, 93, 910, 66, 643, 550, 915, 859, 443, 78, 923, 950, 576, 867, 485, 243, 0, 558, 135, 950, 5, 642, 242, 599, 881, 230, 187]"
90,18,2440,146,10000,571,2149,291,"[13, 88, 3, 45, 56, 91, 11, 13, 52, 87, 64, 44, 96, 97, 60, 9, 77, 76, 0, 7, 26, 97, 1, 78, 57, 38, 45, 43, 79]"
91,18,1935,5443,6492,0,1091,844,"[100, 85, 143, 119, 97, 195, 235, 281, 85, 237, 202, 108, 111, 281, 220, 233, 150, 186, 0, 13, 41, 281, 198, 262, 268, 99, 224, 227, 13]"
92,18,2549,52,8989,0,1596,953,"[108, 34, 83, 63, 2, 158, 315, 211, 60, 246, 26, 291, 293, 317, 181, 281, 282, 237, 0, 158, 181, 317, 46, 268, 287, 170, 90, 135, 169]"
93,18,2974,6989,4974,0,2155,819,"[229, 9, 152, 156, 204, 165, 58, 195, 230, 81, 5, 207, 162, 273, 207, 0, 3, 74, 0, 30, 258, 273, 13, 108, 163, 204, 214, 168, 238]"
94,18,1983,1021,5936,0,1686,297,"[50, 98, 51, 51, 13, 94, 70, 73, 15, 69, 31, 24, 4, 99, 97, 83, 86, 81, 0, 87, 40, 99, 40, 98, 7, 37, 41, 1, 29]"
95,18,1796,797,6935,0,1773,23,"[5, 4, 0, 6, 3, 4, 0, 3, 0, 0, 5, 4, 7, 7, 7, 1, 2, 0, 0, 0, 5, 7, 7, 7, 1, 4, 4, 7, 3]"
96,18,2398,1305,8028,0,64,2334,"[496, 251, 242, 112, 586, 545, 274, 109, 518, 693, 67, 165, 598, 778, 190, 492, 425, 252, 0, 92, 712, 778, 580, 678, 496, 366, 568, 113, 676]"
97,18,2691,2564,8155,0,188,2503,"[45, 552, 638, 225, 425, 671, 551, 71, 502, 631, 232, 337, 1, 834, 144, 246, 437, 568, 0, 590, 397, 834, 734, 693, 478, 169, 782, 370, 72]"
98,18,2288,153,10000,290,1529,759,"[154, 20, 102, 218, 232, 160, 228, 219, 232, 174, 203, 112, 149, 253, 174, 103, 144, 106, 0, 218, 66, 253, 38, 71, 205, 65, 129, 126, 252]"
99,18,2819,7025,5794,0,2562,257,"[20, 45, 11, 24, 80, 69, 79, 34, 29, 62, 35, 25, 29, 85, 10, 58, 2, 27, 0, 70, 24, 85, 29, 41, 10, 17, 36, 9, 6]"
100,18,2725,1290,7229,0,678,2047,"[428, 137, 678, 628, 208, 227, 12, 165, 646, 26, 144, 672, 327, 682, 48, 471, 533, 554, 0, 163, 522, 682, 19, 581, 242, 599, 495, 523, 255]"
101,18,1554,856,7927,0,1169,385,"[92, 46, 1, 110, 11, 72, 3, 107, 53, 77, 1, 79, 4, 128, 73, 115, 109, 52, 0, 40, 123, 128, 66, 32, 58, 117, 83, 53, 89]"
102,18,2947,1927,8947,0,1662,1285,"[59, 416, 395, 147, 278, 412, 122, 385, 376, 9, 200, 217, 395, 428, 73, 421, 351, 200, 0, 372, 170, 428, 48, 188, 390, 246, 401, 366, 382]"
103,18,2533,6402,5078,0,2334,199,"[31, 31, 1, 44, 42, 0, 39, 23, 2, 5, 4, 2, 31, 66, 27, 28, 11, 43, 0, 27, 56, 66, 39, 46, 11, 34, 21, 40, 43]"
104,18,1950,715,6313,0,303,1647,"[246, 319, 521, 374, 510, 172, 344, 228, 391, 477, 276, 131, 140, 549, 151, 473, 221, 469, 0, 538, 365, 549, 249, 326, 142, 505, 20, 372, 283]"
105,18,2793,1604,7502,0,1292,1501,"[343, 450, 0, 381, 311, 149, 139, 331, 24, 458, 14, 229, 70, 500, 295, 304, 219, 483, 0, 321, 124, 500, 324, 481, 491, 102, 490, 34, 471]"
106,18,1865,69,9298,0,69,1796,"[494, 261, 215, 576, 595, 481, 253, 276, 303, 410, 280, 510, 331, 598, 124, 175, 229, 174, 0, 244, 201, 598, 225, 412, 423, 524, 453, 329, 40]"
107,18,1737,7367,3668,0,989,748,"[117, 90, 226, 151, 159, 213, 158, 131, 195, 35, 139, 170, 219, 249, 55, 132, 91, 132, 0, 0, 157, 249, 63, 166, 55, 112, 233, 113, 55]"
108,18,1447,709,4406,0,690,757,"[167, 133, 163, 249, 62, 168, 64, 205, 34, 170, 216, 48, 199, 252, 125, 83, 119, 129, 0, 40, 65, 252, 91, 143, 2, 172, 97, 6, 50]"
109,18,2032,801,5637,0,514,1518,"[480, 301, 169, 496, 247, 380, 49, 457, 321, 70, 478, 240, 430, 506, 27, 414, 62, 43, 0, 35, 270, 506, 65, 318, 335, 263, 124, 199, 215]"
110,18,1025,612,6050,0,64,961,"[269, 280, 204, 235, 284, 7, 105, 0, 61, 214, 40, 315, 103, 320, 92, 156, 319, 27, 0, 175, 20, 320, 227, 16, 120, 270, 56, 139, 130]"
111,18,1440,717,6773,0,305,1135,"[193, 368, 158, 358, 232, 17, 233, 241, 198, 174, 84, 252, 62, 378, 354, 178, 76, 306, 0, 272, 25, 378, 351, 303, 110, 148, 61, 134, 340]"
112,18,1441,255,7959,0,50,1391,"[436, 276, 388, 402, 40, 89, 291, 357, 195, 450, 463, 38, 50, 463, 8, 371, 349, 228, 0, 303, 337, 463, 198, 424, 255, 294, 113, 161, 81]"
113,18,1427,144,9242,0,280,1147,"[11, 73, 270, 91, 60, 175, 162, 256, 245, 175, 326, 253, 203, 382, 295, 134, 271, 153, 0, 66, 202, 382, 255, 98, 277, 287, 80, 107, 239]"
114,18,2075,5218,6099,0,1716,359,"[75, 19, 73, 63, 93, 86, 74, 48, 84, 1, 33, 54, 38, 119, 113, 80, 116, 15, 0, 13, 82, 119, 87, 18, 100, 85, 86, 29, 32]"
115,18,2053,1340,6812,0,105,1948,"[329, 352, 519, 336, 284, 80, 105, 275, 451, 224, 95, 25, 596, 649, 148, 467, 602, 195, 0, 345, 470, 649, 289, 110, 195, 401, 361, 145, 479]"
116,18,1845,239,8418,0,615,1230,"[264, 261, 76, 347, 96, 237, 149, 5, 345, 109, 99, 196, 92, 410, 162, 308, 3, 381, 0, 45, 127, 410, 269, 211, 388, 322, 390, 7, 333]"
117,18,2469,1592,9295,0,2413,56,"[1, 11, 4, 17, 7, 16, 3, 18, 6, 9, 17, 10, 6, 18, 10, 10, 2, 15, 0, 2, 3, 18, 1, 11, 13, 12, 14, 17, 4]"
118,18,2571,6708,5158,0,1289,1282,"[373, 330, 40, 169, 398, 252, 64, 362, 398, 287, 54, 348, 160, 427, 256, 59, 202, 254, 0, 27, 323, 427, 85, 11, 376, 243, 332, 32, 60]"
119,18,1966,429,6695,0,626,1340,"[88, 367, 157, 163, 259, 8, 208, 217, 157, 420, 324, 86, 126, 446, 260, 159, 181, 170, 0, 51, 97, 446, 228, 353, 403, 259, 297, 43, 9]"
0,19,2244,0,2244,0,2122,122,"[35, 22, 14, 8, 4, 27, 26, 35, 39, 20, 30, 25, 2, 36, 33, 0, 16, 40, 19, 0, 33, 36, 3, 13, 37, 20, 40, 2, 23]"
1,19,2344,1445,3143,0,2244,100,"[9, 33, 29, 4, 14, 0, 32, 6, 1, 30, 1, 20, 13, 17, 4, 12, 6, 33, 6, 0, 5, 9, 25, 11, 1, 32, 33, 32, 11]"
2,19,1721,593,4271,0,1623,98,"[16, 28, 19, 1, 8, 21, 25, 21, 12, 15, 8, 3, 29, 4, 0, 7, 32, 32, 29, 0, 3, 32, 22, 25, 8, 5, 32, 1, 14]"
3,19,2675,290,6656,0,2669,6,"[1, 0, 1, 1, 0, 0, 1, 2, 1, 0, 1, 1, 2, 2, 1, 0, 0, 2, 0, 0, 2, 1, 0, 2, 1, 2, 2, 0, 0]"
4,19,2986,1645,7997,0,1677,1309,"[36, 17, 0, 374, 5, 196, 224, 293, 115, 228, 336, 223, 66, 197, 80, 305, 384, 436, 157, 0, 204, 45, 314, 422, 78, 54, 436, 43, 133]"
5,19,2395,1003,9389,0,1445,950,"[284, 64, 257, 27, 120, 242, 264, 155, 81, 51, 42, 207, 58, 51, 50, 158, 58, 316, 288, 0, 161, 280, 89, 178, 88, 148, 316, 76, 141]"
6,19,2719,5489,6619,0,646,2073,"[240, 563, 36, 651, 174, 482, 11, 17, 90, 350, 357, 108, 640, 467, 260, 269, 17, 691, 244, 0, 359, 586, 17, 143, 395, 241, 691, 111, 165]"
7,19,1339,842,7116,0,282,1057,"[267, 172, 96, 14, 59, 176, 113, 342, 113, 64, 169, 125, 324, 183, 60, 136, 273, 352, 312, 0, 347, 74, 128, 284, 103, 286, 352, 157, 253]"
8,19,1697,941,7872,0,1037,660,"[192, 2, 32, 70, 0, 206, 74, 58, 11, 94, 114, 175, 57, 115, 140, 112, 49, 220, 143, 0, 161, 10, 154, 60, 121, 18, 220, 116, 196]"
9,19,1395,443,8824,0,1279,116,"[14, 10, 31, 10, 2, 18, 12, 14, 5, 16, 21, 36, 24, 26, 30, 12, 18, 38, 13, 0, 32, 37, 20, 35, 31, 25, 38, 22, 25]"
10,19,1873,1130,9567,0,1245,628,"[85, 92, 143, 82, 28, 153, 113, 25, 42, 7, 194, 76, 117, 141, 39, 184, 70, 209, 113, 0, 201, 123, 15, 184, 184, 1, 209, 121, 148]"
11,19,1067,135,10000,499,1,1066,"[145, 307, 77, 166, 50, 317, 122, 182, 66, 343, 68, 14, 60, 286, 347, 189, 217, 355, 110, 0, 40, 316, 54, 134, 332, 149, 355, 149, 25]"
12,19,1372,6495,4877,0,1118,254,"[66, 50, 42, 33, 74, 3, 15, 19, 50, 18, 56, 42, 9, 1, 55, 54, 16, 84, 41, 0, 52, 22, 75, 38, 75, 75, 84, 81, 48]"
13,19,1773,377,6273,0,1565,208,"[9, 63, 60, 43, 15, 68, 1, 68, 18, 42, 8, 55, 52, 55, 50, 50, 7, 69, 41, 0, 12, 69, 5, 22, 63, 23, 69, 29, 19]"
14,19,1905,1100,7078,0,316,1589,"[15, 490, 56, 520, 328, 331, 207, 202, 110, 419, 12, 322, 505, 58, 269, 202, 25, 529, 357, 0, 235, 430, 422, 528, 263, 393, 529, 234, 139]"
15,19,1469,1385,7162,0,1211,258,"[51, 60, 80, 25, 9, 15, 51, 17, 72, 41, 33, 76, 58, 59, 83, 53, 82, 86, 39, 0, 23, 40, 12, 40, 72, 26, 86, 84, 11]"
16,19,2759,772,9149,0,1130,1629,"[455, 51, 87, 111, 51, 74, 41, 491, 236, 175, 543, 127, 395, 204, 263, 294, 500, 543, 75, 0, 413, 31, 155, 491, 118, 207, 543, 385, 523]"
17,19,1563,66,10000,646,1470,93,"[2, 8, 30, 22, 14, 11, 16, 10, 28, 23, 4, 4, 25, 18, 28, 30, 4, 31, 5, 0, 24, 6, 21, 2, 28, 3, 31, 24, 18]"
18,19,2154,6392,5762,0,1689,465,"[14, 103, 137, 125, 94, 7, 47, 126, 152, 142, 60, 57, 114, 119, 65, 117, 16, 155, 4, 0, 108, 74, 38, 39, 36, 110, 155, 58, 73]"
19,19,1379,540,6601,0,13,1366,"[100, 408, 113, 176, 357, 56, 279, 418, 4, 312, 321, 298, 291, 155, 129, 341, 254, 455, 98, 0, 67, 434, 200, 427, 151, 250, 455, 203, 394]"
20,19,2307,2071,6837,0,2178,129,"[9, 34, 26, 21, 22, 16, 40, 26, 13, 30, 31, 4, 33, 2, 6, 36, 14, 43, 2, 0, 2, 33, 39, 26, 39, 25, 43, 0, 1]"
21,19,2842,1225,8454,0,1817,1025,"[209, 170, 324, 71, 190, 218, 53, 11, 175, 49, 33, 89, 313, 47, 10, 335, 29, 341, 155, 0, 183, 136, 85, 257, 181, 295, 341, 155, 274]"
22,19,1954,1632,8776,0,883,1071,"[248, 291, 130, 208, 98, 179, 145, 191, 88, 248, 345, 57, 342, 351, 76, 263, 275, 357, 188, 0, 12, 126, 50, 167, 169, 306, 357, 294, 131]"
23,19,2981,7164,4593,0,1343,1638,"[517, 22, 258, 454, 505, 543, 196, 324, 497, 228, 134, 219, 289, 85, 477, 63, 348, 546, 16, 0, 287, 40, 141, 83, 491, 152, 546, 65, 500]"
24,19,1880,726,5747,0,317,1563,"[214, 475, 303, 309, 41, 75, 5, 5, 198, 302, 260, 269, 13, 452, 68, 367, 322, 521, 422, 0, 352, 364, 55, 184, 310, 176, 521, 257, 507]"
25,19,2986,915,7818,0,420,2566,"[397, 144, 756, 212, 95, 738, 587, 744, 575, 82, 301, 164, 713, 119, 387, 794, 478, 855, 406, 0, 416, 571, 139, 310, 637, 206, 855, 544, 135]"
26,19,2260,1371,8707,0,404,1856,"[94, 551, 408, 517, 508, 486, 157, 522, 46, 345, 53, 612, 32, 587, 266, 580, 472, 618, 274, 0, 370, 580, 380, 98, 296, 517, 618, 501, 30]"
27,19,2467,6369,4805,0,180,2287,"[531, 710, 618, 305, 198, 191, 685, 684, 701, 645, 44, 364, 164, 177, 492, 58, 603, 762, 296, 0, 174, 342, 436, 452, 75, 80, 762, 3, 187]"
28,19,1470,997,5278,0,304,1166,"[46, 268, 108, 243, 164, 135, 319, 368, 188, 348, 241, 365, 1, 20, 314, 95, 163, 388, 73, 0, 23, 194, 364, 101, 370, 206, 388, 250, 70]"
29,19,1207,783,5702,0,956,251,"[37, 47, 77, 75, 67, 73, 58, 64, 31, 17, 43, 55, 75, 46, 29, 26, 71, 83, 26, 0, 60, 31, 39, 70, 23, 1, 83, 76, 20]"
30,19,1388,315,6775,0,113,1275,"[337, 54, 288, 107, 131, 128, 422, 378, 254, 161, 62, 92, 146, 32, 288, 387, 328, 425, 219, 0, 51, 273, 114, 316, 174, 251, 425, 122, 282]"
31,19,1253,191,7837,0,59,1194,"[250, 181, 231, 60, 304, 57, 60, 216, 12, 123, 308, 159, 47, 72, 159, 279, 73, 398, 45, 0, 365, 133, 315, 90, 7, 49, 398, 128, 191]"
32,19,1436,1318,7955,0,526,910,"[142, 212, 107, 118, 175, 138, 239, 299, 86, 88, 299, 69, 163, 25, 298, 169, 179, 303, 152, 0, 264, 227, 161, 105, 60, 50, 303, 14, 133]"
33,19,2235,1109,9081,0,480,1755,"[269, 286, 527, 253, 157, 115, 501, 341, 149, 268, 192, 359, 67, 138, 539, 438, 496, 585, 230, 0, 83, 385, 276, 573, 247, 534, 585, 313, 1]"
34,19,2352,6602,4831,0,1909,443,"[30, 34, 71, 77, 77, 144, 51, 63, 133, 96, 4, 80, 102, 65, 9, 60, 76, 147, 102, 0, 104, 88, 7, 81, 31, 119, 147, 1, 144]"
35,19,2192,922,6101,0,1533,659,"[37, 34, 58, 30, 193, 113, 176, 179, 14, 194, 140, 162, 109, 214, 115, 31, 68, 219, 162, 0, 81, 79, 95, 198, 164, 207, 219, 149, 105]"
36,19,2847,1968,6980,0,114,2733,"[826, 396, 853, 203, 522, 215, 562, 59, 674, 806, 719, 346, 192, 811, 578, 717, 490, 911, 845, 0, 326, 231, 377, 903, 144, 535, 911, 489, 337]"
37,19,1461,1376,7065,0,594,867,"[42, 258, 163, 28, 170, 101, 60, 177, 268, 274, 54, 23, 248, 151, 241, 50, 269, 289, 245, 0, 29, 230, 276, 161, 279, 206, 289, 201, 167]"
38,19,1850,1627,7288,0,1823,27,"[2, 2, 3, 2, 6, 5, 5, 4, 1, 7, 5, 6, 3, 9, 9, 0, 9, 9, 4, 0, 2, 4, 5, 5, 6, 1, 9, 7, 1]"
39,19,2997,450,9835,0,1678,1319,"[194, 244, 276, 188, 126, 80, 436, 181, 381, 422, 231, 352, 404, 66, 76, 159, 409, 439, 54, 0, 119, 97, 236, 320, 398, 39, 439, 302, 178]"
40,19,2388,5721,6502,0,1017,1371,"[453, 115, 43, 288, 67, 73, 228, 66, 192, 101, 284, 22, 18, 63, 89, 328, 366, 457, 389, 0, 3, 80, 453, 21, 110, 450, 457, 383, 406]"
41,19,1891,400,7993,0,1336,555,"[46, 166, 2, 31, 102, 162, 74, 174, 174, 46, 115, 66, 5, 116, 44, 143, 123, 185, 176, 0, 34, 19, 132, 69, 82, 178, 185, 174, 90]"
42,19,1162,614,8541,0,287,875,"[126, 10, 272, 210, 161, 71, 187, 124, 237, 6, 120, 244, 253, 170, 175, 263, 168, 291, 49, 0, 140, 126, 88, 191, 150, 30, 291, 181, 111]"
43,19,2429,1389,9581,0,1792,637,"[159, 30, 103, 177, 19, 116, 168, 28, 66, 72, 67, 77, 95, 161, 78, 111, 182, 212, 103, 0, 114, 163, 203, 196, 19, 175, 212, 147, 113]"
44,19,2089,7163,4507,0,135,1954,"[651, 70, 500, 612, 113, 645, 289, 277, 382, 373, 574, 42, 90, 161, 203, 532, 266, 651, 255, 0, 637, 87, 299, 512, 599, 44, 651, 261, 419]"
45,19,2825,887,6445,0,2359,466,"[19, 70, 88, 0, 90, 132, 77, 33, 17, 111, 60, 93, 128, 106, 89, 100, 48, 155, 120, 0, 0, 22, 107, 99, 48, 21, 155, 117, 7]"
46,19,1226,633,7038,0,486,740,"[96, 188, 156, 15, 86, 76, 177, 206, 22, 227, 95, 52, 207, 46, 174, 124, 151, 246, 192, 0, 19, 79, 123, 180, 86, 34, 246, 202, 184]"
47,19,1955,1926,7067,0,1804,151,"[6, 11, 50, 32, 24, 24, 14, 6, 43, 38, 28, 31, 11, 3, 28, 45, 45, 50, 44, 0, 23, 43, 23, 18, 27, 39, 50, 8, 41]"
48,19,1361,674,7754,0,1235,126,"[0, 27, 12, 1, 21, 33, 30, 20, 39, 17, 24, 11, 10, 19, 27, 24, 32, 42, 40, 0, 15, 6, 5, 25, 6, 31, 42, 14, 40]"
49,19,1616,1391,7979,0,943,673,"[120, 134, 163, 23, 100, 213, 151, 28, 20, 11, 46, 20, 58, 205, 138, 217, 12, 224, 52, 0, 92, 4, 159, 87, 127, 171, 224, 209, 222]"
50,19,2458,2416,8021,0,881,1577,"[441, 265, 108, 488, 292, 446, 150, 325, 59, 501, 427, 364, 300, 332, 98, 163, 436, 525, 504, 0, 36, 212, 387, 327, 348, 290, 525, 49, 342]"
51,19,2257,267,10000,11,292,1965,"[127, 49, 535, 471, 256, 212, 452, 289, 163, 71, 598, 518, 230, 468, 355, 57, 240, 655, 141, 0, 623, 483, 477, 288, 654, 377, 655, 273, 86]"
52,19,2284,7402,4882,0,1815,469,"[25, 24, 124, 74, 13, 30, 22, 89, 147, 31, 62, 32, 101, 93, 129, 34, 11, 156, 39, 0, 115, 78, 85, 91, 37, 49, 156, 98, 59]"
53,19,2421,1506,5797,0,1948,473,"[27, 36, 119, 118, 10, 119, 43, 53, 107, 139, 82, 31, 24, 49, 115, 107, 68, 157, 100, 0, 79, 155, 58, 8, 79, 130, 157, 156, 70]"
54,19,2183,710,7270,0,2063,120,"[26, 16, 11, 29, 17, 7, 25, 36, 17, 7, 3, 20, 30, 36, 12, 5, 8, 40, 39, 0, 20, 21, 7, 34, 3, 0, 40, 27, 9]"
55,19,1321,1119,7472,0,1055,266,"[34, 25, 60, 64, 29, 22, 31, 34, 45, 60, 80, 17, 24, 29, 19, 18, 67, 88, 75, 0, 36, 86, 49, 83, 78, 44, 88, 11, 81]"
56,19,1426,988,7910,0,1299,127,"[40, 37, 21, 7, 40, 27, 24, 13, 15, 4, 29, 40, 19, 26, 24, 25, 17, 42, 18, 0, 30, 20, 8, 32, 31, 39, 42, 1, 21]"
57,19,1724,1169,8465,0,1394,330,"[62, 8, 97, 83, 110, 43, 64, 79, 37, 5, 82, 54, 15, 56, 15, 36, 63, 110, 85, 0, 104, 97, 96, 100, 7, 67, 110, 15, 7]"
58,19,1704,705,9464,0,1510,194,"[48, 43, 36, 30, 26, 3, 34, 38, 43, 60, 53, 13, 50, 57, 46, 24, 7, 64, 21, 0, 0, 64, 17, 30, 52, 0, 64, 16, 28]"
59,19,1251,765,9950,0,356,895,"[257, 54, 62, 62, 154, 182, 258, 121, 26, 288, 133, 6, 185, 288, 97, 289, 149, 298, 181, 0, 253, 69, 30, 274, 166, 105, 298, 289, 46]"
60,19,1599,6794,4755,0,1486,113,"[19, 6, 16, 34, 22, 17, 32, 25, 18, 12, 17, 35, 12, 21, 29, 10, 27, 37, 15, 0, 10, 31, 11, 13, 24, 19, 37, 18, 23]"
61,19,1805,1462,5098,0,1614,191,"[30, 60, 59, 15, 62, 42, 33, 16, 61, 56, 47, 44, 50, 46, 12, 47, 51, 63, 35, 0, 11, 0, 49, 8, 22, 30, 63, 48, 9]"
62,19,1960,1846,5212,0,1936,24,"[1, 8, 7, 7, 0, 1, 6, 7, 3, 7, 1, 1, 2, 6, 2, 7, 5, 8, 7, 0, 7, 1, 8, 3, 7, 3, 8, 6, 7]"
63,19,1419,145,6486,0,976,443,"[63, 128, 20, 101, 132, 57, 1, 107, 129, 24, 117, 98, 41, 4, 6, 108, 13, 147, 121, 0, 81, 75, 85, 102, 42, 118, 147, 141, 97]"
64,19,1643,1132,6997,0,392,1251,"[84, 121, 241, 175, 22, 127, 365, 122, 378, 365, 246, 208, 16, 114, 409, 66, 387, 417, 162, 0, 99, 359, 264, 202, 325, 100, 417, 83, 335]"
65,19,1173,250,7920,0,412,761,"[173, 28, 230, 236, 182, 52, 60, 33, 116, 65, 22, 53, 133, 63, 172, 60, 212, 253, 45, 0, 140, 114, 167, 207, 139, 183, 253, 173, 182]"
66,19,2446,1641,8725,0,1041,1405,"[151, 82, 44, 468, 56, 416, 210, 264, 275, 158, 56, 273, 73, 184, 38, 361, 253, 468, 109, 0, 292, 103, 5, 78, 228, 195, 468, 420, 315]"
67,19,1506,1411,8820,0,1016,490,"[56, 35, 13, 21, 30, 82, 146, 53, 112, 66, 58, 130, 113, 159, 17, 32, 68, 163, 116, 0, 58, 155, 120, 30, 127, 67, 163, 155, 76]"
68,19,1159,1035,8944,0,999,160,"[48, 53, 40, 23, 18, 41, 39, 30, 11, 20, 1, 37, 52, 12, 29, 27, 33, 53, 53, 0, 35, 4, 0, 39, 18, 2, 53, 23, 34]"
69,19,2736,5772,5908,0,2673,63,"[6, 21, 20, 6, 18, 15, 16, 15, 8, 12, 18, 8, 3, 4, 17, 2, 21, 21, 13, 0, 1, 9, 5, 15, 0, 7, 21, 6, 19]"
70,19,1425,1032,6301,0,97,1328,"[413, 111, 85, 151, 301, 115, 313, 279, 220, 239, 230, 133, 162, 248, 402, 378, 326, 442, 425, 0, 357, 68, 188, 160, 223, 336, 442, 11, 320]"
71,19,1684,636,7349,0,1435,249,"[74, 60, 46, 13, 55, 8, 7, 67, 40, 45, 30, 7, 15, 10, 80, 80, 47, 83, 80, 0, 65, 24, 42, 36, 64, 15, 83, 78, 52]"
72,19,1044,465,7928,0,493,551,"[51, 132, 135, 61, 156, 60, 182, 156, 84, 8, 172, 115, 141, 111, 103, 72, 39, 183, 134, 0, 139, 177, 10, 183, 143, 65, 183, 140, 22]"
73,19,1319,157,9090,0,784,535,"[128, 82, 20, 13, 162, 74, 51, 95, 159, 27, 16, 134, 170, 8, 100, 145, 152, 178, 111, 0, 80, 80, 4, 41, 101, 42, 178, 67, 155]"
74,19,1368,724,9734,0,935,433,"[54, 106, 44, 33, 30, 107, 102, 130, 18, 76, 61, 54, 80, 78, 136, 17, 9, 144, 44, 0, 137, 50, 14, 61, 116, 101, 144, 18, 126]"
75,19,2547,6120,6161,0,1059,1488,"[432, 104, 271, 140, 294, 395, 169, 359, 406, 381, 54, 336, 426, 263, 191, 26, 94, 496, 476, 0, 95, 481, 122, 182, 242, 345, 496, 205, 393]"
76,19,2998,973,8186,0,2514,484,"[8, 16, 153, 95, 47, 116, 49, 142, 10, 122, 108, 64, 87, 45, 50, 73, 133, 161, 54, 0, 57, 95, 56, 154, 41, 68, 161, 143, 52]"
77,19,2600,606,10000,180,1553,1047,"[333, 140, 128, 215, 260, 29, 238, 13, 269, 272, 244, 278, 14, 202, 235, 229, 44, 349, 278, 0, 284, 272, 341, 272, 312, 288, 349, 246, 215]"
78,19,2836,6147,6689,0,2665,171,"[4, 31, 45, 46, 39, 5, 50, 3, 29, 48, 4, 52, 45, 22, 21, 36, 46, 57, 49, 0, 19, 15, 22, 26, 55, 13, 57, 22, 15]"
79,19,2547,220,9016,0,1664,883,"[171, 218, 172, 79, 17, 205, 230, 183, 189, 217, 93, 204, 245, 150, 185, 156, 113, 294, 241, 0, 80, 11, 291, 104, 140, 260, 294, 260, 291]"
80,19,1582,622,9976,0,1011,571,"[97, 175, 148, 146, 107, 157, 41, 180, 164, 83, 59, 144, 88, 106, 118, 134, 0, 190, 29, 0, 100, 11, 162, 6, 122, 113, 190, 92, 86]"
81,19,2848,7165,5659,0,858,1990,"[626, 123, 516, 183, 147, 158, 83, 553, 411, 522, 63, 105, 128, 268, 108, 444, 273, 663, 360, 0, 632, 394, 435, 464, 163, 337, 663, 130, 207]"
82,19,1441,163,6937,0,1092,349,"[105, 6, 82, 59, 70, 52, 15, 109, 36, 6, 20, 113, 18, 20, 116, 1, 62, 116, 74, 0, 57, 61, 40, 8, 90, 44, 116, 76, 114]"
83,19,1316,718,7535,0,691,625,"[15, 54, 67, 185, 204, 208, 16, 107, 185, 162, 159, 7, 109, 129, 157, 164, 96, 208, 37, 0, 53, 77, 57, 5, 86, 121, 208, 38, 73]"
84,19,2313,2085,7763,0,959,1354,"[408, 415, 24, 199, 173, 347, 237, 179, 387, 84, 320, 16, 255, 414, 255, 341, 291, 451, 338, 0, 334, 262, 281, 63, 356, 170, 451, 353, 12]"
85,19,1762,97,9428,0,1110,652,"[70, 26, 97, 192, 92, 24, 146, 171, 170, 65, 197, 180, 96, 56, 95, 154, 130, 217, 124, 0, 111, 22, 81, 0, 191, 77, 217, 105, 185]"
86,19,1210,984,9654,0,686,524,"[106, 99, 115, 58, 60, 150, 131, 160, 89, 61, 116, 78, 153, 119, 56, 92, 131, 174, 23, 0, 124, 27, 26, 25, 8, 163, 174, 115, 42]"
87,19,2938,6631,5961,0,775,2163,"[279, 632, 1, 248, 469, 534, 720, 190, 117, 667, 69, 590, 227, 507, 313, 27, 257, 721, 307, 0, 353, 67, 588, 79, 103, 370, 721, 506, 556]"
88,19,1661,5,7617,0,246,1415,"[318, 60, 372, 47, 3, 357, 127, 18, 29, 414, 42, 463, 205, 253, 397, 410, 426, 471, 159, 0, 152, 439, 174, 375, 314, 125, 471, 88, 421]"
89,19,1496,489,8624,0,918,578,"[192, 100, 40, 97, 47, 47, 28, 156, 2, 27, 67, 116, 27, 86, 22, 144, 187, 192, 181, 0, 84, 140, 10, 137, 10, 106, 192, 174, 180]"
90,19,2700,6957,4367,0,116,2584,"[695, 506, 433, 204, 235, 73, 209, 654, 89, 674, 567, 640, 152, 142, 260, 451, 763, 861, 434, 0, 854, 768, 641, 552, 624, 318, 861, 502, 30]"
91,19,1906,1765,4508,0,946,960,"[198, 0, 107, 53, 193, 264, 231, 139, 71, 31, 145, 150, 302, 86, 294, 309, 259, 320, 241, 0, 266, 151, 120, 206, 259, 136, 320, 111, 198]"
92,19,1154,343,5319,0,1090,64,"[18, 18, 8, 9, 15, 1, 3, 17, 19, 20, 5, 6, 12, 17, 14, 0, 12, 21, 18, 0, 13, 9, 9, 2, 10, 10, 21, 15, 17]"
93,19,1175,217,6277,0,1130,45,"[2, 10, 9, 10, 7, 1, 13, 4, 11, 15, 10, 8, 15, 6, 15, 3, 14, 15, 0, 0, 0, 14, 9, 0, 1, 15, 15, 0, 12]"
94,19,1916,1441,6752,0,1350,566,"[45, 133, 42, 9, 30, 53, 141, 87, 156, 12, 97, 125, 178, 178, 153, 44, 23, 188, 67, 0, 172, 4, 168, 170, 150, 76, 188, 39, 179]"
95,19,1565,1336,6981,0,832,733,"[87, 62, 185, 158, 214, 27, 164, 111, 170, 85, 99, 102, 48, 62, 48, 181, 188, 244, 244, 0, 117, 238, 16, 21, 243, 66, 244, 116, 158]"
96,19,2330,1507,7804,0,226,2104,"[453, 339, 223, 541, 59, 587, 36, 637, 351, 62, 645, 7, 440, 457, 484, 448, 421, 701, 249, 0, 87, 426, 172, 16, 80, 359, 701, 626, 254]"
97,19,1024,18,8810,0,528,496,"[19, 106, 19, 131, 9, 56, 65, 107, 107, 5, 143, 91, 148, 4, 62, 164, 83, 165, 60, 0, 107, 149, 67, 90, 40, 117, 165, 149, 50]"
98,19,2712,5379,6143,0,1236,1476,"[136, 53, 48, 416, 70, 42, 109, 462, 453, 293, 364, 44, 32, 361, 468, 195, 202, 492, 38, 0, 378, 353, 7, 183, 410, 343, 492, 401, 206]"
99,19,1428,1040,6531,0,59,1369,"[77, 235, 449, 85, 382, 360, 52, 368, 288, 407, 291, 353, 64, 231, 452, 302, 176, 456, 226, 0, 75, 16, 262, 183, 119, 255, 456, 223, 188]"
100,19,1954,1246,7239,0,317,1637,"[115, 238, 325, 436, 102, 125, 27, 397, 458, 425, 231, 319, 11, 186, 384, 63, 429, 545, 441, 0, 304, 483, 345, 456, 194, 487, 545, 339, 177]"
101,19,1026,213,8052,0,100,926,"[19, 102, 97, 50, 70, 215, 84, 148, 2, 170, 270, 66, 234, 59, 302, 59, 107, 308, 157, 0, 135, 68, 61, 170, 281, 62, 308, 116, 251]"
102,19,2445,260,10000,237,2100,345,"[37, 23, 4, 110, 61, 107, 64, 64, 13, 41, 43, 109, 35, 71, 15, 48, 62, 115, 90, 0, 64, 97, 97, 93, 28, 0, 115, 48, 75]"
103,19,2192,5364,6828,0,1116,1076,"[224, 352, 120, 197, 197, 358, 229, 44, 238, 333, 47, 27, 114, 72, 341, 154, 70, 358, 168, 0, 257, 14, 25, 155, 115, 176, 358, 30, 204]"
104,19,2009,734,8103,0,1431,578,"[1, 163, 158, 27, 39, 40, 154, 17, 125, 89, 115, 16, 187, 28, 93, 40, 90, 192, 49, 0, 89, 177, 11, 177, 92, 19, 192, 111, 20]"
105,19,2280,99,10000,284,1556,724,"[102, 110, 69, 139, 226, 162, 176, 37, 126, 1, 176, 2, 34, 225, 220, 103, 221, 241, 202, 0, 189, 127, 238, 241, 70, 235, 241, 144, 11]"
106,19,1470,5101,6369,0,973,497,"[122, 56, 23, 129, 135, 3, 28, 53, 143, 52, 64, 54, 126, 118, 120, 112, 144, 165, 139, 0, 98, 103, 69, 38, 90, 72, 165, 134, 132]"
107,19,1108,349,7128,0,214,894,"[149, 107, 201, 290, 138, 209, 150, 261, 133, 176, 251, 27, 150, 54, 172, 270, 165, 298, 103, 0, 178, 119, 119, 121, 21, 211, 298, 239, 28]"
108,19,1301,374,8055,0,790,511,"[78, 34, 43, 157, 88, 93, 109, 2, 28, 25, 152, 74, 158, 109, 79, 160, 138, 170, 134, 0, 76, 1, 120, 115, 111, 121, 170, 2, 121]"
109,19,2930,2642,8343,0,2168,762,"[77, 152, 170, 90, 21, 136, 119, 4, 130, 75, 31, 86, 235, 155, 22, 19, 164, 254, 187, 0, 67, 206, 201, 254, 239, 181, 254, 23, 92]"
110,19,1472,801,9014,0,289,1183,"[237, 122, 345, 242, 354, 33, 41, 103, 366, 330, 368, 116, 33, 207, 60, 278, 218, 394, 22, 0, 226, 242, 87, 222, 136, 23, 394, 204, 21]"
111,19,1991,7340,3665,0,323,1668,"[124, 60, 26, 162, 450, 479, 59, 348, 515, 536, 34, 533, 128, 414, 367, 30, 402, 556, 548, 0, 49, 177, 111, 293, 130, 488, 556, 521, 139]"
112,19,1618,107,5176,0,1267,351,"[81, 98, 50, 82, 82, 25, 33, 113, 33, 30, 16, 26, 90, 101, 55, 42, 69, 117, 109, 0, 3, 36, 1, 19, 37, 53, 117, 81, 50]"
113,19,1027,206,5997,0,134,893,"[2, 250, 106, 289, 297, 239, 235, 119, 271, 192, 114, 169, 68, 176, 114, 4, 79, 297, 187, 0, 136, 268, 38, 260, 68, 176, 297, 154, 3]"
114,19,2453,846,7604,0,76,2377,"[247, 354, 722, 554, 431, 733, 17, 386, 264, 355, 659, 167, 598, 789, 158, 192, 153, 792, 2, 0, 591, 529, 287, 227, 758, 509, 792, 106, 429]"
115,19,1363,635,8332,0,835,528,"[144, 154, 129, 82, 108, 15, 63, 17, 106, 74, 48, 34, 103, 43, 171, 56, 159, 176, 21, 0, 129, 165, 97, 37, 26, 66, 176, 6, 49]"
116,19,2571,1667,9236,0,932,1639,"[12, 69, 44, 528, 542, 357, 21, 289, 466, 323, 323, 241, 411, 248, 88, 545, 273, 546, 369, 0, 201, 257, 491, 45, 347, 68, 546, 311, 279]"
117,19,1529,1138,9627,0,91,1438,"[391, 217, 268, 142, 12, 63, 96, 195, 258, 338, 262, 404, 125, 212, 415, 406, 72, 479, 332, 0, 329, 380, 337, 142, 50, 213, 479, 443, 431]"
118,19,1014,940,9701,0,640,374,"[5, 70, 72, 106, 91, 53, 114, 34, 36, 87, 30, 117, 93, 112, 106, 84, 61, 124, 75, 0, 50, 54, 52, 5, 56, 69, 124, 62, 53]"
119,19,2323,5463,6561,0,623,1700,"[407, 442, 386, 101, 61, 152, 142, 51, 303, 394, 1, 257, 248, 457, 64, 22, 330, 566, 540, 0, 14, 113, 19, 429, 53, 282, 566, 20, 476]"
0,20,5,0,5,0,3,2,"[0, 0, 0, 0, 0, 0, 0, 0, 0, 0, 0, 0, 0, 0, 0, 0, 0, 0, 0, 0, 0, 0, 0, 0, 0, 0, 0, 0, 0]"
1,20,22,11,16,0,18,4,"[0, 1, 1, 0, 1, 1, 0, 1, 0, 1, 1, 0, 1, 1, 1, 1, 1, 1, 0, 0, 0, 0, 1, 1, 0, 0, 0, 1, 0]"
2,20,86,34,68,0,56,30,"[0, 8, 9, 1, 4, 10, 7, 7, 4, 6, 5, 9, 3, 10, 5, 7, 10, 6, 0, 3, 0, 4, 7, 10, 10, 6, 8, 10, 6]"
3,20,7,4,71,0,5,2,"[0, 0, 0, 0, 0, 0, 0, 0, 0, 0, 0, 0, 0, 0, 0, 0, 0, 0, 0, 0, 0, 0, 0, 0, 0, 0, 0, 0, 0]"
4,20,14,0,85,0,8,6,"[2, 0, 2, 1, 2, 2, 1, 1, 0, 2, 1, 0, 1, 2, 2, 0, 2, 2, 0, 1, 0, 2, 2, 2, 2, 0, 1, 2, 1]"
5,20,7,5,87,0,3,4,"[1, 1, 1, 1, 1, 0, 1, 0, 0, 1, 0, 0, 1, 0, 0, 1, 1, 0, 1, 1, 0, 1, 1, 1, 1, 0, 0, 1, 1]"
6,20,6,4,89,0,3,3,"[0, 0, 1, 0, 0, 1, 1, 1, 0, 1, 0, 1, 0, 0, 1, 0, 1, 1, 0, 0, 0, 1, 1, 1, 0, 1, 0, 0, 1]"
7,20,52,20,121,0,45,7,"[1, 1, 1, 0, 2, 2, 0, 2, 2, 2, 2, 1, 1, 1, 0, 0, 2, 1, 1, 1, 0, 0, 0, 2, 1, 0, 2, 2, 0]"
8,20,59,15,165,0,52,7,"[0, 0, 1, 1, 0, 2, 2, 2, 2, 2, 2, 0, 2, 1, 1, 2, 2, 1, 1, 2, 0, 2, 2, 2, 2, 2, 1, 2, 2]"
9,20,85,33,217,0,44,41,"[4, 5, 7, 12, 5, 9, 5, 6, 3, 8, 5, 0, 13, 5, 10, 6, 13, 13, 13, 4, 0, 7, 0, 13, 1, 12, 9, 4, 11]"
10,20,25,14,228,0,4,21,"[7, 0, 0, 3, 5, 7, 7, 6, 4, 2, 3, 6, 1, 5, 6, 1, 7, 3, 2, 0, 0, 2, 3, 7, 1, 3, 3, 7, 0]"
11,20,80,52,256,0,67,13,"[2, 2, 0, 0, 2, 0, 2, 3, 2, 0, 3, 4, 2, 1, 1, 1, 4, 2, 4, 0, 0, 1, 2, 4, 2, 0, 0, 0, 4]"
12,20,64,13,307,0,29,35,"[8, 0, 3, 1, 6, 4, 9, 1, 11, 7, 2, 10, 10, 2, 11, 7, 11, 3, 4, 11, 0, 10, 6, 11, 7, 1, 8, 6, 0]"
13,20,6,3,310,0,3,3,"[1, 0, 1, 0, 0, 0, 0, 1, 1, 0, 1, 0, 1, 0, 1, 0, 1, 0, 0, 1, 0, 1, 0, 1, 1, 0, 1, 1, 1]"
14,20,13,1,322,0,0,13,"[0, 4, 4, 4, 3, 0, 0, 2, 4, 4, 2, 1, 3, 0, 3, 2, 4, 2, 2, 4, 0, 3, 2, 4, 0, 1, 2, 4, 3]"
15,20,75,53,344,0,75,0,"[0, 0, 0, 0, 0, 0, 0, 0, 0, 0, 0, 0, 0, 0, 0, 0, 0, 0, 0, 0, 0, 0, 0, 0, 0, 0, 0, 0, 0]"
16,20,98,38,404,0,6,92,"[29, 26, 3, 27, 13, 9, 9, 30, 6, 6, 16, 23, 1, 12, 18, 23, 30, 12, 2, 0, 0, 15, 3, 30, 5, 18, 27, 6, 8]"
17,20,75,35,444,0,18,57,"[3, 19, 0, 15, 13, 11, 14, 17, 4, 2, 11, 15, 19, 16, 4, 5, 19, 6, 8, 5, 0, 19, 19, 19, 2, 5, 15, 12, 19]"
18,20,51,30,465,0,24,27,"[5, 8, 2, 5, 5, 1, 8, 7, 7, 0, 9, 7, 7, 8, 9, 6, 9, 3, 3, 6, 0, 5, 2, 9, 4, 1, 4, 0, 8]"
19,20,45,44,466,0,6,39,"[0, 0, 11, 8, 2, 6, 7, 1, 2, 12, 3, 12, 11, 11, 6, 8, 13, 6, 7, 7, 0, 6, 0, 13, 7, 8, 1, 1, 8]"
20,20,42,42,466,0,16,26,"[7, 3, 1, 2, 4, 1, 0, 6, 4, 0, 0, 4, 3, 1, 4, 6, 8, 5, 4, 1, 0, 7, 0, 8, 6, 2, 2, 2, 7]"
21,20,82,63,485,0,52,30,"[3, 1, 5, 7, 7, 1, 10, 6, 1, 0, 8, 2, 1, 7, 5, 7, 10, 5, 4, 5, 0, 10, 5, 10, 5, 1, 5, 0, 9]"
22,20,49,4,530,0,23,26,"[6, 6, 5, 0, 0, 2, 0, 6, 4, 5, 8, 8, 0, 1, 2, 7, 8, 7, 6, 7, 0, 5, 0, 8, 0, 5, 8, 8, 8]"
23,20,65,36,559,0,44,21,"[3, 1, 1, 6, 6, 0, 7, 6, 2, 6, 6, 7, 4, 2, 0, 4, 7, 7, 5, 5, 0, 0, 3, 7, 3, 2, 5, 1, 2]"
24,20,45,26,578,0,6,39,"[12, 11, 6, 0, 4, 13, 10, 13, 11, 9, 12, 10, 12, 13, 4, 11, 13, 10, 7, 8, 0, 8, 4, 13, 12, 12, 7, 8, 0]"
25,20,7,2,583,0,1,6,"[2, 1, 2, 1, 2, 2, 0, 2, 1, 1, 1, 2, 0, 0, 2, 1, 2, 0, 1, 1, 0, 0, 2, 2, 0, 0, 1, 1, 2]"
26,20,49,17,615,0,25,24,"[3, 2, 3, 7, 8, 0, 1, 0, 3, 5, 2, 0, 8, 4, 4, 7, 8, 8, 8, 3, 0, 6, 0, 8, 3, 8, 4, 0, 6]"
27,20,96,61,650,0,47,49,"[0, 0, 5, 8, 1, 2, 14, 1, 16, 0, 14, 12, 7, 8, 4, 7, 16, 8, 7, 14, 0, 4, 6, 16, 7, 3, 13, 3, 12]"
28,20,3,3,650,0,2,1,"[0, 0, 0, 0, 0, 0, 0, 0, 0, 0, 0, 0, 0, 0, 0, 0, 0, 0, 0, 0, 0, 0, 0, 0, 0, 0, 0, 0, 0]"
29,20,96,52,694,0,83,13,"[0, 4, 1, 4, 3, 0, 2, 4, 3, 1, 1, 4, 1, 1, 2, 3, 4, 3, 0, 2, 0, 3, 4, 4, 1, 3, 0, 0, 3]"
30,20,1,0,651,0,0,1,"[0, 0, 0, 0, 0, 0, 0, 0, 0, 0, 0, 0, 0, 0, 0, 0, 0, 0, 0, 0, 0, 0, 0, 0, 0, 0, 0, 0, 0]"
31,20,13,12,652,0,8,5,"[0, 0, 1, 1, 0, 1, 0, 1, 1, 1, 0, 1, 1, 1, 1, 0, 1, 1, 1, 1, 0, 1, 1, 1, 1, 0, 1, 1, 0]"
32,20,75,18,709,0,71,4,"[0, 1, 1, 0, 1, 1, 0, 1, 0, 1, 1, 0, 0, 1, 0, 1, 1, 1, 1, 1, 0, 1, 1, 1, 0, 1, 1, 1, 1]"
33,20,10,1,718,0,6,4,"[0, 0, 1, 1, 0, 0, 0, 1, 0, 0, 1, 1, 1, 0, 1, 1, 1, 0, 0, 1, 0, 1, 0, 1, 0, 0, 0, 0, 1]"
34,20,77,44,751,0,7,70,"[2, 10, 12, 23, 6, 13, 18, 6, 12, 4, 3, 18, 9, 7, 12, 15, 23, 4, 13, 0, 0, 5, 7, 23, 21, 7, 10, 16, 18]"
35,20,3,3,751,0,0,3,"[0, 1, 1, 1, 1, 1, 1, 0, 1, 1, 1, 1, 1, 0, 0, 0, 1, 1, 1, 0, 0, 1, 0, 1, 1, 0, 0, 1, 1]"
36,20,89,16,824,0,60,29,"[8, 9, 0, 8, 7, 1, 5, 8, 7, 0, 2, 2, 7, 4, 5, 2, 9, 8, 8, 1, 0, 4, 0, 9, 0, 0, 7, 0, 0]"
37,20,100,40,884,0,2,98,"[17, 30, 23, 7, 32, 14, 21, 24, 20, 27, 30, 21, 7, 20, 25, 13, 32, 6, 27, 2, 0, 17, 9, 32, 0, 19, 13, 29, 11]"
38,20,71,67,888,0,27,44,"[10, 8, 13, 9, 1, 11, 6, 4, 9, 6, 1, 0, 5, 5, 10, 9, 14, 14, 2, 13, 0, 11, 0, 14, 8, 8, 12, 5, 14]"
39,20,99,79,908,0,40,59,"[16, 18, 1, 7, 13, 8, 13, 15, 11, 13, 17, 1, 11, 0, 13, 15, 19, 14, 9, 13, 0, 18, 6, 19, 16, 9, 7, 3, 6]"
40,20,44,43,909,0,28,16,"[4, 1, 3, 5, 1, 0, 4, 2, 3, 4, 5, 5, 3, 3, 0, 3, 5, 4, 0, 4, 0, 3, 0, 5, 5, 1, 2, 2, 4]"
41,20,21,12,918,0,12,9,"[1, 3, 2, 2, 3, 1, 2, 1, 2, 1, 0, 3, 1, 0, 0, 0, 3, 2, 2, 0, 0, 1, 1, 3, 3, 0, 3, 1, 3]"
42,20,89,79,928,0,4,85,"[26, 6, 15, 7, 6, 5, 27, 26, 6, 24, 15, 22, 20, 21, 8, 10, 28, 18, 23, 28, 0, 13, 15, 28, 2, 0, 22, 3, 10]"
43,20,15,0,943,0,4,11,"[3, 1, 1, 0, 3, 1, 1, 3, 1, 0, 2, 3, 3, 0, 3, 2, 3, 3, 0, 3, 0, 0, 2, 3, 0, 2, 3, 0, 0]"
44,20,31,31,943,0,9,22,"[3, 4, 1, 0, 0, 6, 4, 3, 6, 5, 6, 5, 3, 6, 4, 3, 7, 4, 1, 0, 0, 6, 7, 7, 4, 1, 1, 3, 4]"
45,20,87,35,995,0,4,83,"[15, 3, 25, 14, 7, 4, 11, 14, 23, 1, 6, 22, 19, 18, 2, 0, 27, 13, 6, 10, 0, 7, 10, 27, 16, 14, 14, 12, 27]"
46,20,20,19,996,0,15,5,"[0, 0, 0, 0, 0, 1, 1, 1, 0, 1, 0, 1, 1, 0, 0, 0, 1, 0, 1, 0, 0, 0, 1, 1, 1, 1, 0, 1, 1]"
47,20,49,34,1011,0,10,39,"[11, 12, 13, 10, 13, 9, 4, 12, 12, 9, 7, 6, 6, 12, 10, 6, 13, 5, 8, 8, 0, 13, 7, 13, 1, 11, 12, 6, 10]"
48,20,78,58,1031,0,38,40,"[6, 3, 5, 9, 9, 6, 3, 6, 10, 2, 5, 7, 8, 7, 6, 5, 13, 2, 3, 2, 0, 13, 7, 13, 1, 10, 4, 9, 12]"
49,20,32,22,1041,0,32,0,"[0, 0, 0, 0, 0, 0, 0, 0, 0, 0, 0, 0, 0, 0, 0, 0, 0, 0, 0, 0, 0, 0, 0, 0, 0, 0, 0, 0, 0]"
50,20,58,42,1057,0,7,51,"[9, 4, 5, 3, 10, 5, 8, 13, 12, 3, 11, 11, 16, 6, 11, 14, 17, 16, 14, 9, 0, 1, 7, 17, 16, 11, 1, 14, 9]"
51,20,78,35,1100,0,72,6,"[1, 0, 1, 1, 1, 2, 1, 0, 1, 0, 2, 0, 2, 2, 2, 2, 2, 2, 1, 1, 0, 0, 2, 2, 0, 1, 0, 2, 1]"
52,20,12,1,1111,0,0,12,"[0, 3, 1, 3, 4, 1, 4, 0, 0, 4, 4, 3, 4, 1, 4, 4, 4, 2, 3, 2, 0, 1, 1, 4, 2, 2, 1, 2, 4]"
53,20,74,27,1158,0,26,48,"[7, 9, 6, 9, 3, 10, 9, 5, 5, 13, 0, 1, 3, 5, 1, 9, 16, 3, 6, 1, 0, 16, 5, 16, 0, 6, 0, 11, 12]"
54,20,21,10,1169,0,1,20,"[6, 4, 4, 0, 6, 6, 0, 3, 6, 2, 0, 2, 5, 5, 2, 4, 6, 5, 1, 5, 0, 5, 5, 6, 1, 4, 4, 6, 4]"
55,20,40,32,1177,0,26,14,"[4, 4, 3, 3, 3, 1, 2, 3, 0, 3, 4, 1, 3, 1, 3, 1, 4, 1, 2, 4, 0, 2, 0, 4, 0, 3, 1, 2, 2]"
56,20,96,1,1272,0,30,66,"[17, 2, 11, 6, 15, 4, 13, 22, 2, 17, 3, 19, 4, 4, 1, 14, 22, 2, 20, 14, 0, 14, 15, 22, 19, 3, 4, 13, 8]"
57,20,89,18,1343,0,69,20,"[5, 6, 4, 2, 5, 1, 0, 2, 5, 3, 0, 0, 6, 2, 0, 6, 6, 0, 1, 2, 0, 6, 3, 6, 2, 3, 3, 2, 2]"
58,20,18,0,1361,0,12,6,"[1, 1, 2, 2, 2, 0, 0, 1, 1, 0, 0, 0, 1, 1, 1, 0, 2, 1, 1, 0, 0, 0, 0, 2, 1, 0, 2, 1, 1]"
59,20,26,17,1370,0,4,22,"[4, 0, 7, 4, 5, 7, 3, 2, 2, 3, 6, 1, 7, 0, 2, 1, 7, 3, 1, 6, 0, 0, 3, 7, 4, 7, 6, 4, 2]"
60,20,26,10,1386,0,10,16,"[5, 4, 0, 0, 1, 5, 5, 0, 0, 2, 2, 1, 4, 4, 4, 5, 5, 0, 2, 4, 0, 2, 1, 5, 3, 0, 5, 2, 2]"
61,20,36,11,1411,0,3,33,"[3, 7, 3, 8, 7, 6, 4, 4, 3, 9, 10, 1, 7, 10, 7, 1, 11, 2, 1, 5, 0, 9, 9, 11, 10, 9, 9, 7, 6]"
62,20,68,2,1477,0,57,11,"[1, 3, 3, 3, 2, 2, 1, 2, 2, 1, 2, 3, 1, 3, 2, 3, 3, 3, 1, 2, 0, 0, 0, 3, 0, 3, 1, 0, 2]"
63,20,73,18,1532,0,14,59,"[7, 0, 12, 3, 7, 10, 4, 10, 10, 14, 3, 14, 16, 8, 18, 16, 19, 11, 3, 7, 0, 3, 11, 19, 3, 16, 5, 10, 9]"
64,20,75,53,1554,0,29,46,"[14, 3, 4, 7, 13, 7, 14, 2, 14, 11, 0, 1, 13, 5, 5, 12, 15, 8, 0, 5, 0, 6, 10, 15, 2, 10, 0, 8, 14]"
65,20,100,47,1607,0,33,67,"[16, 15, 20, 22, 19, 18, 15, 8, 4, 22, 5, 11, 3, 0, 12, 18, 22, 20, 16, 20, 0, 13, 3, 22, 21, 6, 1, 6, 15]"
66,20,45,13,1639,0,24,21,"[0, 4, 5, 6, 1, 5, 2, 6, 5, 6, 1, 1, 3, 3, 2, 2, 7, 7, 1, 5, 0, 6, 7, 7, 0, 7, 1, 6, 1]"
67,20,2,2,1639,0,0,2,"[0, 0, 0, 0, 0, 0, 0, 0, 0, 0, 0, 0, 0, 0, 0, 0, 0, 0, 0, 0, 0, 0, 0, 0, 0, 0, 0, 0, 0]"
68,20,77,31,1685,0,20,57,"[4, 6, 18, 9, 6, 7, 12, 11, 3, 5, 6, 8, 9, 9, 17, 8, 19, 5, 6, 18, 0, 10, 13, 19, 6, 13, 18, 13, 18]"
69,20,72,72,1685,0,50,22,"[3, 6, 3, 3, 2, 0, 1, 7, 5, 7, 4, 5, 5, 5, 0, 5, 7, 1, 6, 7, 0, 5, 3, 7, 2, 2, 5, 5, 4]"
70,20,66,16,1735,0,57,9,"[1, 2, 1, 1, 3, 1, 3, 3, 2, 0, 0, 3, 1, 0, 3, 0, 3, 2, 1, 2, 0, 0, 1, 3, 1, 0, 1, 1, 2]"
71,20,4,3,1736,0,0,4,"[0, 1, 0, 0, 1, 0, 1, 0, 0, 0, 1, 1, 1, 0, 0, 1, 1, 0, 0, 1, 0, 1, 1, 1, 1, 1, 1, 0, 1]"
72,20,96,40,1792,0,7,89,"[29, 3, 28, 0, 6, 2, 26, 24, 11, 6, 2, 20, 25, 2, 23, 15, 29, 13, 27, 23, 0, 15, 7, 29, 27, 9, 0, 29, 28]"
73,20,100,86,1806,0,94,6,"[0, 2, 1, 1, 1, 2, 0, 1, 2, 0, 0, 2, 0, 2, 2, 2, 2, 1, 2, 0, 0, 1, 1, 2, 0, 0, 1, 1, 1]"
74,20,99,91,1814,0,31,68,"[10, 10, 10, 5, 4, 16, 1, 0, 17, 15, 22, 22, 2, 13, 1, 20, 22, 19, 11, 1, 0, 13, 14, 22, 7, 14, 5, 20, 18]"
75,20,63,31,1846,0,3,60,"[20, 20, 14, 17, 10, 7, 6, 18, 0, 1, 13, 0, 16, 7, 15, 3, 20, 8, 14, 18, 0, 1, 14, 20, 16, 5, 2, 8, 12]"
76,20,77,76,1847,0,20,57,"[18, 16, 5, 14, 17, 0, 5, 18, 15, 10, 7, 9, 13, 17, 14, 12, 19, 3, 7, 3, 0, 7, 2, 19, 4, 19, 2, 9, 8]"
77,20,85,26,1906,0,68,17,"[2, 1, 0, 0, 1, 0, 4, 1, 1, 5, 4, 1, 0, 2, 4, 0, 5, 2, 5, 4, 0, 4, 5, 5, 3, 3, 3, 0, 3]"
78,20,30,16,1920,0,2,28,"[0, 0, 0, 6, 0, 8, 0, 8, 2, 9, 9, 6, 6, 1, 0, 7, 9, 4, 8, 9, 0, 5, 6, 9, 7, 1, 6, 7, 8]"
79,20,37,31,1926,0,16,21,"[3, 5, 2, 4, 5, 0, 4, 1, 2, 5, 0, 6, 4, 2, 0, 2, 7, 2, 7, 0, 0, 0, 3, 7, 4, 0, 0, 4, 2]"
80,20,22,2,1946,0,10,12,"[2, 4, 1, 3, 2, 4, 1, 4, 1, 1, 3, 1, 3, 0, 4, 4, 4, 3, 4, 0, 0, 4, 4, 4, 1, 2, 2, 2, 4]"
81,20,1,0,1927,0,0,1,"[0, 0, 0, 0, 0, 0, 0, 0, 0, 0, 0, 0, 0, 0, 0, 0, 0, 0, 0, 0, 0, 0, 0, 0, 0, 0, 0, 0, 0]"
82,20,68,26,1969,0,33,35,"[8, 1, 11, 4, 1, 0, 6, 10, 0, 9, 7, 5, 2, 8, 4, 3, 11, 6, 1, 9, 0, 0, 11, 11, 3, 3, 2, 8, 1]"
83,20,39,37,1971,0,39,0,"[0, 0, 0, 0, 0, 0, 0, 0, 0, 0, 0, 0, 0, 0, 0, 0, 0, 0, 0, 0, 0, 0, 0, 0, 0, 0, 0, 0, 0]"
84,20,83,13,2041,0,21,62,"[7, 2, 5, 13, 2, 15, 17, 5, 9, 9, 0, 4, 17, 10, 1, 5, 20, 5, 9, 4, 0, 17, 4, 20, 5, 16, 9, 11, 7]"
85,20,67,55,2053,0,26,41,"[9, 1, 9, 7, 13, 13, 7, 5, 8, 0, 6, 10, 4, 2, 3, 2, 13, 5, 0, 1, 0, 6, 10, 13, 9, 3, 7, 7, 11]"
86,20,44,3,2094,0,35,9,"[3, 0, 0, 0, 2, 3, 1, 3, 3, 2, 3, 1, 2, 3, 0, 2, 3, 3, 1, 0, 0, 1, 0, 3, 3, 0, 0, 1, 0]"
87,20,25,14,2105,0,5,20,"[2, 6, 6, 4, 2, 5, 2, 6, 3, 0, 0, 5, 0, 0, 4, 1, 6, 2, 6, 6, 0, 0, 5, 6, 1, 2, 0, 0, 0]"
88,20,2,2,2105,0,0,2,"[0, 0, 0, 0, 0, 0, 0, 0, 0, 0, 0, 0, 0, 0, 0, 0, 0, 0, 0, 0, 0, 0, 0, 0, 0, 0, 0, 0, 0]"
89,20,63,20,2148,0,58,5,"[1, 1, 0, 0, 0, 1, 0, 0, 0, 0, 0, 1, 0, 1, 0, 0, 1, 1, 1, 1, 0, 0, 1, 1, 0, 0, 0, 1, 1]"
90,20,50,37,2161,0,22,28,"[4, 0, 8, 2, 5, 7, 7, 6, 0, 0, 0, 8, 1, 7, 1, 0, 9, 2, 6, 6, 0, 2, 7, 9, 1, 0, 0, 1, 6]"
91,20,66,53,2174,0,57,9,"[3, 2, 1, 0, 0, 2, 2, 1, 2, 3, 2, 0, 1, 3, 0, 0, 3, 1, 2, 3, 0, 3, 3, 3, 2, 3, 1, 1, 3]"
92,20,58,13,2219,0,8,50,"[11, 9, 6, 11, 15, 15, 11, 3, 16, 11, 9, 0, 16, 9, 10, 3, 16, 15, 15, 16, 0, 9, 5, 16, 2, 7, 11, 10, 15]"
93,20,44,31,2232,0,28,16,"[3, 5, 5, 1, 3, 5, 3, 1, 3, 0, 3, 0, 0, 3, 0, 2, 5, 2, 5, 5, 0, 5, 4, 5, 5, 4, 4, 4, 4]"
94,20,76,74,2234,0,47,29,"[9, 3, 2, 3, 9, 1, 6, 6, 4, 4, 8, 6, 4, 5, 1, 4, 9, 3, 5, 0, 0, 9, 0, 9, 1, 0, 8, 3, 3]"
95,20,18,9,2243,0,3,15,"[2, 0, 1, 3, 3, 3, 0, 4, 1, 0, 1, 5, 3, 5, 0, 0, 5, 3, 1, 1, 0, 5, 1, 5, 0, 4, 5, 4, 4]"
96,20,85,29,2299,0,58,27,"[5, 9, 1, 6, 2, 8, 1, 5, 4, 0, 2, 7, 2, 9, 9, 0, 9, 4, 1, 7, 0, 1, 3, 9, 9, 1, 7, 5, 3]"
97,20,8,1,2306,0,0,8,"[0, 2, 1, 2, 0, 0, 1, 2, 1, 1, 0, 2, 2, 0, 1, 1, 2, 0, 1, 1, 0, 1, 2, 2, 0, 1, 0, 1, 2]"
98,20,74,73,2307,0,65,9,"[2, 1, 2, 3, 2, 1, 0, 1, 1, 2, 2, 1, 0, 2, 1, 1, 3, 0, 2, 0, 0, 3, 2, 3, 2, 1, 3, 1, 1]"
99,20,42,15,2334,0,28,14,"[4, 0, 0, 2, 0, 3, 0, 2, 4, 3, 3, 0, 0, 2, 2, 1, 4, 0, 1, 1, 0, 3, 2, 4, 2, 2, 0, 0, 1]"
100,20,41,17,2358,0,2,39,"[8, 11, 6, 6, 12, 13, 6, 0, 10, 11, 10, 5, 12, 3, 12, 10, 13, 2, 0, 0, 0, 6, 13, 13, 13, 6, 10, 10, 7]"
101,20,55,3,2410,0,28,27,"[9, 4, 7, 7, 8, 8, 9, 6, 3, 0, 2, 0, 1, 8, 5, 7, 9, 4, 5, 8, 0, 2, 7, 9, 8, 8, 6, 4, 9]"
102,20,21,9,2422,0,10,11,"[1, 1, 0, 3, 2, 2, 3, 2, 2, 1, 1, 3, 2, 3, 3, 3, 3, 1, 1, 2, 0, 0, 1, 3, 0, 0, 2, 1, 1]"
103,20,35,17,2440,0,4,31,"[2, 5, 10, 7, 1, 2, 2, 10, 6, 1, 5, 3, 0, 2, 9, 7, 10, 9, 1, 1, 0, 9, 3, 10, 4, 3, 4, 8, 2]"
104,20,78,9,2509,0,77,1,"[0, 0, 0, 0, 0, 0, 0, 0, 0, 0, 0, 0, 0, 0, 0, 0, 0, 0, 0, 0, 0, 0, 0, 0, 0, 0, 0, 0, 0]"
105,20,86,8,2587,0,72,14,"[4, 2, 2, 3, 3, 0, 1, 2, 2, 3, 3, 3, 1, 1, 3, 0, 4, 2, 0, 1, 0, 1, 2, 4, 0, 3, 1, 4, 0]"
106,20,49,41,2595,0,2,47,"[3, 5, 8, 7, 6, 9, 8, 6, 12, 6, 15, 14, 7, 9, 3, 7, 15, 4, 3, 3, 0, 10, 13, 15, 9, 6, 3, 12, 10]"
107,20,90,12,2673,0,38,52,"[12, 1, 6, 7, 14, 6, 9, 9, 11, 15, 15, 16, 11, 5, 15, 6, 17, 12, 1, 5, 0, 15, 7, 17, 1, 4, 14, 9, 1]"
108,20,16,2,2687,0,0,16,"[3, 1, 3, 5, 5, 5, 1, 3, 1, 2, 0, 2, 1, 5, 0, 3, 5, 3, 0, 2, 0, 3, 1, 5, 3, 3, 2, 3, 3]"
109,20,35,31,2691,0,12,23,"[6, 6, 3, 7, 7, 4, 2, 2, 1, 7, 2, 2, 4, 0, 2, 4, 7, 5, 7, 6, 0, 3, 6, 7, 5, 5, 4, 3, 2]"
110,20,23,17,2697,0,17,6,"[1, 1, 0, 0, 0, 0, 0, 0, 0, 2, 1, 0, 0, 1, 2, 1, 2, 2, 1, 0, 0, 1, 2, 2, 2, 0, 0, 2, 0]"
111,20,66,65,2698,0,45,21,"[3, 6, 6, 6, 1, 5, 4, 0, 4, 1, 2, 2, 4, 7, 0, 0, 7, 1, 3, 4, 0, 1, 0, 7, 7, 1, 1, 6, 2]"
112,20,82,1,2779,0,68,14,"[3, 4, 4, 0, 0, 3, 0, 2, 4, 3, 1, 3, 4, 2, 3, 2, 4, 3, 0, 2, 0, 3, 4, 4, 3, 3, 4, 0, 4]"
113,20,11,2,2788,0,3,8,"[0, 1, 1, 1, 1, 2, 1, 0, 0, 0, 2, 1, 0, 2, 0, 2, 2, 2, 1, 0, 0, 2, 0, 2, 2, 1, 1, 0, 2]"
114,20,2,0,2790,0,2,0,"[0, 0, 0, 0, 0, 0, 0, 0, 0, 0, 0, 0, 0, 0, 0, 0, 0, 0, 0, 0, 0, 0, 0, 0, 0, 0, 0, 0, 0]"
115,20,19,15,2794,0,15,4,"[0, 0, 1, 1, 0, 1, 0, 0, 1, 1, 0, 0, 0, 1, 1, 1, 1, 1, 0, 1, 0, 1, 0, 1, 0, 0, 1, 0, 0]"
116,20,52,14,2832,0,47,5,"[1, 1, 0, 1, 1, 1, 0, 1, 1, 1, 1, 0, 1, 1, 1, 0, 1, 1, 1, 1, 0, 0, 1, 1, 0, 1, 0, 1, 0]"
117,20,17,15,2834,0,16,1,"[0, 0, 0, 0, 0, 0, 0, 0, 0, 0, 0, 0, 0, 0, 0, 0, 0, 0, 0, 0, 0, 0, 0, 0, 0, 0, 0, 0, 0]"
118,20,64,11,2887,0,46,18,"[0, 1, 5, 5, 1, 1, 3, 4, 0, 4, 1, 2, 1, 6, 1, 4, 6, 2, 3, 5, 0, 6, 5, 6, 5, 6, 5, 5, 2]"
119,20,56,7,2936,0,13,43,"[3, 4, 13, 11, 14, 9, 11, 5, 3, 11, 4, 10, 14, 13, 2, 11, 14, 11, 3, 14, 0, 14, 13, 14, 12, 3, 5, 12, 6]"
0,21,1592,0,1592,0,562,1030,"[131, 4, 95, 119, 208, 250, 322, 143, 49, 328, 11, 270, 215, 343, 312, 71, 82, 175, 343, 332, 134, 0, 214, 73, 76, 152, 97, 296, 12]"
1,21,2326,471,3447,0,360,1966,"[346, 244, 23, 75, 524, 109, 542, 654, 372, 601, 51, 8, 191, 655, 398, 78, 327, 431, 655, 549, 417, 0, 247, 280, 59, 650, 52, 197, 253]"
2,21,2179,1649,3977,0,1992,187,"[26, 16, 16, 47, 38, 24, 8, 53, 52, 9, 3, 29, 8, 62, 34, 29, 12, 46, 62, 60, 10, 0, 1, 47, 57, 46, 5, 23, 45]"
3,21,2466,78,6365,0,1852,614,"[21, 133, 16, 198, 92, 134, 150, 170, 85, 61, 118, 69, 62, 204, 75, 36, 28, 102, 204, 152, 0, 0, 102, 50, 144, 143, 192, 180, 120]"
4,21,2985,1087,8263,0,1628,1357,"[74, 416, 237, 39, 168, 171, 95, 133, 72, 54, 389, 63, 167, 452, 3, 208, 303, 403, 452, 394, 251, 0, 96, 419, 182, 88, 107, 128, 296]"
5,21,1360,251,9372,0,851,509,"[92, 141, 168, 114, 96, 158, 75, 140, 46, 167, 102, 96, 66, 169, 138, 16, 120, 6, 169, 42, 32, 0, 149, 161, 30, 136, 22, 57, 115]"
6,21,1274,366,10000,280,925,349,"[107, 89, 101, 66, 29, 86, 31, 18, 9, 25, 89, 16, 36, 116, 27, 46, 64, 63, 116, 26, 88, 0, 53, 69, 67, 47, 80, 82, 52]"
7,21,1278,5271,6007,0,854,424,"[86, 109, 98, 1, 120, 22, 56, 40, 121, 100, 25, 52, 125, 141, 88, 60, 9, 84, 141, 75, 72, 0, 98, 23, 71, 42, 59, 58, 1]"
8,21,2409,1139,7277,0,1647,762,"[24, 190, 78, 249, 107, 157, 159, 160, 115, 175, 236, 150, 22, 254, 153, 68, 206, 201, 254, 211, 95, 0, 222, 130, 16, 1, 21, 122, 254]"
9,21,1425,204,8498,0,251,1174,"[195, 248, 264, 142, 215, 359, 241, 66, 13, 289, 213, 63, 106, 391, 249, 378, 154, 101, 391, 94, 268, 0, 326, 17, 21, 237, 39, 53, 200]"
10,21,1405,404,9499,0,657,748,"[191, 106, 115, 1, 160, 248, 65, 97, 137, 153, 74, 125, 237, 249, 197, 58, 212, 77, 249, 129, 86, 0, 10, 26, 137, 112, 98, 68, 126]"
11,21,2092,5703,5888,0,2019,73,"[13, 16, 16, 2, 15, 12, 22, 9, 11, 23, 9, 11, 7, 24, 3, 16, 0, 1, 24, 13, 9, 0, 4, 21, 17, 23, 19, 12, 1]"
12,21,1089,387,6590,0,211,878,"[75, 38, 206, 187, 69, 283, 88, 263, 291, 276, 233, 178, 91, 292, 4, 168, 161, 108, 292, 39, 157, 0, 188, 215, 114, 276, 214, 250, 23]"
13,21,2514,1516,7588,0,791,1723,"[438, 138, 264, 260, 497, 165, 181, 315, 234, 572, 122, 374, 98, 574, 119, 425, 125, 302, 574, 59, 208, 0, 295, 371, 191, 466, 352, 524, 574]"
14,21,1615,74,9129,0,1206,409,"[59, 60, 91, 20, 68, 123, 87, 126, 81, 103, 130, 136, 79, 136, 23, 84, 26, 20, 136, 88, 102, 0, 15, 57, 71, 122, 119, 31, 33]"
15,21,1499,597,10000,31,1008,491,"[87, 41, 34, 86, 106, 57, 15, 161, 92, 156, 127, 134, 17, 163, 56, 149, 109, 67, 163, 108, 10, 0, 27, 87, 40, 155, 152, 133, 162]"
16,21,2607,5865,6742,0,1893,714,"[235, 87, 173, 63, 147, 208, 45, 30, 6, 7, 117, 24, 181, 238, 174, 182, 123, 5, 238, 187, 211, 0, 24, 169, 36, 57, 185, 198, 50]"
17,21,1168,346,7564,0,809,359,"[42, 110, 15, 14, 17, 70, 89, 69, 60, 34, 80, 112, 36, 119, 9, 74, 103, 61, 119, 14, 40, 0, 103, 77, 69, 48, 19, 103, 100]"
18,21,2757,1344,8977,0,1341,1416,"[349, 465, 174, 340, 115, 275, 120, 359, 208, 436, 110, 382, 468, 472, 150, 426, 355, 454, 472, 202, 447, 0, 463, 322, 240, 165, 54, 463, 471]"
19,21,1139,728,9388,0,1121,18,"[6, 3, 6, 1, 2, 5, 6, 4, 5, 4, 2, 5, 1, 6, 3, 2, 6, 3, 6, 5, 5, 0, 6, 1, 2, 3, 1, 3, 3]"
20,21,2945,5396,6937,0,2938,7,"[2, 2, 1, 1, 2, 1, 1, 0, 2, 0, 1, 2, 1, 2, 2, 0, 1, 2, 2, 1, 1, 0, 1, 2, 2, 2, 2, 2, 0]"
21,21,1100,779,7258,0,788,312,"[103, 51, 17, 67, 56, 74, 63, 79, 65, 39, 71, 63, 58, 104, 66, 32, 82, 22, 104, 67, 100, 0, 20, 13, 0, 21, 92, 92, 38]"
22,21,2367,835,8790,0,1528,839,"[125, 105, 84, 250, 20, 203, 243, 72, 141, 74, 208, 93, 276, 279, 83, 175, 89, 266, 279, 196, 127, 0, 265, 210, 123, 161, 219, 115, 15]"
23,21,1829,845,9774,0,217,1612,"[337, 306, 374, 93, 85, 328, 479, 37, 422, 238, 274, 102, 519, 537, 284, 375, 449, 355, 537, 117, 301, 0, 334, 223, 244, 487, 133, 42, 311]"
24,21,2452,7363,4863,0,1504,948,"[122, 128, 209, 138, 15, 312, 125, 300, 5, 255, 231, 46, 10, 316, 139, 185, 173, 164, 316, 283, 273, 0, 68, 306, 277, 4, 199, 275, 203]"
25,21,1906,372,6397,0,1899,7,"[2, 2, 2, 1, 0, 1, 2, 2, 2, 0, 0, 2, 1, 2, 2, 2, 0, 1, 2, 0, 0, 0, 0, 1, 0, 0, 1, 2, 0]"
26,21,1713,439,7671,0,734,979,"[169, 218, 14, 67, 167, 267, 57, 190, 96, 79, 191, 107, 194, 326, 106, 121, 265, 147, 326, 186, 41, 0, 85, 211, 138, 306, 39, 204, 96]"
27,21,2705,1774,8602,0,67,2638,"[303, 184, 11, 730, 858, 142, 74, 143, 165, 337, 12, 294, 82, 879, 167, 127, 848, 838, 879, 449, 552, 0, 751, 114, 201, 12, 370, 371, 514]"
28,21,1824,1675,8751,0,1789,35,"[2, 7, 2, 2, 5, 9, 7, 3, 6, 11, 5, 6, 0, 11, 7, 4, 9, 3, 11, 8, 6, 0, 2, 8, 3, 6, 0, 6, 0]"
29,21,2167,209,10000,709,16,2151,"[671, 199, 79, 394, 507, 539, 331, 75, 313, 314, 246, 253, 595, 717, 114, 504, 580, 45, 717, 577, 600, 0, 129, 167, 280, 322, 312, 222, 283]"
30,21,1630,5506,6124,0,32,1598,"[293, 287, 324, 215, 213, 55, 242, 136, 405, 165, 11, 333, 529, 532, 480, 284, 211, 371, 532, 401, 75, 0, 154, 81, 490, 403, 314, 266, 14]"
31,21,2455,1160,7419,0,1867,588,"[41, 93, 160, 160, 181, 108, 7, 25, 60, 14, 89, 168, 68, 196, 175, 113, 157, 49, 196, 186, 60, 0, 124, 45, 30, 181, 95, 171, 159]"
32,21,2627,1655,8391,0,392,2235,"[333, 242, 238, 65, 328, 211, 648, 140, 310, 147, 415, 63, 91, 745, 289, 125, 630, 458, 745, 158, 630, 0, 633, 48, 251, 371, 44, 313, 318]"
33,21,2060,1847,8604,0,1553,507,"[75, 90, 72, 11, 43, 11, 127, 83, 47, 45, 81, 68, 127, 169, 114, 154, 133, 136, 169, 34, 95, 0, 148, 74, 82, 103, 3, 158, 131]"
34,21,2327,295,10000,636,726,1601,"[407, 520, 208, 300, 482, 48, 19, 501, 410, 65, 112, 500, 360, 533, 142, 465, 487, 78, 533, 26, 321, 0, 231, 225, 205, 496, 168, 94, 181]"
35,21,2774,7315,5459,0,1199,1575,"[365, 524, 72, 398, 297, 437, 373, 510, 216, 436, 259, 120, 185, 525, 442, 326, 11, 322, 525, 299, 519, 0, 277, 20, 333, 370, 7, 525, 497]"
36,21,2028,1537,5950,0,395,1633,"[53, 59, 207, 288, 459, 202, 333, 209, 251, 515, 363, 282, 437, 544, 109, 398, 412, 145, 544, 357, 234, 0, 275, 126, 240, 226, 279, 246, 167]"
37,21,1977,912,7015,0,1046,931,"[211, 140, 309, 159, 31, 301, 178, 237, 146, 53, 40, 262, 110, 310, 121, 200, 250, 306, 310, 98, 75, 0, 264, 125, 13, 66, 56, 244, 183]"
38,21,2203,1331,7887,0,2150,53,"[1, 8, 15, 14, 1, 7, 7, 4, 10, 17, 9, 13, 12, 17, 6, 5, 14, 14, 17, 2, 4, 0, 13, 0, 4, 3, 8, 13, 8]"
39,21,2796,983,9700,0,1736,1060,"[311, 301, 207, 335, 107, 187, 76, 25, 150, 138, 140, 92, 122, 353, 83, 345, 146, 48, 353, 34, 58, 0, 196, 117, 260, 183, 298, 51, 50]"
40,21,1726,6834,4592,0,445,1281,"[315, 394, 94, 236, 137, 399, 243, 240, 33, 238, 353, 260, 122, 427, 366, 154, 46, 407, 427, 371, 154, 0, 221, 2, 107, 64, 86, 257, 248]"
41,21,1513,1495,4610,0,553,960,"[83, 98, 0, 140, 314, 234, 175, 305, 32, 40, 226, 8, 301, 320, 206, 172, 61, 78, 320, 214, 86, 0, 23, 128, 57, 288, 273, 20, 182]"
42,21,1159,105,5664,0,1112,47,"[14, 6, 1, 10, 8, 14, 3, 6, 13, 13, 15, 4, 10, 15, 7, 9, 0, 1, 15, 14, 0, 0, 0, 14, 12, 5, 3, 3, 15]"
43,21,2251,716,7199,0,1373,878,"[17, 112, 266, 181, 283, 265, 151, 43, 47, 237, 69, 277, 14, 292, 149, 205, 277, 96, 292, 20, 64, 0, 156, 121, 277, 212, 27, 152, 172]"
44,21,2011,1111,8099,0,175,1836,"[161, 300, 565, 468, 280, 454, 202, 242, 244, 21, 46, 493, 306, 612, 600, 297, 17, 14, 612, 247, 307, 0, 179, 259, 515, 33, 597, 211, 589]"
45,21,1297,952,8444,0,689,608,"[124, 175, 85, 122, 132, 10, 33, 10, 74, 199, 61, 63, 92, 202, 65, 18, 98, 190, 202, 164, 95, 0, 18, 12, 83, 59, 154, 19, 118]"
46,21,1105,1087,8462,0,907,198,"[10, 9, 46, 53, 49, 12, 30, 19, 17, 58, 32, 40, 43, 66, 8, 55, 25, 46, 66, 40, 15, 0, 66, 33, 44, 42, 18, 57, 24]"
47,21,2746,6217,4991,0,2244,502,"[52, 146, 28, 119, 99, 146, 21, 136, 142, 29, 74, 112, 5, 167, 114, 74, 63, 53, 167, 13, 156, 0, 62, 100, 145, 8, 26, 137, 138]"
48,21,1264,189,6066,0,1245,19,"[0, 0, 5, 5, 6, 3, 4, 6, 1, 2, 5, 1, 0, 6, 3, 2, 1, 6, 6, 0, 3, 0, 1, 6, 3, 6, 0, 4, 0]"
49,21,2788,2662,6192,0,896,1892,"[320, 390, 72, 198, 307, 160, 37, 324, 403, 314, 383, 183, 265, 630, 64, 124, 121, 386, 630, 45, 96, 0, 434, 218, 571, 155, 454, 342, 184]"
50,21,2614,1880,6926,0,2363,251,"[22, 43, 36, 80, 47, 32, 61, 52, 11, 57, 1, 43, 11, 83, 35, 66, 15, 0, 83, 71, 51, 0, 66, 25, 61, 31, 70, 20, 58]"
51,21,1742,1634,7034,0,996,746,"[115, 145, 29, 125, 74, 69, 167, 183, 166, 183, 59, 91, 125, 248, 130, 101, 53, 68, 248, 229, 136, 0, 177, 167, 247, 193, 194, 93, 0]"
52,21,2806,789,9051,0,624,2182,"[484, 15, 400, 176, 368, 617, 268, 151, 661, 645, 524, 240, 458, 727, 434, 351, 411, 575, 727, 446, 35, 0, 362, 36, 334, 628, 250, 288, 178]"
53,21,2800,5466,6385,0,183,2617,"[689, 616, 459, 634, 49, 368, 362, 206, 53, 67, 606, 10, 144, 872, 704, 787, 809, 214, 872, 217, 571, 0, 328, 533, 172, 415, 562, 556, 830]"
54,21,1679,904,7160,0,181,1498,"[495, 435, 135, 469, 207, 200, 366, 254, 466, 396, 291, 316, 471, 499, 428, 236, 443, 2, 499, 243, 51, 0, 460, 51, 121, 276, 494, 32, 81]"
55,21,2172,1044,8288,0,1242,930,"[60, 177, 192, 8, 147, 281, 220, 254, 263, 269, 257, 189, 232, 310, 250, 268, 281, 37, 310, 203, 238, 0, 92, 225, 171, 7, 201, 310, 186]"
56,21,2279,260,10000,307,589,1690,"[304, 205, 244, 129, 187, 72, 113, 351, 549, 300, 256, 141, 252, 563, 121, 107, 78, 371, 563, 317, 555, 0, 210, 45, 8, 284, 187, 32, 250]"
57,21,2081,6543,5538,0,1822,259,"[21, 47, 8, 62, 78, 15, 69, 59, 6, 59, 51, 32, 42, 86, 54, 24, 1, 61, 86, 30, 37, 0, 11, 73, 48, 62, 62, 32, 13]"
58,21,1286,979,5845,0,1219,67,"[15, 19, 10, 1, 10, 6, 9, 15, 15, 17, 2, 11, 17, 22, 3, 8, 22, 7, 22, 1, 20, 0, 15, 5, 5, 7, 22, 0, 9]"
59,21,1790,891,6744,0,690,1100,"[74, 47, 2, 172, 36, 0, 116, 108, 312, 101, 356, 22, 239, 366, 256, 245, 215, 25, 366, 63, 299, 0, 91, 27, 309, 339, 147, 171, 139]"
60,21,1377,42,8079,0,1120,257,"[44, 60, 78, 18, 2, 33, 80, 63, 10, 60, 46, 24, 28, 85, 40, 40, 74, 19, 85, 47, 61, 0, 13, 23, 2, 1, 56, 60, 70]"
61,21,2081,1653,8507,0,762,1319,"[250, 364, 405, 227, 74, 159, 383, 239, 214, 51, 37, 212, 361, 439, 228, 302, 303, 171, 439, 356, 81, 0, 401, 298, 330, 436, 32, 336, 318]"
62,21,2717,6403,4821,0,1022,1695,"[544, 293, 53, 100, 97, 384, 10, 280, 528, 132, 435, 120, 330, 565, 231, 36, 72, 42, 565, 302, 299, 0, 559, 160, 262, 456, 438, 344, 400]"
63,21,1219,620,5420,0,669,550,"[64, 41, 158, 64, 130, 24, 163, 3, 49, 37, 54, 90, 95, 183, 79, 155, 166, 20, 183, 55, 131, 0, 67, 85, 44, 156, 50, 176, 71]"
64,21,1602,1144,5878,0,1128,474,"[108, 38, 76, 44, 11, 152, 107, 126, 77, 109, 78, 137, 49, 158, 147, 50, 17, 15, 158, 80, 149, 0, 105, 18, 85, 71, 85, 50, 132]"
65,21,2807,1661,7024,0,2587,220,"[14, 70, 17, 52, 44, 51, 65, 14, 48, 23, 25, 45, 26, 73, 9, 26, 38, 66, 73, 34, 47, 0, 57, 73, 6, 33, 18, 23, 46]"
66,21,1212,758,7478,0,575,637,"[114, 92, 172, 210, 55, 44, 180, 207, 24, 9, 168, 6, 155, 212, 50, 56, 36, 123, 212, 21, 2, 0, 189, 157, 20, 39, 107, 33, 182]"
67,21,2143,39,9582,0,50,2093,"[31, 78, 583, 430, 645, 216, 354, 492, 122, 38, 432, 465, 608, 697, 477, 232, 90, 26, 697, 471, 507, 0, 425, 156, 577, 440, 309, 114, 628]"
68,21,2827,6906,5503,0,2007,820,"[66, 271, 121, 93, 133, 102, 99, 156, 16, 199, 35, 73, 120, 273, 267, 268, 133, 28, 273, 259, 8, 0, 59, 154, 166, 176, 108, 200, 66]"
69,21,1308,1007,5804,0,342,966,"[175, 175, 100, 129, 203, 296, 228, 73, 106, 205, 85, 31, 24, 322, 191, 78, 18, 278, 322, 5, 179, 0, 146, 58, 32, 57, 259, 317, 87]"
70,21,1016,158,6662,0,432,584,"[132, 180, 73, 137, 109, 84, 64, 43, 68, 22, 151, 138, 193, 194, 179, 119, 116, 174, 194, 115, 3, 0, 28, 169, 41, 114, 28, 27, 26]"
71,21,1848,464,8046,0,1466,382,"[45, 81, 45, 106, 82, 18, 107, 8, 43, 34, 32, 89, 28, 127, 14, 24, 124, 54, 127, 16, 3, 0, 125, 72, 100, 68, 90, 100, 66]"
72,21,2459,1568,8937,0,125,2334,"[350, 528, 234, 710, 196, 185, 94, 332, 204, 69, 39, 572, 104, 778, 420, 422, 128, 713, 778, 627, 83, 0, 758, 524, 128, 98, 8, 310, 765]"
73,21,2091,5164,5864,0,2079,12,"[1, 2, 2, 2, 3, 2, 2, 2, 3, 1, 3, 0, 1, 4, 0, 0, 3, 2, 4, 3, 0, 0, 1, 3, 4, 4, 4, 3, 2]"
74,21,2717,349,8232,0,326,2391,"[671, 514, 61, 2, 181, 292, 147, 403, 9, 67, 610, 538, 698, 797, 424, 134, 424, 757, 797, 689, 717, 0, 388, 114, 109, 796, 127, 562, 415]"
75,21,1063,30,9265,0,623,440,"[91, 0, 41, 104, 76, 74, 28, 88, 63, 1, 76, 13, 14, 146, 93, 74, 84, 65, 146, 67, 144, 0, 94, 118, 118, 93, 28, 100, 46]"
76,21,1905,5099,6071,0,872,1033,"[145, 238, 113, 141, 6, 112, 194, 249, 195, 32, 149, 103, 223, 344, 129, 179, 294, 289, 344, 339, 140, 0, 56, 25, 167, 138, 252, 162, 157]"
77,21,1631,1347,6355,0,542,1089,"[192, 61, 150, 116, 165, 85, 71, 189, 231, 331, 324, 169, 90, 363, 229, 332, 148, 111, 363, 81, 267, 0, 267, 310, 304, 231, 216, 65, 254]"
78,21,2107,931,7531,0,562,1545,"[373, 402, 40, 251, 198, 49, 229, 296, 457, 315, 416, 50, 365, 515, 293, 266, 509, 491, 515, 125, 115, 0, 99, 399, 171, 78, 222, 435, 175]"
79,21,2724,2283,7972,0,444,2280,"[209, 5, 706, 278, 533, 675, 709, 242, 354, 325, 345, 259, 588, 760, 596, 308, 493, 59, 760, 189, 149, 0, 664, 10, 331, 672, 568, 744, 386]"
80,21,1293,944,8321,0,909,384,"[50, 62, 44, 6, 44, 0, 124, 58, 10, 119, 46, 16, 59, 128, 59, 38, 81, 77, 128, 37, 111, 0, 27, 20, 112, 96, 89, 54, 125]"
81,21,1513,697,9137,0,347,1166,"[204, 184, 14, 16, 293, 291, 284, 387, 262, 253, 348, 203, 307, 388, 199, 243, 360, 163, 388, 178, 303, 0, 148, 264, 165, 324, 221, 117, 381]"
82,21,1556,627,10000,66,916,640,"[184, 120, 141, 170, 167, 140, 151, 175, 86, 18, 112, 18, 23, 213, 195, 102, 35, 86, 213, 134, 50, 0, 54, 129, 57, 137, 67, 126, 24]"
83,21,2917,7445,5472,0,1104,1813,"[603, 45, 510, 124, 597, 339, 231, 177, 589, 497, 540, 307, 309, 604, 499, 547, 93, 22, 604, 70, 373, 0, 539, 319, 344, 179, 208, 310, 2]"
84,21,2336,504,7304,0,334,2002,"[383, 354, 596, 6, 604, 304, 262, 251, 270, 604, 339, 238, 170, 667, 580, 231, 569, 642, 667, 601, 594, 0, 632, 427, 345, 633, 656, 204, 416]"
85,21,2840,2059,8085,0,1693,1147,"[167, 78, 231, 100, 244, 30, 120, 351, 345, 195, 380, 70, 230, 382, 182, 286, 89, 118, 382, 131, 12, 0, 154, 359, 9, 259, 295, 320, 216]"
86,21,1451,1288,8248,0,436,1015,"[323, 41, 35, 96, 99, 141, 153, 232, 156, 297, 190, 194, 235, 338, 328, 187, 160, 23, 338, 201, 239, 0, 318, 89, 6, 219, 193, 150, 248]"
87,21,1608,692,9164,0,223,1385,"[80, 215, 322, 308, 450, 134, 115, 15, 423, 41, 317, 425, 345, 461, 277, 91, 437, 320, 461, 38, 401, 0, 135, 203, 85, 126, 59, 233, 186]"
88,21,1268,491,9941,0,427,841,"[239, 192, 142, 270, 114, 106, 20, 20, 103, 220, 75, 193, 189, 280, 275, 175, 131, 266, 280, 191, 162, 0, 99, 69, 214, 265, 8, 88, 147]"
89,21,2813,5579,7175,0,2139,674,"[83, 123, 197, 211, 96, 171, 25, 126, 80, 151, 147, 206, 43, 224, 24, 120, 193, 205, 224, 115, 221, 0, 86, 219, 194, 190, 126, 50, 55]"
90,21,1150,416,7909,0,338,812,"[98, 224, 122, 55, 31, 211, 269, 3, 236, 201, 29, 225, 83, 270, 73, 109, 213, 70, 270, 15, 55, 0, 56, 265, 160, 66, 51, 16, 6]"
91,21,2294,983,9220,0,2181,113,"[17, 32, 28, 35, 13, 19, 5, 34, 26, 3, 32, 3, 32, 37, 16, 27, 30, 34, 37, 19, 22, 0, 31, 13, 23, 8, 27, 28, 22]"
92,21,2576,5606,6190,0,2201,375,"[80, 40, 87, 56, 23, 61, 72, 51, 36, 43, 90, 95, 94, 125, 77, 87, 26, 73, 125, 55, 75, 0, 89, 104, 69, 86, 50, 94, 22]"
93,21,2566,130,8626,0,1630,936,"[278, 9, 251, 49, 199, 216, 247, 275, 297, 277, 172, 87, 20, 312, 196, 11, 0, 55, 312, 284, 166, 0, 112, 283, 83, 272, 171, 224, 154]"
94,21,1715,590,9751,0,1426,289,"[93, 78, 45, 70, 89, 35, 76, 27, 84, 87, 9, 60, 49, 96, 36, 68, 47, 70, 96, 78, 89, 0, 80, 55, 45, 47, 6, 47, 31]"
95,21,2952,6405,6298,0,2138,814,"[147, 27, 137, 163, 43, 69, 189, 30, 147, 245, 170, 50, 253, 271, 197, 35, 259, 222, 271, 38, 167, 0, 42, 186, 251, 255, 180, 116, 250]"
96,21,1472,1135,6635,0,994,478,"[79, 52, 109, 96, 100, 20, 60, 88, 107, 23, 32, 102, 94, 159, 33, 40, 10, 36, 159, 141, 104, 0, 7, 6, 134, 104, 78, 66, 59]"
97,21,1978,1849,6764,0,407,1571,"[186, 67, 324, 387, 353, 500, 419, 148, 352, 174, 225, 86, 480, 523, 65, 461, 494, 157, 523, 178, 164, 0, 17, 204, 86, 330, 285, 341, 507]"
98,21,1073,953,6884,0,362,711,"[21, 26, 218, 229, 110, 156, 2, 126, 205, 94, 146, 33, 220, 237, 72, 41, 178, 2, 237, 235, 1, 0, 24, 100, 3, 34, 1, 140, 192]"
99,21,2965,654,9195,0,2293,672,"[106, 141, 24, 184, 18, 8, 114, 127, 114, 167, 96, 182, 15, 224, 191, 149, 71, 204, 224, 22, 39, 0, 10, 29, 200, 42, 39, 201, 126]"
100,21,1233,411,10000,17,44,1189,"[273, 59, 164, 53, 103, 376, 33, 13, 78, 228, 43, 209, 301, 396, 104, 196, 368, 300, 396, 263, 18, 0, 222, 236, 201, 305, 388, 74, 169]"
101,21,2263,7345,4918,0,463,1800,"[110, 566, 440, 496, 406, 411, 599, 170, 472, 122, 104, 561, 263, 600, 440, 318, 592, 581, 600, 185, 425, 0, 301, 289, 385, 392, 191, 181, 409]"
102,21,1949,1939,4928,0,335,1614,"[175, 10, 285, 165, 453, 296, 255, 460, 521, 234, 214, 122, 57, 538, 534, 70, 416, 245, 538, 270, 183, 0, 267, 166, 520, 423, 50, 39, 416]"
103,21,1524,669,5783,0,1449,75,"[12, 13, 19, 1, 19, 19, 13, 3, 15, 23, 12, 6, 19, 25, 11, 10, 8, 15, 25, 7, 13, 0, 9, 3, 19, 15, 8, 8, 2]"
104,21,2890,810,7863,0,151,2739,"[304, 248, 374, 98, 470, 222, 192, 757, 532, 850, 886, 45, 782, 913, 233, 588, 243, 156, 913, 470, 68, 0, 88, 247, 533, 619, 593, 157, 617]"
105,21,2498,2250,8111,0,2065,433,"[32, 91, 91, 104, 56, 74, 138, 17, 46, 79, 48, 120, 109, 144, 70, 128, 28, 102, 144, 48, 39, 0, 108, 5, 28, 84, 128, 125, 92]"
106,21,1116,833,8394,0,904,212,"[70, 53, 50, 22, 29, 12, 36, 0, 69, 22, 36, 52, 43, 70, 9, 40, 0, 50, 70, 15, 44, 0, 67, 40, 69, 6, 27, 9, 31]"
107,21,1527,1398,8523,0,922,605,"[79, 120, 30, 3, 146, 122, 80, 4, 39, 84, 190, 60, 74, 201, 179, 191, 87, 165, 201, 183, 81, 0, 101, 36, 182, 173, 165, 121, 106]"
108,21,1202,807,8918,0,1073,129,"[37, 40, 15, 32, 2, 42, 37, 39, 43, 35, 4, 12, 29, 43, 41, 8, 14, 32, 43, 38, 34, 0, 40, 20, 30, 8, 24, 18, 26]"
109,21,2566,6111,5373,0,2423,143,"[47, 22, 44, 13, 7, 42, 18, 36, 19, 6, 0, 8, 1, 47, 4, 25, 17, 44, 47, 27, 35, 0, 9, 40, 44, 37, 45, 20, 20]"
110,21,2587,2519,5441,0,209,2378,"[481, 663, 651, 629, 412, 469, 666, 46, 47, 620, 459, 431, 726, 792, 156, 749, 501, 454, 792, 177, 672, 0, 446, 171, 393, 394, 126, 486, 540]"
111,21,2106,312,7235,0,995,1111,"[206, 146, 310, 147, 207, 159, 167, 3, 282, 49, 239, 145, 149, 370, 168, 59, 258, 363, 370, 191, 351, 0, 75, 339, 190, 348, 253, 141, 94]"
112,21,1446,144,8537,0,59,1387,"[448, 255, 368, 304, 100, 308, 191, 352, 205, 227, 5, 253, 51, 462, 359, 42, 346, 363, 462, 64, 199, 0, 207, 188, 221, 59, 102, 245, 456]"
113,21,1601,870,9268,0,1109,492,"[127, 45, 24, 92, 126, 162, 140, 153, 34, 108, 79, 151, 37, 164, 115, 0, 118, 90, 164, 98, 25, 0, 65, 48, 61, 7, 121, 4, 126]"
114,21,2028,6092,5204,0,732,1296,"[131, 123, 274, 154, 288, 317, 256, 4, 319, 33, 373, 399, 75, 432, 123, 94, 263, 309, 432, 358, 169, 0, 229, 86, 60, 428, 317, 421, 49]"
115,21,2401,1372,6233,0,978,1423,"[361, 117, 250, 62, 77, 415, 95, 348, 436, 5, 399, 449, 457, 474, 417, 96, 170, 429, 474, 267, 150, 0, 5, 185, 426, 237, 54, 155, 381]"
116,21,2160,1360,7033,0,200,1960,"[89, 527, 438, 483, 464, 648, 351, 110, 242, 458, 155, 112, 276, 653, 263, 436, 390, 459, 653, 58, 29, 0, 629, 206, 250, 380, 620, 11, 445]"
117,21,1905,1139,7799,0,1161,744,"[77, 151, 242, 215, 104, 51, 118, 75, 85, 245, 146, 247, 53, 248, 102, 145, 102, 43, 248, 35, 47, 0, 60, 88, 211, 130, 105, 115, 40]"
118,21,2030,1259,8570,0,1002,1028,"[52, 80, 49, 311, 158, 320, 280, 160, 205, 197, 225, 180, 188, 342, 91, 238, 18, 1, 342, 35, 129, 0, 156, 111, 196, 339, 136, 226, 73]"
119,21,1772,1320,9022,0,718,1054,"[308, 92, 83, 107, 206, 322, 237, 90, 132, 115, 291, 244, 134, 351, 221, 243, 126, 278, 351, 293, 107, 0, 334, 121, 148, 337, 288, 136, 93]"
0,22,4431,0,4431,0,2560,1871,"[2, 138, 435, 79, 545, 568, 571, 259, 41, 598, 5, 623, 148, 50, 377, 283, 207, 484, 404, 98, 149, 43, 0, 291, 623, 210, 310, 546, 614]"
1,22,4951,856,8526,0,1770,3181,"[486, 177, 187, 3, 50, 1031, 647, 679, 981, 814, 269, 1060, 1015, 1021, 944, 531, 960, 445, 716, 942, 370, 227, 0, 152, 1060, 753, 231, 748, 110]"
2,22,3871,5864,6533,0,980,2891,"[416, 79, 797, 808, 175, 286, 806, 706, 764, 273, 374, 963, 907, 741, 474, 292, 863, 389, 798, 906, 754, 655, 0, 393, 963, 626, 716, 403, 185]"
3,22,3505,2685,7353,0,2505,1000,"[146, 245, 299, 143, 30, 143, 282, 47, 110, 67, 161, 333, 130, 262, 178, 180, 241, 75, 283, 20, 85, 91, 0, 279, 333, 191, 194, 300, 15]"
4,22,3943,7480,3816,0,1763,2180,"[681, 74, 529, 407, 564, 316, 634, 54, 211, 196, 75, 726, 114, 67, 124, 638, 653, 137, 551, 101, 14, 451, 0, 584, 726, 650, 616, 47, 463]"
5,22,4843,2466,6193,0,3406,1437,"[468, 278, 39, 220, 295, 370, 462, 205, 164, 122, 251, 479, 27, 321, 120, 169, 110, 427, 272, 417, 400, 388, 0, 300, 479, 367, 83, 190, 382]"
6,22,4575,1381,9387,0,1625,2950,"[175, 547, 100, 950, 234, 493, 258, 201, 212, 621, 78, 983, 333, 219, 241, 155, 40, 906, 200, 599, 943, 539, 0, 208, 983, 837, 318, 100, 858]"
7,22,4779,5859,8307,0,965,3814,"[19, 49, 597, 946, 832, 116, 301, 1172, 834, 1237, 615, 1271, 1014, 748, 1108, 404, 797, 880, 384, 7, 309, 1058, 0, 453, 1271, 1134, 989, 999, 1060]"
8,22,4944,6926,6325,0,2235,2709,"[473, 181, 899, 196, 892, 260, 856, 889, 395, 764, 831, 903, 1, 751, 541, 122, 791, 478, 360, 473, 350, 557, 0, 174, 903, 395, 37, 763, 735]"
9,22,3644,3193,6776,0,1560,2084,"[145, 431, 193, 674, 181, 388, 458, 128, 129, 238, 127, 694, 101, 666, 331, 37, 664, 268, 276, 566, 663, 480, 0, 240, 694, 98, 641, 498, 180]"
10,22,4072,1347,9501,0,3080,992,"[60, 212, 215, 183, 224, 114, 91, 302, 190, 112, 276, 330, 43, 41, 89, 325, 325, 201, 74, 192, 319, 153, 0, 248, 330, 189, 289, 325, 27]"
11,22,4824,7457,6868,0,4533,291,"[64, 28, 5, 54, 12, 44, 25, 36, 1, 32, 7, 97, 57, 66, 76, 54, 75, 36, 93, 64, 70, 54, 0, 46, 97, 48, 40, 90, 50]"
12,22,4369,6776,4461,0,1422,2947,"[45, 432, 416, 205, 734, 16, 278, 392, 164, 99, 314, 982, 722, 824, 954, 520, 200, 227, 901, 324, 638, 143, 0, 797, 982, 277, 858, 693, 434]"
13,22,4545,289,8717,0,4144,401,"[80, 17, 84, 80, 40, 28, 59, 28, 74, 67, 8, 133, 7, 106, 18, 48, 15, 87, 66, 87, 44, 23, 0, 55, 133, 103, 69, 52, 121]"
14,22,4462,7124,6055,0,1641,2821,"[754, 276, 461, 507, 539, 604, 195, 41, 706, 416, 129, 940, 157, 793, 457, 681, 371, 818, 383, 931, 815, 556, 0, 621, 940, 584, 653, 493, 45]"
15,22,4033,3308,6780,0,258,3775,"[189, 1180, 176, 4, 293, 1208, 295, 733, 117, 884, 542, 1258, 188, 310, 1064, 913, 509, 102, 540, 121, 741, 193, 0, 164, 1258, 1146, 1075, 173, 669]"
16,22,3822,3721,6881,0,95,3727,"[466, 1209, 36, 35, 881, 996, 179, 1238, 357, 74, 751, 1242, 593, 248, 151, 641, 935, 948, 1154, 201, 795, 233, 0, 1178, 1242, 153, 897, 994, 666]"
17,22,4589,5962,5508,0,1301,3288,"[298, 175, 408, 465, 982, 710, 557, 337, 499, 946, 726, 1096, 764, 910, 782, 15, 994, 849, 1025, 319, 750, 87, 0, 989, 1096, 499, 440, 917, 602]"
18,22,4440,2471,7477,0,3565,875,"[88, 169, 275, 98, 198, 252, 19, 43, 37, 193, 83, 291, 56, 276, 53, 173, 245, 175, 289, 31, 183, 94, 0, 15, 291, 84, 197, 282, 230]"
19,22,3916,7360,4033,0,731,3185,"[785, 222, 445, 400, 426, 614, 475, 208, 422, 547, 362, 1061, 585, 164, 875, 408, 618, 58, 440, 774, 818, 743, 0, 3, 1061, 741, 497, 87, 494]"
20,22,3245,2062,5216,0,2932,313,"[38, 60, 37, 58, 96, 23, 53, 49, 21, 26, 96, 104, 20, 25, 80, 16, 76, 70, 86, 32, 57, 53, 0, 92, 104, 91, 68, 74, 9]"
21,22,4603,3983,5836,0,1192,3411,"[1035, 659, 817, 228, 305, 1129, 429, 142, 1041, 282, 825, 1137, 944, 113, 295, 170, 1106, 861, 777, 68, 413, 1001, 0, 233, 1137, 1043, 399, 504, 302]"
22,22,3486,1331,7991,0,820,2666,"[558, 126, 220, 600, 123, 370, 507, 642, 757, 120, 706, 888, 39, 365, 509, 49, 41, 763, 143, 245, 772, 619, 0, 111, 888, 224, 489, 395, 478]"
23,22,3995,7110,4876,0,3037,958,"[55, 313, 178, 100, 117, 274, 45, 178, 273, 66, 278, 319, 306, 196, 68, 21, 144, 290, 304, 299, 140, 57, 0, 186, 319, 186, 116, 274, 291]"
24,22,3010,1587,6299,0,2387,623,"[140, 140, 127, 7, 74, 119, 26, 198, 20, 78, 198, 207, 138, 54, 28, 14, 82, 204, 43, 201, 151, 156, 0, 74, 207, 137, 9, 95, 6]"
25,22,4891,7144,4046,0,181,4710,"[717, 789, 1282, 366, 970, 1290, 365, 635, 52, 372, 365, 1570, 1373, 1361, 727, 82, 976, 1557, 670, 1476, 1471, 752, 0, 142, 1570, 692, 1197, 79, 202]"
26,22,3927,1771,6202,0,3139,788,"[101, 252, 65, 247, 156, 19, 262, 168, 7, 32, 30, 262, 18, 200, 64, 149, 238, 13, 59, 250, 50, 61, 0, 0, 262, 254, 147, 219, 79]"
27,22,4160,1943,8419,0,3329,831,"[246, 94, 262, 203, 254, 42, 147, 139, 260, 228, 133, 277, 80, 147, 203, 101, 3, 275, 181, 264, 236, 221, 0, 122, 277, 145, 260, 265, 191]"
28,22,4453,5093,7779,0,3477,976,"[41, 242, 88, 53, 15, 160, 100, 75, 105, 9, 113, 325, 42, 45, 77, 304, 4, 145, 33, 158, 250, 96, 0, 115, 325, 84, 249, 124, 60]"
29,22,3044,2691,8132,0,1352,1692,"[178, 411, 369, 299, 151, 294, 30, 276, 324, 124, 557, 564, 32, 72, 337, 147, 9, 500, 375, 243, 561, 53, 0, 407, 564, 275, 43, 293, 303]"
30,22,4421,6676,5877,0,2530,1891,"[17, 578, 146, 293, 60, 448, 156, 578, 621, 473, 2, 630, 81, 175, 181, 283, 141, 303, 300, 394, 391, 76, 0, 358, 630, 360, 127, 323, 211]"
31,22,4661,2119,8419,0,4213,448,"[121, 61, 132, 141, 88, 112, 36, 42, 77, 137, 128, 149, 132, 134, 136, 48, 45, 79, 116, 109, 53, 58, 0, 47, 149, 135, 82, 131, 136]"
32,22,4501,5617,7303,0,4344,157,"[21, 29, 52, 1, 44, 13, 23, 17, 16, 11, 43, 52, 30, 27, 25, 2, 50, 31, 11, 17, 7, 11, 0, 23, 52, 33, 48, 41, 38]"
33,22,3332,506,10000,129,3163,169,"[13, 16, 26, 53, 38, 19, 28, 52, 8, 50, 25, 56, 3, 28, 41, 32, 56, 36, 32, 34, 24, 28, 0, 13, 56, 38, 46, 25, 48]"
34,22,4005,7192,6813,0,700,3305,"[301, 950, 700, 26, 939, 539, 755, 55, 471, 868, 495, 1101, 24, 948, 737, 143, 839, 26, 275, 523, 813, 52, 0, 650, 1101, 879, 288, 253, 137]"
35,22,4373,6902,4284,0,86,4287,"[1412, 1065, 583, 1305, 920, 1293, 193, 1148, 894, 1053, 867, 1429, 984, 164, 1079, 791, 580, 1427, 1084, 840, 572, 1047, 0, 1261, 1429, 696, 531, 1165, 1354]"
36,22,3986,2554,5716,0,711,3275,"[1085, 1068, 427, 788, 793, 1048, 201, 417, 764, 568, 288, 1091, 123, 514, 817, 75, 387, 634, 115, 593, 777, 410, 0, 613, 1091, 156, 777, 611, 1039]"
37,22,3424,2181,6959,0,2989,435,"[52, 31, 96, 50, 102, 137, 94, 55, 63, 141, 138, 145, 0, 99, 123, 141, 60, 127, 5, 114, 70, 120, 0, 83, 145, 105, 33, 54, 64]"
38,22,4025,272,10000,712,2899,1126,"[375, 175, 158, 27, 189, 170, 164, 62, 44, 337, 131, 375, 235, 33, 73, 342, 367, 341, 43, 212, 70, 244, 0, 212, 375, 4, 345, 243, 55]"
39,22,4132,5500,8632,0,1820,2312,"[458, 318, 769, 158, 625, 520, 561, 525, 768, 189, 429, 770, 554, 300, 347, 359, 117, 657, 382, 680, 619, 330, 0, 327, 770, 346, 448, 395, 398]"
40,22,3752,6877,5507,0,1606,2146,"[377, 164, 665, 581, 225, 635, 143, 478, 443, 557, 591, 715, 21, 160, 543, 635, 407, 342, 421, 330, 361, 153, 0, 406, 715, 662, 232, 215, 20]"
41,22,3464,2582,6389,0,2787,677,"[48, 205, 133, 82, 16, 142, 79, 198, 29, 191, 187, 225, 32, 183, 29, 164, 50, 140, 170, 122, 12, 82, 0, 77, 225, 6, 149, 7, 103]"
42,22,3212,2178,7423,0,2003,1209,"[288, 195, 251, 198, 210, 106, 31, 156, 258, 68, 95, 403, 319, 69, 273, 12, 123, 150, 264, 170, 46, 139, 0, 300, 403, 44, 119, 268, 223]"
43,22,3081,566,9938,0,2902,179,"[41, 5, 22, 8, 47, 49, 25, 11, 10, 55, 35, 59, 34, 16, 36, 34, 44, 21, 16, 26, 49, 9, 0, 38, 59, 23, 16, 10, 6]"
44,22,3115,5121,7932,0,137,2978,"[394, 235, 584, 299, 323, 902, 189, 765, 865, 956, 922, 992, 612, 845, 160, 392, 143, 726, 775, 960, 448, 434, 0, 873, 992, 912, 893, 326, 602]"
45,22,3008,2822,8118,0,2793,215,"[15, 10, 64, 63, 13, 60, 33, 61, 57, 56, 52, 71, 6, 45, 43, 17, 10, 22, 27, 50, 12, 67, 0, 34, 71, 63, 18, 54, 20]"
46,22,3254,7361,4011,0,1180,2074,"[41, 96, 166, 608, 133, 506, 501, 357, 645, 253, 50, 691, 425, 229, 634, 461, 129, 497, 154, 66, 447, 240, 0, 88, 691, 306, 51, 291, 111]"
47,22,4854,2159,6706,0,3551,1303,"[434, 327, 66, 250, 194, 139, 287, 278, 378, 252, 252, 434, 278, 261, 163, 212, 343, 107, 14, 403, 101, 291, 0, 308, 434, 69, 34, 228, 190]"
48,22,4095,56,10000,745,4065,30,"[6, 1, 1, 1, 7, 2, 6, 10, 2, 9, 1, 10, 3, 8, 5, 8, 2, 1, 3, 6, 4, 2, 0, 2, 10, 9, 2, 2, 9]"
49,22,3231,6093,7138,0,2145,1086,"[136, 312, 356, 137, 272, 236, 28, 234, 54, 211, 6, 362, 321, 168, 109, 78, 71, 348, 112, 6, 321, 272, 0, 69, 362, 270, 324, 256, 109]"
50,22,4618,7274,4482,0,2017,2601,"[795, 590, 248, 318, 42, 525, 731, 484, 619, 390, 203, 867, 640, 709, 434, 430, 481, 471, 237, 524, 850, 669, 0, 274, 867, 354, 500, 220, 658]"
51,22,3077,633,6926,0,3006,71,"[0, 19, 17, 10, 13, 23, 1, 21, 14, 14, 8, 23, 14, 17, 9, 20, 2, 3, 18, 17, 3, 8, 0, 10, 23, 22, 17, 3, 6]"
52,22,4989,5584,6331,0,670,4319,"[1332, 803, 502, 517, 1173, 1193, 1321, 1063, 1191, 407, 1267, 1439, 468, 1368, 442, 1374, 955, 1278, 508, 1294, 346, 895, 0, 631, 1439, 1038, 777, 1208, 1008]"
53,22,3596,865,9062,0,3052,544,"[47, 65, 145, 72, 41, 181, 24, 52, 68, 4, 8, 181, 66, 4, 117, 60, 32, 137, 32, 30, 151, 94, 0, 63, 181, 78, 157, 164, 76]"
54,22,4301,6291,7072,0,3281,1020,"[280, 100, 51, 190, 338, 95, 107, 150, 279, 47, 318, 340, 172, 280, 1, 3, 107, 112, 312, 96, 48, 61, 0, 55, 340, 97, 37, 224, 327]"
55,22,3028,1708,8392,0,1676,1352,"[248, 343, 86, 170, 159, 406, 376, 47, 165, 152, 213, 450, 341, 24, 343, 278, 19, 33, 449, 235, 181, 381, 0, 231, 450, 185, 286, 264, 200]"
56,22,4417,6629,6180,0,3144,1273,"[389, 9, 197, 389, 121, 109, 16, 264, 101, 287, 214, 424, 212, 51, 332, 235, 407, 382, 83, 341, 193, 182, 0, 247, 424, 0, 135, 314, 151]"
57,22,4118,796,9502,0,3368,750,"[70, 204, 64, 101, 107, 67, 65, 240, 249, 193, 70, 250, 240, 96, 122, 54, 74, 99, 178, 153, 33, 138, 0, 128, 250, 14, 173, 80, 140]"
58,22,3922,7358,6066,0,1311,2611,"[104, 537, 298, 751, 868, 369, 756, 665, 801, 626, 670, 870, 701, 748, 160, 393, 563, 551, 173, 296, 655, 403, 0, 21, 870, 44, 73, 644, 527]"
59,22,4392,2629,7829,0,2176,2216,"[296, 492, 683, 557, 129, 447, 185, 331, 56, 278, 587, 738, 713, 261, 711, 31, 380, 408, 421, 129, 95, 683, 0, 35, 738, 509, 369, 721, 524]"
60,22,3247,6326,4750,0,2169,1078,"[248, 311, 301, 281, 280, 239, 39, 216, 222, 160, 355, 359, 184, 66, 124, 140, 312, 296, 47, 319, 238, 29, 0, 202, 359, 152, 248, 191, 218]"
61,22,3026,2157,5619,0,1261,1765,"[102, 442, 40, 179, 201, 522, 496, 450, 114, 462, 69, 588, 48, 372, 148, 192, 555, 266, 36, 241, 73, 373, 0, 439, 588, 306, 291, 139, 201]"
62,22,4539,2270,7888,0,2120,2419,"[685, 651, 726, 48, 114, 293, 566, 68, 758, 250, 300, 806, 17, 705, 338, 727, 454, 70, 45, 41, 309, 13, 0, 18, 806, 315, 724, 243, 753]"
63,22,3889,6062,5715,0,3315,574,"[21, 53, 25, 188, 182, 29, 93, 111, 22, 140, 73, 191, 75, 74, 142, 53, 157, 71, 171, 35, 53, 162, 0, 178, 191, 32, 57, 107, 46]"
64,22,4315,4302,5728,0,53,4262,"[494, 1082, 899, 81, 119, 371, 876, 265, 1100, 596, 886, 1420, 566, 905, 1122, 588, 831, 818, 822, 1224, 413, 333, 0, 467, 1420, 659, 1192, 9, 614]"
65,22,4549,2723,7554,0,3856,693,"[223, 163, 122, 109, 70, 193, 219, 65, 213, 116, 25, 231, 104, 182, 25, 146, 156, 132, 150, 216, 29, 188, 0, 190, 231, 199, 211, 104, 17]"
66,22,3529,7413,3670,0,2621,908,"[300, 3, 127, 85, 162, 192, 110, 238, 157, 261, 276, 302, 271, 17, 298, 47, 40, 176, 41, 156, 27, 208, 0, 57, 302, 67, 73, 9, 196]"
67,22,4390,1227,6833,0,2562,1828,"[378, 288, 479, 476, 27, 312, 164, 56, 412, 352, 280, 609, 388, 253, 136, 556, 252, 302, 489, 480, 433, 441, 0, 554, 609, 222, 535, 234, 563]"
68,22,3074,2736,7171,0,206,2868,"[835, 448, 402, 385, 718, 608, 949, 866, 894, 718, 668, 956, 769, 486, 29, 351, 766, 100, 322, 618, 492, 700, 0, 550, 956, 830, 369, 704, 296]"
69,22,3848,7084,3935,0,2101,1747,"[140, 40, 47, 127, 235, 138, 163, 237, 482, 91, 52, 582, 273, 58, 476, 570, 521, 404, 425, 533, 18, 330, 0, 223, 582, 344, 20, 514, 24]"
70,22,3674,1880,5729,0,826,2848,"[666, 275, 4, 430, 533, 721, 237, 683, 918, 158, 682, 949, 771, 73, 640, 239, 182, 862, 52, 205, 234, 502, 0, 496, 949, 392, 727, 124, 525]"
71,22,4274,3076,6927,0,3151,1123,"[85, 120, 234, 8, 283, 265, 313, 90, 9, 294, 137, 374, 198, 124, 76, 3, 338, 228, 82, 232, 173, 102, 0, 23, 374, 52, 219, 256, 147]"
72,22,4500,5509,5918,0,260,4240,"[1331, 328, 1286, 957, 1041, 1169, 526, 841, 397, 1215, 986, 1413, 1042, 1284, 563, 646, 845, 844, 1361, 215, 461, 803, 0, 652, 1413, 120, 254, 178, 971]"
73,22,3667,1959,7626,0,1557,2110,"[597, 100, 565, 645, 159, 220, 408, 439, 610, 229, 305, 703, 645, 446, 259, 426, 557, 551, 493, 469, 232, 298, 0, 435, 703, 239, 582, 312, 668]"
74,22,4988,6595,6019,0,4670,318,"[64, 98, 96, 84, 55, 41, 90, 83, 82, 92, 79, 106, 41, 103, 100, 22, 83, 100, 81, 0, 15, 90, 0, 23, 106, 68, 6, 33, 78]"
75,22,3794,2092,7721,0,2951,843,"[229, 164, 236, 160, 102, 145, 214, 125, 27, 215, 76, 281, 165, 79, 46, 74, 118, 48, 150, 169, 262, 87, 0, 134, 281, 136, 209, 235, 3]"
76,22,4051,6889,4883,0,2452,1599,"[487, 0, 76, 466, 383, 30, 337, 313, 440, 180, 200, 533, 394, 243, 364, 44, 285, 193, 134, 414, 22, 237, 0, 69, 533, 291, 401, 212, 44]"
77,22,3095,1186,6792,0,477,2618,"[506, 391, 21, 376, 395, 41, 759, 397, 750, 89, 658, 872, 366, 438, 253, 391, 585, 148, 419, 723, 39, 450, 0, 524, 872, 435, 63, 200, 773]"
78,22,3131,2905,7018,0,505,2626,"[430, 61, 106, 188, 206, 544, 720, 108, 702, 605, 623, 875, 519, 267, 328, 687, 649, 425, 193, 147, 393, 272, 0, 846, 875, 61, 4, 477, 278]"
79,22,4307,5584,5741,0,2157,2150,"[352, 179, 601, 703, 332, 105, 680, 194, 585, 149, 247, 716, 108, 433, 567, 188, 69, 242, 645, 184, 212, 359, 0, 574, 716, 80, 233, 288, 144]"
80,22,3329,1832,7238,0,2469,860,"[246, 137, 122, 153, 77, 286, 110, 9, 5, 261, 267, 286, 258, 32, 104, 17, 284, 8, 262, 56, 53, 13, 0, 152, 286, 213, 42, 241, 165]"
81,22,4411,6496,5153,0,2392,2019,"[359, 506, 80, 147, 502, 583, 534, 388, 132, 624, 645, 673, 304, 166, 284, 647, 174, 542, 51, 451, 366, 570, 0, 356, 673, 142, 299, 230, 575]"
82,22,4847,3619,6381,0,4477,370,"[111, 37, 21, 50, 36, 47, 26, 16, 102, 76, 30, 123, 115, 95, 77, 26, 91, 77, 29, 16, 66, 53, 0, 6, 123, 104, 39, 70, 46]"
83,22,3440,2519,7302,0,3145,295,"[84, 86, 24, 88, 28, 19, 14, 20, 22, 51, 57, 98, 52, 41, 67, 90, 33, 48, 17, 75, 87, 39, 0, 33, 98, 35, 69, 40, 12]"
84,22,3380,1720,8962,0,57,3323,"[453, 576, 902, 91, 9, 927, 621, 561, 1005, 1051, 192, 1107, 204, 719, 446, 246, 267, 910, 874, 541, 299, 511, 0, 1067, 1107, 569, 419, 113, 55]"
85,22,3811,7424,5349,0,1407,2404,"[466, 163, 317, 603, 596, 514, 597, 313, 26, 674, 203, 801, 341, 558, 700, 448, 27, 447, 404, 142, 467, 151, 0, 294, 801, 340, 581, 533, 705]"
86,22,3777,1006,8120,0,1597,2180,"[491, 553, 662, 323, 188, 447, 314, 131, 274, 56, 113, 726, 299, 316, 295, 151, 145, 215, 108, 665, 700, 207, 0, 699, 726, 162, 236, 516, 273]"
87,22,4257,7459,4918,0,1242,3015,"[277, 289, 669, 968, 588, 957, 465, 436, 610, 725, 354, 1005, 371, 898, 46, 834, 489, 118, 375, 681, 69, 957, 0, 598, 1005, 62, 54, 261, 485]"
88,22,4780,3929,5769,0,457,4323,"[1227, 411, 715, 763, 773, 761, 632, 139, 346, 292, 784, 1441, 1321, 419, 228, 360, 1233, 241, 646, 901, 1068, 1314, 0, 597, 1441, 413, 543, 386, 434]"
89,22,3293,2181,6881,0,867,2426,"[163, 734, 229, 375, 51, 26, 705, 357, 684, 741, 757, 808, 32, 35, 432, 798, 85, 749, 534, 491, 25, 378, 0, 222, 808, 312, 754, 354, 713]"
90,22,4552,5447,5986,0,3039,1513,"[495, 315, 17, 76, 325, 19, 225, 129, 348, 97, 503, 504, 316, 158, 101, 382, 377, 469, 70, 480, 4, 211, 0, 446, 504, 146, 301, 221, 265]"
91,22,3982,2695,7273,0,2248,1734,"[383, 229, 511, 123, 208, 540, 569, 33, 137, 438, 422, 578, 329, 523, 25, 425, 353, 423, 383, 502, 550, 306, 0, 500, 578, 157, 281, 372, 271]"
92,22,4016,5589,5700,0,1189,2827,"[688, 675, 201, 54, 363, 837, 78, 326, 308, 826, 876, 942, 36, 352, 169, 664, 326, 410, 470, 441, 670, 131, 0, 235, 942, 633, 434, 89, 763]"
93,22,3249,803,8146,0,2345,904,"[62, 272, 13, 82, 24, 111, 131, 192, 287, 170, 135, 301, 21, 151, 14, 256, 84, 115, 195, 100, 204, 275, 0, 113, 301, 225, 112, 122, 131]"
94,22,4811,7352,5605,0,2728,2083,"[180, 140, 227, 584, 197, 620, 473, 610, 139, 166, 452, 694, 643, 508, 286, 441, 257, 187, 325, 167, 525, 628, 0, 395, 694, 392, 180, 389, 127]"
95,22,4201,655,9151,0,2473,1728,"[243, 366, 514, 391, 259, 212, 95, 211, 194, 428, 62, 576, 165, 254, 389, 17, 339, 444, 458, 443, 302, 282, 0, 281, 576, 189, 280, 122, 286]"
96,22,4251,7152,6250,0,1182,3069,"[102, 855, 1004, 257, 689, 323, 778, 861, 187, 381, 325, 1023, 300, 764, 519, 422, 121, 834, 511, 527, 527, 195, 0, 842, 1023, 386, 80, 149, 310]"
97,22,4982,6920,4312,0,84,4898,"[535, 358, 763, 913, 1001, 1459, 382, 769, 1263, 505, 1191, 1632, 1504, 592, 1498, 1200, 859, 1414, 684, 1095, 133, 1413, 0, 1296, 1632, 99, 1440, 893, 879]"
98,22,3129,322,7119,0,2555,574,"[157, 114, 117, 8, 126, 32, 34, 117, 126, 34, 16, 191, 146, 29, 16, 178, 20, 136, 118, 56, 149, 30, 0, 96, 191, 103, 50, 58, 111]"
99,22,4216,7262,4073,0,452,3764,"[668, 1134, 1044, 678, 923, 478, 141, 1242, 800, 774, 883, 1254, 737, 697, 937, 626, 7, 1165, 241, 290, 1251, 1000, 0, 624, 1254, 288, 855, 298, 1073]"
100,22,4740,1958,6855,0,3289,1451,"[207, 305, 133, 161, 236, 58, 39, 87, 94, 53, 41, 483, 3, 313, 28, 178, 93, 362, 239, 131, 415, 123, 0, 324, 483, 463, 379, 401, 458]"
101,22,3463,11,10000,307,1701,1762,"[42, 359, 87, 223, 546, 566, 435, 276, 20, 273, 552, 587, 275, 353, 410, 448, 361, 552, 424, 179, 402, 479, 0, 518, 587, 386, 231, 426, 203]"
102,22,3275,7351,5924,0,249,3026,"[280, 547, 720, 653, 85, 355, 571, 504, 978, 244, 144, 1008, 812, 982, 718, 227, 321, 432, 206, 1006, 633, 413, 0, 240, 1008, 143, 493, 662, 205]"
103,22,4171,2740,7355,0,2501,1670,"[98, 261, 445, 413, 103, 329, 464, 287, 133, 443, 17, 556, 345, 410, 88, 432, 484, 540, 522, 251, 15, 369, 0, 1, 556, 294, 434, 501, 424]"
104,22,4961,6148,6168,0,2288,2673,"[349, 510, 304, 45, 636, 559, 650, 638, 26, 11, 315, 891, 570, 845, 268, 28, 272, 361, 123, 591, 82, 350, 0, 882, 891, 504, 744, 587, 497]"
105,22,4832,1382,9618,0,1251,3581,"[986, 940, 1154, 777, 691, 873, 1080, 510, 1065, 103, 426, 1193, 700, 1039, 214, 479, 1021, 792, 78, 237, 202, 1156, 0, 91, 1193, 540, 778, 718, 961]"
106,22,3571,6604,6585,0,2960,611,"[195, 182, 64, 169, 108, 179, 140, 6, 170, 193, 55, 203, 19, 50, 154, 103, 120, 191, 142, 85, 29, 9, 0, 144, 203, 104, 3, 185, 75]"
107,22,3994,3177,7402,0,2976,1018,"[197, 127, 27, 339, 264, 44, 116, 57, 254, 172, 68, 339, 185, 14, 297, 138, 20, 318, 199, 145, 312, 2, 0, 53, 339, 175, 311, 247, 337]"
108,22,3458,2445,8415,0,41,3417,"[1078, 415, 967, 861, 768, 65, 813, 530, 1131, 635, 172, 1139, 334, 1060, 195, 614, 76, 275, 588, 1095, 208, 575, 0, 559, 1139, 884, 487, 79, 967]"
109,22,4716,5023,8108,0,4266,450,"[35, 137, 96, 40, 92, 142, 8, 24, 77, 63, 109, 150, 23, 72, 29, 93, 62, 12, 106, 44, 132, 71, 0, 68, 150, 67, 35, 130, 65]"
110,22,3876,6726,5258,0,569,3307,"[905, 247, 1102, 997, 482, 535, 825, 656, 125, 1009, 961, 1102, 349, 783, 822, 716, 690, 921, 526, 454, 9, 1014, 0, 356, 1102, 783, 375, 629, 619]"
111,22,3410,112,8556,0,2990,420,"[37, 40, 80, 112, 12, 46, 65, 35, 88, 133, 74, 140, 60, 13, 4, 104, 137, 96, 33, 119, 83, 70, 0, 21, 140, 53, 80, 105, 10]"
112,22,3202,7143,4615,0,3199,3,"[1, 1, 1, 0, 1, 0, 0, 1, 0, 1, 1, 1, 1, 0, 0, 0, 0, 0, 0, 1, 1, 0, 0, 0, 1, 0, 1, 0, 1]"
113,22,4048,383,8280,0,38,4010,"[481, 1081, 549, 62, 86, 931, 182, 1170, 76, 638, 428, 1336, 947, 568, 68, 1014, 39, 968, 588, 53, 1308, 447, 0, 599, 1336, 577, 582, 1203, 433]"
114,22,4479,6386,6373,0,761,3718,"[98, 13, 626, 927, 647, 1094, 854, 1056, 460, 791, 362, 1239, 314, 791, 1112, 494, 380, 671, 801, 508, 410, 1021, 0, 137, 1239, 1219, 539, 1063, 175]"
115,22,3961,1538,8796,0,1867,2094,"[497, 572, 90, 404, 407, 283, 323, 76, 308, 604, 285, 698, 289, 326, 82, 420, 370, 183, 246, 398, 256, 305, 0, 63, 698, 381, 676, 457, 421]"
116,22,3395,7197,4994,0,3140,255,"[60, 29, 5, 6, 62, 62, 85, 84, 52, 66, 52, 85, 76, 50, 14, 58, 14, 61, 47, 23, 80, 67, 0, 68, 85, 44, 3, 57, 76]"
117,22,3199,1554,6639,0,2852,347,"[8, 64, 29, 65, 75, 90, 105, 94, 28, 26, 54, 115, 70, 87, 47, 39, 113, 35, 100, 67, 34, 1, 0, 113, 115, 29, 104, 108, 88]"
118,22,3992,1067,9564,0,2681,1311,"[102, 28, 254, 257, 155, 349, 180, 381, 54, 290, 313, 437, 332, 24, 101, 166, 330, 375, 137, 75, 168, 265, 0, 353, 437, 114, 398, 162, 298]"
119,22,4894,6302,8156,0,3701,1193,"[108, 110, 207, 180, 263, 243, 248, 32, 130, 284, 383, 397, 323, 307, 299, 80, 73, 309, 123, 318, 223, 26, 0, 319, 397, 300, 295, 140, 91]"
0,23,84,0,84,0,52,32,"[3, 5, 7, 6, 7, 0, 7, 9, 0, 1, 8, 10, 5, 10, 6, 9, 10, 1, 4, 8, 10, 4, 1, 0, 2, 7, 10, 6, 7]"
1,23,80,27,137,0,67,13,"[1, 2, 4, 2, 0, 0, 2, 4, 0, 3, 2, 1, 1, 2, 1, 0, 4, 0, 2, 2, 4, 3, 0, 0, 4, 3, 2, 4, 3]"
2,23,32,12,157,0,7,25,"[5, 1, 6, 1, 2, 2, 0, 0, 4, 3, 3, 1, 7, 2, 2, 8, 8, 7, 3, 2, 8, 2, 1, 0, 7, 4, 7, 0, 3]"
3,23,67,22,202,0,47,20,"[4, 5, 2, 0, 5, 2, 3, 3, 5, 4, 6, 0, 4, 2, 2, 6, 6, 6, 5, 4, 6, 1, 1, 0, 2, 1, 6, 3, 5]"
4,23,76,22,256,0,30,46,"[0, 15, 9, 7, 8, 4, 3, 3, 1, 9, 8, 13, 12, 11, 4, 13, 15, 6, 13, 7, 15, 3, 7, 0, 0, 15, 2, 14, 15]"
5,23,67,50,273,0,38,29,"[4, 3, 6, 7, 4, 5, 1, 2, 9, 5, 4, 3, 2, 4, 7, 2, 9, 6, 3, 5, 9, 9, 2, 0, 7, 3, 8, 5, 9]"
6,23,47,3,317,0,19,28,"[3, 8, 3, 8, 4, 1, 2, 6, 2, 2, 7, 3, 5, 8, 8, 0, 9, 4, 6, 2, 9, 9, 3, 0, 6, 3, 7, 6, 8]"
7,23,62,57,322,0,58,4,"[1, 0, 1, 0, 1, 0, 0, 0, 0, 0, 0, 1, 0, 1, 1, 0, 1, 0, 1, 1, 1, 0, 1, 0, 1, 0, 0, 1, 1]"
8,23,3,2,323,0,2,1,"[0, 0, 0, 0, 0, 0, 0, 0, 0, 0, 0, 0, 0, 0, 0, 0, 0, 0, 0, 0, 0, 0, 0, 0, 0, 0, 0, 0, 0]"
9,23,83,6,400,0,73,10,"[0, 0, 1, 3, 0, 1, 0, 2, 2, 0, 3, 1, 2, 2, 2, 1, 3, 1, 2, 2, 3, 3, 0, 0, 2, 3, 1, 2, 3]"
10,23,69,14,455,0,21,48,"[11, 16, 11, 9, 4, 7, 8, 10, 3, 11, 7, 3, 6, 2, 5, 5, 16, 14, 10, 5, 16, 3, 9, 0, 9, 7, 16, 8, 1]"
11,23,74,26,503,0,32,42,"[8, 7, 8, 9, 14, 10, 10, 7, 0, 9, 10, 1, 6, 11, 0, 8, 14, 2, 11, 8, 14, 7, 3, 0, 3, 14, 14, 14, 4]"
12,23,42,18,527,0,30,12,"[3, 4, 2, 3, 3, 2, 1, 0, 1, 3, 3, 4, 4, 1, 1, 1, 4, 1, 1, 0, 4, 2, 3, 0, 1, 0, 0, 2, 1]"
13,23,56,20,563,0,46,10,"[2, 1, 3, 0, 2, 2, 0, 1, 0, 3, 0, 0, 0, 3, 2, 0, 3, 3, 1, 1, 3, 3, 3, 0, 2, 0, 3, 0, 2]"
14,23,43,7,599,0,6,37,"[2, 2, 10, 2, 11, 8, 9, 4, 12, 7, 12, 5, 3, 9, 6, 11, 12, 7, 11, 4, 12, 4, 9, 0, 8, 9, 3, 12, 4]"
15,23,99,77,621,0,35,64,"[7, 13, 18, 9, 2, 16, 2, 4, 1, 12, 8, 15, 18, 1, 5, 17, 21, 2, 8, 10, 21, 1, 5, 0, 15, 0, 10, 4, 7]"
16,23,91,52,660,0,33,58,"[9, 12, 15, 10, 0, 10, 11, 17, 2, 17, 1, 15, 1, 6, 14, 10, 19, 10, 19, 18, 19, 1, 10, 0, 0, 13, 10, 15, 1]"
17,23,11,3,668,0,6,5,"[0, 1, 0, 1, 1, 1, 1, 1, 0, 0, 0, 0, 1, 0, 1, 1, 1, 0, 1, 0, 1, 1, 0, 0, 0, 1, 1, 0, 1]"
18,23,76,63,681,0,62,14,"[4, 2, 0, 3, 3, 1, 2, 1, 4, 1, 3, 2, 3, 1, 3, 0, 4, 1, 0, 0, 4, 4, 3, 0, 1, 0, 2, 1, 2]"
19,23,75,24,732,0,11,64,"[17, 0, 14, 0, 1, 14, 12, 20, 7, 13, 18, 12, 19, 4, 7, 18, 21, 6, 7, 0, 21, 17, 21, 0, 19, 10, 0, 3, 17]"
20,23,69,62,739,0,67,2,"[0, 0, 0, 0, 0, 0, 0, 0, 0, 0, 0, 0, 0, 0, 0, 0, 0, 0, 0, 0, 0, 0, 0, 0, 0, 0, 0, 0, 0]"
21,23,60,3,796,0,41,19,"[3, 6, 2, 1, 3, 0, 3, 0, 0, 2, 1, 3, 6, 1, 1, 0, 6, 6, 0, 6, 6, 3, 0, 0, 3, 3, 2, 5, 5]"
22,23,53,43,806,0,30,23,"[7, 2, 2, 2, 5, 4, 1, 5, 7, 4, 5, 0, 0, 4, 4, 3, 7, 5, 3, 3, 7, 5, 3, 0, 6, 6, 4, 1, 7]"
23,23,92,8,890,0,25,67,"[17, 11, 6, 3, 21, 18, 7, 8, 4, 9, 5, 6, 6, 4, 13, 1, 22, 1, 5, 13, 22, 18, 10, 0, 9, 2, 9, 18, 8]"
24,23,37,29,898,0,20,17,"[3, 4, 4, 1, 3, 3, 2, 5, 2, 3, 5, 2, 2, 3, 4, 0, 5, 4, 4, 2, 5, 1, 4, 0, 1, 1, 3, 1, 3]"
25,23,28,1,925,0,12,16,"[2, 4, 0, 5, 3, 1, 0, 4, 4, 5, 2, 4, 1, 4, 3, 4, 5, 5, 5, 1, 5, 4, 3, 0, 3, 2, 5, 3, 3]"
26,23,42,25,942,0,16,26,"[6, 8, 1, 5, 3, 8, 7, 1, 8, 3, 1, 7, 1, 0, 3, 1, 8, 4, 5, 1, 8, 6, 7, 0, 6, 4, 6, 0, 3]"
27,23,97,6,1033,0,5,92,"[2, 18, 9, 15, 25, 8, 16, 11, 22, 3, 3, 17, 19, 28, 3, 30, 30, 22, 9, 4, 30, 13, 18, 0, 22, 11, 18, 20, 30]"
28,23,29,8,1054,0,25,4,"[1, 1, 1, 1, 0, 1, 1, 0, 1, 1, 0, 1, 0, 1, 1, 0, 1, 1, 1, 0, 1, 0, 1, 0, 0, 0, 0, 1, 1]"
29,23,23,11,1066,0,13,10,"[1, 1, 2, 2, 2, 0, 1, 0, 3, 1, 3, 0, 0, 3, 3, 3, 3, 1, 2, 1, 3, 1, 1, 0, 2, 0, 0, 2, 2]"
30,23,65,48,1083,0,4,61,"[11, 7, 17, 16, 15, 10, 7, 2, 17, 12, 18, 7, 16, 19, 12, 15, 20, 8, 4, 14, 20, 11, 11, 0, 0, 14, 8, 15, 7]"
31,23,80,78,1085,0,51,29,"[1, 2, 2, 5, 0, 4, 3, 3, 2, 0, 8, 7, 1, 1, 3, 3, 9, 2, 2, 0, 9, 8, 5, 0, 7, 7, 3, 6, 2]"
32,23,60,39,1106,0,27,33,"[6, 11, 2, 4, 0, 3, 11, 8, 8, 3, 9, 3, 4, 6, 10, 8, 11, 9, 0, 9, 11, 3, 8, 0, 5, 10, 3, 8, 1]"
33,23,83,79,1110,0,20,63,"[10, 3, 17, 3, 4, 17, 20, 15, 20, 21, 0, 7, 14, 12, 17, 19, 21, 1, 16, 16, 21, 7, 2, 0, 21, 20, 4, 12, 12]"
34,23,33,12,1131,0,29,4,"[0, 0, 0, 1, 0, 1, 0, 0, 0, 0, 0, 1, 1, 1, 0, 0, 1, 1, 1, 1, 1, 1, 0, 0, 0, 0, 0, 0, 0]"
35,23,73,40,1164,0,73,0,"[0, 0, 0, 0, 0, 0, 0, 0, 0, 0, 0, 0, 0, 0, 0, 0, 0, 0, 0, 0, 0, 0, 0, 0, 0, 0, 0, 0, 0]"
36,23,85,61,1188,0,25,60,"[18, 16, 15, 13, 3, 15, 14, 3, 10, 2, 13, 0, 7, 0, 11, 7, 20, 8, 9, 6, 20, 7, 5, 0, 11, 20, 8, 15, 17]"
37,23,18,15,1191,0,3,15,"[4, 4, 2, 0, 2, 4, 5, 4, 2, 4, 5, 2, 2, 2, 1, 5, 5, 3, 0, 1, 5, 0, 1, 0, 3, 2, 2, 0, 4]"
38,23,49,43,1197,0,5,44,"[12, 1, 10, 14, 10, 0, 9, 4, 4, 7, 14, 6, 2, 5, 5, 4, 14, 14, 7, 12, 14, 0, 11, 0, 0, 9, 0, 14, 4]"
39,23,19,9,1207,0,1,18,"[0, 3, 2, 4, 2, 4, 0, 3, 6, 3, 0, 1, 5, 2, 2, 6, 6, 1, 2, 5, 6, 3, 4, 0, 2, 6, 0, 3, 5]"
40,23,32,31,1208,0,2,30,"[0, 2, 10, 4, 8, 2, 5, 5, 10, 2, 5, 0, 6, 8, 3, 6, 10, 6, 8, 5, 10, 0, 4, 0, 4, 7, 4, 1, 2]"
41,23,75,23,1260,0,42,33,"[11, 3, 2, 4, 8, 0, 7, 7, 7, 2, 4, 10, 1, 10, 2, 0, 11, 9, 5, 7, 11, 9, 11, 0, 0, 10, 4, 6, 7]"
42,23,53,11,1302,0,19,34,"[3, 7, 9, 7, 9, 4, 8, 2, 2, 7, 1, 3, 3, 1, 0, 2, 11, 6, 3, 10, 11, 0, 1, 0, 9, 4, 1, 6, 2]"
43,23,39,10,1331,0,5,34,"[6, 0, 4, 6, 3, 11, 6, 9, 3, 5, 9, 10, 7, 4, 0, 8, 11, 8, 10, 9, 11, 1, 9, 0, 10, 3, 10, 11, 10]"
44,23,61,59,1333,0,11,50,"[9, 3, 5, 13, 14, 4, 4, 13, 8, 16, 11, 14, 2, 2, 11, 5, 16, 0, 8, 3, 16, 16, 0, 0, 8, 16, 9, 3, 4]"
45,23,67,46,1354,0,16,51,"[10, 17, 15, 13, 3, 16, 4, 5, 3, 4, 2, 15, 2, 15, 5, 16, 17, 15, 1, 10, 17, 16, 6, 0, 8, 17, 3, 12, 5]"
46,23,41,11,1384,0,19,22,"[0, 4, 5, 3, 6, 1, 1, 6, 7, 7, 3, 1, 1, 3, 4, 5, 7, 3, 2, 1, 7, 0, 1, 0, 6, 6, 4, 6, 3]"
47,23,15,0,1399,0,13,2,"[0, 0, 0, 0, 0, 0, 0, 0, 0, 0, 0, 0, 0, 0, 0, 0, 0, 0, 0, 0, 0, 0, 0, 0, 0, 0, 0, 0, 0]"
48,23,77,31,1445,0,62,15,"[1, 5, 0, 4, 4, 1, 5, 4, 1, 2, 3, 3, 4, 3, 4, 0, 5, 2, 1, 4, 5, 5, 4, 0, 2, 4, 3, 0, 2]"
49,23,63,9,1499,0,43,20,"[2, 6, 1, 1, 6, 5, 2, 3, 3, 3, 2, 6, 4, 4, 6, 1, 6, 2, 6, 4, 6, 2, 2, 0, 0, 3, 5, 0, 4]"
50,23,60,23,1536,0,18,42,"[12, 7, 12, 10, 3, 5, 2, 3, 5, 4, 1, 1, 10, 11, 3, 7, 14, 0, 3, 14, 14, 5, 8, 0, 11, 2, 10, 7, 14]"
51,23,31,30,1537,0,7,24,"[0, 4, 3, 5, 0, 1, 4, 3, 3, 8, 0, 0, 4, 4, 6, 2, 8, 4, 0, 1, 8, 6, 3, 0, 5, 4, 5, 3, 8]"
52,23,49,38,1548,0,49,0,"[0, 0, 0, 0, 0, 0, 0, 0, 0, 0, 0, 0, 0, 0, 0, 0, 0, 0, 0, 0, 0, 0, 0, 0, 0, 0, 0, 0, 0]"
53,23,38,2,1584,0,17,21,"[3, 2, 0, 6, 2, 3, 2, 6, 0, 7, 2, 7, 6, 5, 1, 3, 7, 4, 1, 2, 7, 6, 2, 0, 5, 7, 3, 5, 3]"
54,23,57,50,1591,0,52,5,"[0, 1, 1, 1, 0, 0, 0, 0, 1, 0, 0, 1, 1, 0, 1, 1, 1, 1, 1, 0, 1, 1, 0, 0, 0, 1, 1, 0, 0]"
55,23,71,59,1603,0,7,64,"[6, 15, 18, 2, 2, 5, 8, 13, 9, 5, 8, 18, 21, 21, 13, 17, 21, 18, 1, 0, 21, 15, 15, 0, 13, 12, 8, 15, 9]"
56,23,83,75,1611,0,74,9,"[1, 3, 2, 0, 0, 1, 3, 0, 1, 3, 2, 2, 2, 1, 0, 3, 3, 3, 1, 1, 3, 2, 2, 0, 1, 3, 0, 3, 1]"
57,23,7,6,1612,0,3,4,"[0, 0, 1, 0, 0, 0, 1, 0, 0, 0, 1, 0, 1, 0, 1, 0, 1, 1, 1, 0, 1, 1, 0, 0, 1, 0, 0, 0, 1]"
58,23,90,86,1616,0,3,87,"[20, 28, 21, 11, 11, 29, 7, 12, 19, 14, 26, 4, 29, 15, 13, 29, 29, 24, 6, 13, 29, 2, 26, 0, 3, 23, 6, 17, 4]"
59,23,50,40,1626,0,35,15,"[4, 0, 1, 2, 0, 1, 0, 3, 1, 1, 3, 3, 2, 1, 4, 1, 5, 1, 2, 1, 5, 0, 5, 0, 0, 4, 0, 5, 5]"
60,23,23,20,1629,0,14,9,"[3, 1, 1, 3, 1, 3, 0, 2, 0, 2, 1, 0, 3, 0, 2, 1, 3, 1, 3, 3, 3, 0, 0, 0, 1, 3, 1, 3, 3]"
61,23,59,48,1640,0,24,35,"[2, 0, 1, 9, 7, 8, 9, 1, 2, 8, 9, 5, 5, 5, 0, 1, 11, 3, 3, 0, 11, 8, 1, 0, 6, 6, 4, 2, 9]"
62,23,97,71,1666,0,27,70,"[22, 23, 22, 9, 13, 15, 7, 5, 6, 19, 16, 21, 8, 0, 3, 2, 23, 11, 9, 22, 23, 19, 16, 0, 0, 7, 3, 6, 1]"
63,23,89,51,1704,0,27,62,"[7, 0, 2, 16, 2, 4, 1, 17, 16, 10, 1, 3, 3, 1, 12, 3, 20, 15, 3, 15, 20, 6, 18, 0, 7, 12, 11, 13, 1]"
64,23,68,67,1705,0,59,9,"[3, 3, 0, 3, 2, 3, 0, 1, 2, 3, 1, 3, 0, 3, 1, 3, 3, 3, 3, 1, 3, 1, 1, 0, 3, 3, 2, 2, 2]"
65,23,34,25,1714,0,9,25,"[3, 5, 7, 7, 1, 1, 2, 5, 2, 8, 8, 7, 2, 0, 5, 8, 8, 2, 0, 1, 8, 3, 3, 0, 0, 7, 1, 0, 5]"
66,23,32,26,1720,0,22,10,"[1, 3, 3, 2, 0, 1, 1, 3, 0, 2, 1, 0, 1, 1, 3, 2, 3, 2, 3, 3, 3, 2, 2, 0, 1, 0, 0, 1, 0]"
67,23,27,17,1730,0,11,16,"[5, 3, 3, 0, 4, 2, 4, 1, 5, 1, 0, 3, 4, 2, 4, 0, 5, 1, 5, 3, 5, 1, 3, 0, 0, 4, 4, 2, 5]"
68,23,4,3,1731,0,0,4,"[0, 0, 1, 1, 1, 0, 1, 1, 1, 1, 1, 1, 1, 1, 1, 0, 1, 1, 1, 1, 1, 1, 0, 0, 0, 0, 0, 0, 0]"
69,23,34,6,1759,0,2,32,"[10, 3, 5, 7, 2, 10, 7, 1, 9, 10, 3, 3, 0, 5, 7, 3, 10, 5, 1, 5, 10, 5, 4, 0, 0, 3, 10, 4, 9]"
70,23,34,14,1779,0,28,6,"[0, 2, 1, 0, 2, 2, 2, 1, 1, 1, 0, 0, 0, 0, 1, 0, 2, 2, 0, 2, 2, 2, 1, 0, 1, 1, 0, 2, 2]"
71,23,1,0,1760,0,0,1,"[0, 0, 0, 0, 0, 0, 0, 0, 0, 0, 0, 0, 0, 0, 0, 0, 0, 0, 0, 0, 0, 0, 0, 0, 0, 0, 0, 0, 0]"
72,23,68,41,1787,0,63,5,"[1, 1, 0, 0, 1, 1, 1, 0, 0, 1, 1, 1, 0, 1, 1, 1, 1, 0, 1, 0, 1, 0, 1, 0, 0, 0, 1, 0, 1]"
73,23,64,26,1825,0,43,21,"[5, 6, 2, 5, 7, 6, 7, 0, 4, 2, 0, 3, 0, 4, 1, 5, 7, 3, 4, 5, 7, 7, 6, 0, 5, 1, 2, 6, 3]"
74,23,52,32,1845,0,43,9,"[1, 3, 1, 2, 0, 3, 1, 3, 3, 0, 3, 2, 3, 1, 1, 1, 3, 2, 0, 0, 3, 1, 0, 0, 1, 3, 1, 0, 3]"
75,23,71,27,1889,0,32,39,"[1, 2, 11, 0, 2, 0, 6, 3, 0, 6, 12, 4, 6, 8, 6, 1, 13, 4, 12, 8, 13, 7, 13, 0, 3, 6, 10, 11, 1]"
76,23,34,27,1896,0,31,3,"[0, 0, 0, 1, 1, 1, 0, 1, 1, 1, 1, 0, 0, 0, 0, 0, 1, 0, 0, 1, 1, 1, 1, 0, 0, 0, 0, 1, 0]"
77,23,77,74,1899,0,73,4,"[1, 0, 0, 1, 1, 1, 0, 0, 1, 1, 0, 1, 1, 0, 1, 1, 1, 1, 0, 0, 1, 0, 1, 0, 0, 0, 0, 0, 0]"
78,23,81,28,1952,0,56,25,"[3, 6, 1, 1, 5, 5, 3, 0, 7, 5, 0, 7, 3, 1, 0, 7, 8, 2, 7, 6, 8, 1, 0, 0, 1, 3, 8, 6, 1]"
79,23,65,15,2002,0,13,52,"[7, 11, 15, 8, 16, 7, 9, 13, 11, 12, 9, 8, 5, 15, 5, 1, 17, 11, 0, 5, 17, 1, 2, 0, 14, 7, 4, 13, 17]"
80,23,15,8,2009,0,0,15,"[2, 1, 1, 2, 4, 3, 0, 3, 5, 2, 2, 0, 2, 5, 5, 4, 5, 4, 3, 0, 5, 1, 5, 0, 2, 0, 0, 1, 2]"
81,23,52,5,2056,0,32,20,"[5, 4, 6, 3, 5, 1, 5, 3, 1, 1, 3, 3, 2, 1, 3, 1, 6, 5, 0, 3, 6, 1, 5, 0, 0, 6, 4, 1, 5]"
82,23,35,17,2074,0,20,15,"[3, 3, 5, 4, 3, 4, 3, 1, 4, 3, 2, 2, 4, 4, 3, 3, 5, 1, 4, 2, 5, 1, 1, 0, 2, 0, 5, 2, 0]"
83,23,80,17,2137,0,70,10,"[3, 0, 2, 2, 2, 1, 1, 2, 0, 0, 0, 0, 2, 3, 0, 3, 3, 3, 0, 0, 3, 1, 0, 0, 3, 0, 2, 3, 3]"
84,23,71,63,2145,0,4,67,"[6, 12, 14, 14, 2, 18, 9, 2, 8, 20, 18, 19, 11, 15, 18, 11, 22, 7, 13, 15, 22, 3, 15, 0, 22, 16, 5, 12, 21]"
85,23,31,5,2171,0,4,27,"[3, 0, 8, 8, 4, 8, 4, 3, 0, 3, 9, 5, 5, 5, 6, 9, 9, 5, 8, 1, 9, 3, 4, 0, 8, 4, 6, 0, 5]"
86,23,78,0,2249,0,48,30,"[6, 5, 9, 2, 6, 5, 3, 3, 9, 5, 2, 1, 7, 10, 6, 1, 10, 6, 7, 4, 10, 1, 5, 0, 6, 3, 0, 7, 0]"
87,23,7,6,2250,0,5,2,"[0, 0, 0, 0, 0, 0, 0, 0, 0, 0, 0, 0, 0, 0, 0, 0, 0, 0, 0, 0, 0, 0, 0, 0, 0, 0, 0, 0, 0]"
88,23,7,0,2257,0,5,2,"[0, 0, 0, 0, 0, 0, 0, 0, 0, 0, 0, 0, 0, 0, 0, 0, 0, 0, 0, 0, 0, 0, 0, 0, 0, 0, 0, 0, 0]"
89,23,34,18,2273,0,28,6,"[1, 2, 2, 1, 1, 0, 1, 0, 1, 0, 1, 2, 0, 1, 1, 0, 2, 1, 2, 0, 2, 0, 0, 0, 0, 1, 0, 1, 0]"
90,23,42,12,2303,0,34,8,"[0, 2, 2, 1, 1, 0, 1, 0, 2, 1, 1, 0, 0, 1, 1, 1, 2, 1, 0, 1, 2, 1, 2, 0, 1, 0, 1, 0, 2]"
91,23,46,33,2316,0,9,37,"[3, 3, 0, 7, 0, 9, 11, 12, 11, 10, 12, 7, 5, 5, 7, 12, 12, 9, 12, 11, 12, 1, 4, 0, 12, 2, 11, 12, 11]"
92,23,57,39,2334,0,14,43,"[5, 4, 11, 5, 7, 14, 2, 8, 4, 11, 5, 11, 8, 14, 7, 13, 14, 7, 12, 9, 14, 11, 13, 0, 1, 4, 6, 7, 13]"
93,23,5,0,2339,0,3,2,"[0, 0, 0, 0, 0, 0, 0, 0, 0, 0, 0, 0, 0, 0, 0, 0, 0, 0, 0, 0, 0, 0, 0, 0, 0, 0, 0, 0, 0]"
94,23,31,11,2359,0,9,22,"[2, 1, 7, 3, 4, 4, 0, 3, 7, 6, 6, 1, 4, 6, 1, 3, 7, 3, 6, 2, 7, 1, 1, 0, 0, 5, 7, 7, 3]"
95,23,86,52,2393,0,3,83,"[12, 4, 21, 18, 25, 2, 1, 14, 10, 5, 0, 8, 2, 13, 23, 2, 27, 19, 22, 3, 27, 21, 2, 0, 21, 13, 0, 11, 2]"
96,23,26,25,2394,0,3,23,"[4, 0, 4, 1, 2, 4, 4, 0, 1, 5, 3, 6, 4, 7, 2, 7, 7, 5, 5, 2, 7, 3, 3, 0, 3, 2, 2, 0, 4]"
97,23,68,34,2428,0,21,47,"[4, 8, 2, 13, 8, 2, 3, 0, 13, 3, 2, 11, 12, 5, 2, 0, 15, 14, 0, 14, 15, 7, 5, 0, 15, 4, 10, 4, 15]"
98,23,94,81,2441,0,23,71,"[16, 8, 22, 8, 8, 4, 20, 9, 16, 18, 7, 19, 6, 13, 23, 8, 23, 6, 11, 15, 23, 6, 19, 0, 1, 7, 1, 21, 7]"
99,23,69,53,2457,0,47,22,"[4, 3, 7, 5, 5, 7, 2, 1, 5, 0, 1, 0, 7, 5, 6, 3, 7, 6, 2, 7, 7, 3, 6, 0, 0, 5, 0, 0, 4]"
100,23,37,4,2490,0,5,32,"[7, 10, 9, 8, 9, 6, 10, 3, 9, 3, 10, 3, 9, 6, 5, 0, 10, 5, 0, 9, 10, 7, 3, 0, 7, 0, 0, 8, 8]"
101,23,19,19,2490,0,16,3,"[0, 1, 0, 1, 0, 0, 1, 1, 0, 0, 0, 0, 0, 0, 1, 0, 1, 0, 1, 0, 1, 1, 0, 0, 1, 1, 0, 0, 1]"
102,23,4,1,2493,0,2,2,"[0, 0, 0, 0, 0, 0, 0, 0, 0, 0, 0, 0, 0, 0, 0, 0, 0, 0, 0, 0, 0, 0, 0, 0, 0, 0, 0, 0, 0]"
103,23,59,13,2539,0,12,47,"[15, 2, 7, 2, 3, 5, 0, 2, 5, 3, 0, 1, 5, 7, 13, 13, 15, 3, 6, 0, 15, 7, 12, 0, 3, 15, 10, 1, 7]"
104,23,57,10,2586,0,50,7,"[1, 0, 1, 2, 0, 2, 0, 1, 2, 0, 1, 2, 0, 0, 2, 0, 2, 1, 1, 2, 2, 1, 2, 0, 1, 0, 2, 0, 0]"
105,23,59,34,2611,0,36,23,"[3, 7, 2, 0, 3, 6, 6, 7, 2, 4, 3, 6, 0, 5, 5, 5, 7, 6, 4, 2, 7, 3, 5, 0, 4, 2, 0, 4, 6]"
106,23,55,27,2639,0,37,18,"[4, 0, 4, 2, 5, 4, 2, 6, 4, 2, 2, 3, 3, 5, 6, 5, 6, 1, 2, 4, 6, 0, 6, 0, 6, 2, 1, 3, 3]"
107,23,49,33,2655,0,42,7,"[0, 0, 1, 2, 0, 1, 1, 0, 2, 2, 1, 1, 0, 1, 0, 0, 2, 1, 2, 1, 2, 2, 0, 0, 0, 1, 1, 0, 2]"
108,23,87,74,2668,0,32,55,"[14, 6, 1, 12, 4, 10, 14, 10, 18, 7, 14, 8, 1, 4, 18, 15, 18, 5, 0, 7, 18, 17, 5, 0, 16, 13, 2, 4, 7]"
109,23,69,62,2675,0,44,25,"[3, 5, 2, 3, 7, 1, 3, 7, 0, 7, 1, 1, 6, 7, 4, 6, 8, 4, 7, 7, 8, 7, 6, 0, 5, 1, 1, 1, 8]"
110,23,12,12,2675,0,9,3,"[0, 1, 0, 1, 1, 0, 0, 1, 0, 1, 0, 1, 1, 1, 0, 0, 1, 1, 0, 1, 1, 0, 0, 0, 0, 1, 1, 1, 1]"
111,23,76,66,2685,0,47,29,"[8, 3, 1, 8, 8, 3, 2, 3, 2, 8, 0, 6, 0, 4, 8, 5, 9, 9, 3, 6, 9, 4, 3, 0, 6, 2, 5, 7, 8]"
112,23,91,37,2739,0,47,44,"[3, 8, 11, 8, 14, 0, 7, 2, 9, 7, 14, 1, 5, 0, 11, 6, 14, 13, 6, 10, 14, 14, 9, 0, 10, 4, 13, 7, 3]"
113,23,18,7,2750,0,12,6,"[2, 2, 2, 0, 1, 0, 1, 1, 2, 0, 2, 0, 2, 2, 0, 1, 2, 1, 2, 1, 2, 1, 0, 0, 2, 1, 0, 2, 2]"
114,23,82,44,2788,0,70,12,"[3, 2, 1, 3, 2, 4, 0, 4, 2, 2, 2, 2, 2, 1, 2, 3, 4, 4, 3, 1, 4, 2, 4, 0, 3, 0, 2, 0, 2]"
115,23,82,28,2842,0,61,21,"[3, 2, 3, 0, 6, 2, 0, 0, 3, 3, 2, 5, 1, 4, 0, 7, 7, 4, 7, 0, 7, 1, 4, 0, 3, 6, 6, 4, 3]"
116,23,39,34,2847,0,29,10,"[3, 0, 0, 0, 1, 0, 1, 3, 3, 3, 3, 0, 2, 3, 3, 0, 3, 2, 2, 0, 3, 2, 1, 0, 0, 2, 0, 3, 1]"
117,23,67,61,2853,0,34,33,"[10, 5, 8, 0, 3, 5, 1, 9, 0, 7, 11, 4, 1, 2, 9, 9, 11, 9, 4, 11, 11, 9, 6, 0, 4, 10, 10, 0, 5]"
118,23,37,18,2872,0,30,7,"[0, 0, 2, 1, 0, 2, 2, 1, 2, 1, 1, 0, 0, 0, 2, 2, 2, 1, 2, 0, 2, 0, 1, 0, 1, 2, 1, 1, 2]"
119,23,12,5,2879,0,0,12,"[1, 0, 2, 0, 4, 1, 2, 1, 1, 2, 1, 2, 4, 3, 0, 0, 4, 4, 1, 1, 4, 1, 4, 0, 2, 3, 0, 1, 4]"
0,24,3601,0,3601,0,865,2736,"[343, 561, 726, 493, 370, 463, 57, 758, 264, 33, 360, 912, 261, 722, 183, 128, 588, 810, 709, 615, 854, 677, 912, 281, 0, 469, 118, 95, 85]"
1,24,3655,957,6299,0,3191,464,"[73, 113, 35, 85, 7, 147, 101, 27, 32, 23, 98, 154, 4, 42, 91, 54, 127, 43, 83, 149, 73, 56, 154, 133, 0, 59, 100, 90, 120]"
2,24,3764,1044,9019,0,3170,594,"[104, 86, 113, 51, 70, 70, 103, 53, 172, 109, 170, 198, 62, 116, 91, 128, 45, 192, 102, 190, 26, 160, 198, 81, 0, 1, 176, 167, 86]"
3,24,4738,6107,7650,0,3978,760,"[230, 9, 17, 58, 148, 76, 60, 69, 148, 26, 120, 253, 190, 250, 42, 107, 56, 235, 57, 248, 29, 102, 253, 166, 0, 88, 239, 12, 253]"
4,24,3676,5737,5589,0,2799,877,"[151, 91, 160, 11, 258, 140, 153, 133, 290, 67, 172, 292, 156, 42, 11, 87, 62, 96, 160, 40, 0, 141, 292, 208, 0, 57, 126, 191, 13]"
5,24,4013,721,8881,0,31,3982,"[274, 88, 1228, 221, 508, 1052, 717, 1056, 929, 1249, 1266, 1327, 644, 1183, 776, 745, 920, 13, 1220, 1266, 779, 850, 1327, 1083, 0, 698, 1208, 889, 391]"
6,24,3311,6111,6081,0,2590,721,"[195, 144, 36, 42, 202, 152, 20, 33, 58, 64, 171, 240, 138, 79, 161, 103, 206, 229, 47, 52, 113, 25, 240, 10, 0, 121, 201, 79, 5]"
7,24,4828,2958,7951,0,3294,1534,"[441, 56, 231, 399, 52, 510, 349, 104, 53, 167, 58, 511, 51, 407, 86, 6, 114, 2, 102, 506, 501, 311, 511, 285, 0, 476, 285, 177, 234]"
8,24,4981,6192,6740,0,624,4357,"[768, 1192, 505, 451, 66, 456, 1022, 899, 399, 384, 102, 1452, 366, 1222, 60, 345, 679, 1309, 862, 1061, 715, 1376, 1452, 1339, 0, 635, 336, 1106, 931]"
9,24,4065,1235,9570,0,1891,2174,"[280, 439, 412, 355, 18, 719, 447, 118, 8, 482, 484, 724, 200, 634, 260, 562, 78, 572, 532, 617, 88, 554, 724, 510, 0, 126, 181, 547, 326]"
10,24,3265,5429,7406,0,1129,2136,"[9, 169, 289, 455, 622, 530, 336, 575, 33, 431, 107, 712, 204, 234, 557, 555, 302, 481, 457, 349, 53, 537, 712, 403, 0, 439, 617, 712, 88]"
11,24,3514,2806,8114,0,1152,2362,"[754, 486, 167, 727, 194, 637, 505, 169, 773, 498, 472, 787, 217, 51, 299, 597, 54, 174, 710, 12, 740, 256, 787, 229, 0, 419, 768, 97, 691]"
12,24,3793,5692,6215,0,282,3511,"[1009, 997, 795, 1103, 170, 259, 996, 1059, 991, 505, 932, 1170, 19, 629, 600, 40, 708, 352, 771, 1065, 571, 262, 1170, 317, 0, 1140, 576, 973, 21]"
13,24,4072,3148,7139,0,2685,1387,"[378, 351, 96, 260, 357, 327, 253, 362, 125, 140, 62, 462, 94, 310, 273, 125, 220, 209, 117, 163, 312, 438, 462, 219, 0, 292, 145, 279, 225]"
14,24,4370,7264,4245,0,1927,2443,"[342, 258, 81, 503, 214, 560, 186, 808, 266, 299, 386, 814, 128, 211, 689, 713, 418, 419, 645, 263, 376, 400, 814, 31, 0, 267, 229, 123, 610]"
15,24,3749,2137,5857,0,396,3353,"[543, 248, 961, 22, 1000, 390, 107, 744, 483, 180, 807, 1117, 53, 656, 79, 747, 970, 945, 238, 16, 210, 767, 1117, 140, 0, 454, 655, 1109, 1064]"
16,24,4055,756,9156,0,299,3756,"[546, 950, 604, 246, 794, 562, 312, 884, 617, 244, 965, 1252, 217, 801, 441, 403, 893, 472, 1117, 57, 376, 740, 1252, 1144, 0, 707, 16, 1184, 326]"
17,24,3634,6350,6440,0,3331,303,"[67, 74, 44, 85, 50, 77, 92, 35, 48, 98, 44, 101, 92, 7, 11, 15, 24, 81, 65, 97, 36, 86, 101, 3, 0, 3, 94, 67, 46]"
18,24,4183,1865,8758,0,3917,266,"[8, 73, 60, 76, 35, 79, 75, 26, 63, 83, 49, 88, 61, 50, 75, 79, 27, 29, 82, 74, 78, 29, 88, 88, 0, 12, 63, 70, 53]"
19,24,4578,5664,7672,0,2157,2421,"[482, 477, 512, 544, 4, 693, 719, 74, 148, 388, 129, 807, 595, 63, 448, 335, 196, 309, 521, 505, 685, 168, 807, 41, 0, 86, 767, 323, 16]"
20,24,4721,6714,5679,0,3950,771,"[41, 176, 118, 99, 130, 7, 113, 66, 191, 108, 252, 257, 125, 41, 217, 219, 14, 173, 121, 167, 208, 200, 257, 84, 0, 43, 50, 205, 205]"
21,24,4672,2374,7977,0,4041,631,"[113, 72, 22, 158, 115, 6, 91, 143, 25, 117, 14, 210, 24, 28, 202, 44, 58, 22, 53, 150, 197, 29, 210, 44, 0, 150, 111, 41, 27]"
22,24,3356,6271,5062,0,3204,152,"[25, 33, 4, 42, 18, 26, 3, 19, 19, 28, 23, 50, 27, 21, 25, 5, 46, 17, 0, 16, 22, 7, 50, 6, 0, 24, 29, 44, 12]"
23,24,3833,1439,7456,0,2510,1323,"[20, 90, 197, 378, 59, 221, 424, 47, 306, 56, 215, 441, 160, 340, 115, 210, 408, 58, 144, 210, 365, 139, 441, 92, 0, 68, 317, 338, 315]"
24,24,3336,1756,9036,0,2076,1260,"[281, 369, 350, 199, 125, 196, 218, 320, 297, 58, 352, 420, 145, 270, 319, 257, 219, 398, 130, 88, 351, 219, 420, 264, 0, 271, 106, 242, 374]"
25,24,3954,6722,6268,0,260,3694,"[660, 29, 676, 590, 583, 637, 1220, 1205, 542, 1043, 987, 1231, 504, 1040, 561, 1069, 390, 1144, 302, 1191, 1072, 396, 1231, 506, 0, 597, 345, 579, 1049]"
26,24,3063,2504,6827,0,2164,899,"[5, 174, 95, 244, 283, 95, 227, 91, 105, 91, 135, 299, 32, 151, 125, 155, 298, 67, 255, 119, 67, 99, 299, 67, 0, 110, 73, 235, 271]"
27,24,4288,5677,5438,0,1278,3010,"[415, 970, 74, 481, 512, 364, 280, 142, 18, 520, 991, 1003, 805, 616, 518, 55, 237, 344, 665, 201, 416, 367, 1003, 953, 0, 625, 528, 806, 233]"
28,24,4674,618,9494,0,4081,593,"[62, 69, 173, 113, 181, 63, 196, 140, 14, 85, 138, 197, 25, 128, 169, 42, 66, 70, 136, 74, 137, 105, 197, 3, 0, 109, 91, 120, 106]"
29,24,3014,7217,5291,0,1751,1263,"[209, 240, 359, 176, 117, 39, 7, 31, 91, 220, 203, 421, 73, 384, 420, 58, 189, 197, 203, 44, 54, 334, 421, 280, 0, 11, 293, 58, 304]"
30,24,3694,1341,7644,0,1714,1980,"[497, 377, 98, 241, 102, 221, 12, 639, 554, 491, 133, 660, 439, 504, 269, 442, 485, 253, 624, 219, 514, 567, 660, 286, 0, 89, 42, 513, 34]"
31,24,4303,5238,6709,0,3484,819,"[27, 203, 43, 63, 240, 8, 75, 34, 26, 217, 25, 273, 123, 193, 175, 170, 52, 259, 161, 216, 108, 246, 273, 166, 0, 203, 108, 208, 74]"
32,24,4023,3276,7456,0,1958,2065,"[302, 562, 42, 187, 496, 21, 363, 645, 243, 123, 14, 688, 119, 665, 470, 648, 590, 273, 294, 323, 618, 315, 688, 18, 0, 635, 656, 207, 176]"
33,24,3954,5064,6346,0,371,3583,"[642, 868, 1042, 1015, 964, 1003, 213, 650, 468, 594, 282, 1194, 1078, 564, 940, 238, 657, 455, 1173, 709, 416, 889, 1194, 865, 0, 1180, 901, 1007, 729]"
34,24,3957,2068,8235,0,564,3393,"[342, 740, 890, 1016, 105, 109, 91, 641, 1093, 953, 504, 1131, 385, 463, 18, 996, 756, 518, 691, 937, 330, 674, 1131, 876, 0, 898, 1099, 1131, 253]"
35,24,3649,7007,4877,0,1156,2493,"[530, 92, 452, 567, 606, 442, 369, 778, 688, 383, 709, 831, 706, 91, 557, 125, 192, 324, 614, 183, 266, 276, 831, 311, 0, 273, 53, 367, 225]"
36,24,4193,2600,6470,0,3776,417,"[128, 117, 138, 85, 105, 88, 10, 87, 125, 122, 99, 139, 21, 115, 5, 38, 9, 130, 37, 69, 13, 27, 139, 11, 0, 112, 49, 135, 85]"
37,24,4390,817,10000,43,307,4083,"[38, 843, 676, 246, 1346, 1291, 1067, 1266, 654, 628, 384, 1361, 45, 893, 1237, 880, 676, 975, 720, 622, 537, 1174, 1361, 1067, 0, 1141, 985, 405, 521]"
38,24,3103,6668,6435,0,963,2140,"[331, 235, 411, 639, 288, 85, 543, 699, 238, 66, 687, 713, 686, 235, 114, 168, 705, 428, 489, 580, 626, 682, 713, 365, 0, 139, 26, 360, 436]"
39,24,4983,7449,3969,0,1367,3616,"[731, 306, 736, 158, 713, 908, 378, 144, 764, 387, 1072, 1205, 734, 208, 1198, 173, 591, 270, 409, 806, 189, 708, 1205, 387, 0, 877, 300, 797, 861]"
40,24,3564,2938,4595,0,2339,1225,"[202, 376, 12, 111, 28, 213, 309, 373, 60, 120, 249, 408, 13, 63, 391, 246, 148, 373, 232, 150, 97, 297, 408, 161, 0, 310, 168, 76, 277]"
41,24,4569,549,8615,0,1257,3312,"[1030, 468, 24, 964, 901, 805, 851, 525, 1054, 246, 561, 1104, 892, 488, 832, 310, 1004, 962, 548, 377, 435, 658, 1104, 316, 0, 219, 686, 21, 578]"
42,24,3778,7067,5326,0,92,3686,"[156, 510, 252, 208, 279, 959, 580, 668, 933, 51, 931, 1228, 1012, 268, 1122, 842, 717, 39, 109, 664, 148, 631, 1228, 209, 0, 420, 227, 1148, 1086]"
43,24,4880,4363,5843,0,2024,2856,"[124, 842, 945, 92, 226, 52, 289, 182, 757, 646, 178, 952, 901, 477, 369, 440, 950, 48, 63, 681, 22, 475, 952, 23, 0, 43, 594, 644, 295]"
44,24,3772,3520,6095,0,2522,1250,"[411, 414, 10, 11, 13, 297, 247, 363, 187, 58, 165, 416, 102, 20, 316, 295, 86, 330, 256, 283, 19, 358, 416, 342, 0, 137, 106, 304, 46]"
45,24,4554,1061,9588,0,2337,2217,"[577, 346, 57, 563, 525, 735, 673, 299, 700, 485, 105, 739, 437, 8, 250, 116, 542, 165, 636, 438, 313, 737, 739, 45, 0, 255, 610, 175, 431]"
46,24,4688,6102,8174,0,2317,2371,"[728, 761, 359, 80, 372, 267, 493, 690, 372, 316, 128, 790, 694, 316, 85, 543, 236, 528, 334, 274, 474, 190, 790, 420, 0, 141, 393, 611, 689]"
47,24,3306,6065,5415,0,1809,1497,"[323, 89, 150, 231, 123, 230, 83, 498, 68, 21, 356, 499, 202, 124, 255, 252, 456, 274, 200, 29, 120, 487, 499, 176, 0, 363, 166, 252, 243]"
48,24,4502,3599,6318,0,2013,2489,"[94, 680, 576, 255, 625, 767, 373, 671, 431, 179, 95, 829, 561, 58, 182, 184, 99, 786, 219, 684, 247, 217, 829, 819, 0, 77, 33, 426, 289]"
49,24,4090,3098,7310,0,1278,2812,"[480, 365, 438, 174, 272, 660, 598, 324, 319, 346, 65, 937, 548, 585, 818, 407, 818, 605, 135, 103, 842, 208, 937, 399, 0, 644, 288, 807, 850]"
50,24,4303,6464,5149,0,2472,1831,"[97, 571, 545, 527, 291, 301, 43, 413, 115, 518, 379, 610, 568, 274, 332, 119, 59, 316, 294, 378, 243, 177, 610, 230, 0, 84, 336, 520, 345]"
51,24,4534,357,9326,0,726,3808,"[309, 1214, 862, 292, 821, 838, 254, 941, 1184, 915, 171, 1269, 771, 792, 1210, 547, 655, 44, 695, 510, 634, 1150, 1269, 877, 0, 1206, 212, 608, 85]"
52,24,3744,5292,7778,0,1000,2744,"[424, 16, 67, 755, 256, 94, 741, 807, 141, 502, 899, 914, 225, 756, 533, 135, 747, 31, 117, 671, 883, 607, 914, 390, 0, 741, 715, 443, 122]"
53,24,4110,7130,4758,0,2033,2077,"[642, 678, 529, 50, 82, 428, 577, 203, 505, 385, 24, 692, 398, 319, 20, 450, 195, 208, 614, 680, 316, 445, 692, 446, 0, 171, 124, 496, 75]"
54,24,3998,2757,5999,0,3027,971,"[223, 134, 213, 319, 71, 24, 281, 245, 215, 159, 133, 323, 165, 251, 133, 260, 60, 112, 268, 247, 268, 105, 323, 102, 0, 178, 302, 31, 213]"
55,24,4651,3206,7444,0,33,4618,"[76, 982, 393, 1070, 1391, 101, 477, 1492, 939, 344, 240, 1539, 1383, 863, 340, 547, 1112, 1205, 1192, 1108, 756, 560, 1539, 730, 0, 51, 363, 22, 889]"
56,24,4508,5193,6759,0,2744,1764,"[131, 25, 509, 516, 61, 240, 306, 481, 56, 404, 60, 588, 13, 318, 124, 288, 308, 157, 29, 443, 230, 305, 588, 245, 0, 330, 380, 533, 541]"
57,24,4962,5942,5779,0,185,4777,"[1096, 855, 1119, 930, 64, 1162, 127, 1525, 653, 581, 629, 1592, 1075, 849, 248, 1316, 894, 1100, 1514, 721, 104, 633, 1592, 197, 0, 289, 122, 206, 1424]"
58,24,4216,2912,7083,0,2328,1888,"[76, 289, 110, 509, 351, 550, 52, 45, 433, 143, 42, 629, 600, 279, 260, 514, 75, 247, 569, 447, 513, 423, 629, 146, 0, 317, 547, 457, 376]"
59,24,4658,6415,5326,0,2290,2368,"[145, 19, 161, 138, 756, 31, 333, 153, 467, 398, 326, 789, 523, 785, 376, 590, 123, 348, 750, 456, 421, 347, 789, 607, 0, 759, 779, 598, 750]"
60,24,3834,2034,7126,0,3646,188,"[59, 5, 30, 0, 17, 23, 35, 12, 54, 46, 16, 62, 51, 40, 56, 16, 48, 62, 60, 53, 62, 17, 62, 19, 0, 10, 33, 12, 15]"
61,24,4115,7260,3981,0,2669,1446,"[215, 79, 356, 351, 3, 68, 419, 403, 83, 224, 12, 482, 22, 393, 239, 220, 324, 296, 209, 218, 104, 161, 482, 335, 0, 207, 278, 110, 212]"
62,24,4120,3143,4958,0,316,3804,"[710, 1043, 826, 1260, 792, 890, 65, 891, 990, 1164, 929, 1268, 477, 902, 882, 337, 1264, 249, 264, 1046, 684, 1096, 1268, 1188, 0, 147, 1079, 1171, 591]"
63,24,4790,142,9606,0,2875,1915,"[404, 460, 547, 555, 616, 374, 227, 621, 355, 520, 636, 638, 352, 40, 372, 622, 10, 312, 513, 7, 372, 182, 638, 77, 0, 406, 528, 135, 476]"
64,24,4302,6762,7146,0,468,3834,"[806, 1076, 242, 921, 275, 710, 940, 1144, 870, 240, 906, 1278, 277, 107, 514, 303, 1221, 1099, 311, 416, 645, 1227, 1278, 874, 0, 96, 1240, 553, 1044]"
65,24,4458,6478,5126,0,1409,3049,"[896, 569, 537, 360, 732, 403, 183, 591, 316, 562, 152, 1016, 399, 828, 248, 376, 603, 38, 898, 252, 790, 924, 1016, 729, 0, 213, 471, 265, 832]"
66,24,4115,770,8471,0,1724,2391,"[256, 458, 528, 87, 452, 31, 675, 146, 414, 136, 491, 797, 630, 398, 363, 681, 564, 147, 237, 474, 187, 782, 797, 743, 0, 287, 495, 283, 515]"
67,24,4308,5943,6836,0,3877,431,"[39, 13, 129, 96, 67, 49, 61, 139, 117, 118, 107, 143, 52, 3, 58, 128, 68, 61, 7, 59, 9, 39, 143, 116, 0, 90, 16, 74, 40]"
68,24,3215,2567,7484,0,2732,483,"[113, 140, 36, 143, 156, 39, 52, 60, 136, 2, 141, 161, 60, 129, 130, 139, 121, 116, 9, 127, 10, 91, 161, 4, 0, 138, 115, 109, 144]"
69,24,4559,5510,6533,0,1686,2873,"[653, 101, 255, 703, 255, 83, 542, 155, 253, 901, 664, 957, 663, 910, 89, 626, 1, 242, 714, 909, 544, 477, 957, 200, 0, 840, 331, 126, 169]"
70,24,3632,2167,7998,0,2784,848,"[27, 19, 269, 98, 183, 112, 128, 198, 34, 25, 112, 282, 41, 136, 83, 261, 179, 76, 63, 173, 34, 202, 282, 247, 0, 125, 176, 179, 30]"
71,24,4029,6812,5215,0,2957,1072,"[324, 280, 89, 310, 13, 29, 53, 19, 247, 84, 308, 357, 72, 283, 84, 161, 194, 60, 294, 126, 158, 10, 357, 294, 0, 233, 23, 98, 4]"
72,24,3862,2806,6271,0,2997,865,"[275, 52, 15, 169, 33, 168, 242, 93, 239, 48, 168, 288, 234, 69, 187, 101, 2, 273, 53, 15, 182, 207, 288, 44, 0, 242, 20, 9, 43]"
73,24,4060,3637,6694,0,3117,943,"[262, 279, 2, 106, 96, 38, 156, 298, 31, 50, 82, 314, 247, 93, 23, 205, 313, 210, 32, 249, 21, 257, 314, 51, 0, 199, 186, 28, 86]"
74,24,3448,1442,8700,0,2190,1258,"[32, 172, 158, 270, 264, 305, 15, 148, 105, 309, 92, 419, 57, 151, 147, 45, 114, 281, 359, 277, 160, 48, 419, 231, 0, 392, 200, 179, 169]"
75,24,3565,5239,7026,0,342,3223,"[116, 968, 228, 0, 1018, 1009, 183, 814, 760, 229, 198, 1074, 304, 621, 598, 935, 318, 32, 989, 222, 971, 159, 1074, 625, 0, 948, 949, 88, 799]"
76,24,4617,5725,5918,0,652,3965,"[739, 956, 604, 1213, 857, 603, 595, 1196, 1297, 1216, 1207, 1321, 378, 900, 1035, 1133, 860, 193, 1281, 896, 376, 856, 1321, 1291, 0, 977, 1300, 357, 588]"
77,24,4936,1292,9562,0,4269,667,"[97, 141, 3, 205, 49, 160, 221, 101, 101, 142, 157, 222, 71, 62, 62, 162, 99, 142, 206, 88, 77, 191, 222, 124, 0, 222, 106, 9, 85]"
78,24,3750,7240,6072,0,425,3325,"[1105, 792, 318, 694, 106, 885, 997, 798, 376, 839, 1014, 1108, 207, 150, 217, 311, 280, 305, 814, 1001, 1097, 544, 1108, 784, 0, 446, 971, 152, 386]"
79,24,4121,2444,7749,0,806,3315,"[1086, 1009, 114, 821, 310, 332, 1105, 699, 833, 63, 104, 1105, 155, 1078, 479, 107, 343, 290, 771, 600, 912, 846, 1105, 1043, 0, 766, 46, 567, 735]"
80,24,3346,5098,5997,0,1888,1458,"[46, 257, 311, 326, 170, 463, 266, 373, 214, 336, 101, 486, 463, 329, 253, 420, 24, 49, 354, 57, 38, 166, 486, 94, 0, 151, 148, 455, 185]"
81,24,4561,3130,7428,0,1735,2826,"[295, 900, 879, 652, 620, 892, 352, 109, 514, 12, 799, 942, 733, 432, 85, 106, 926, 459, 501, 304, 908, 516, 942, 883, 0, 582, 327, 855, 591]"
82,24,4176,5335,6269,0,1102,3074,"[19, 654, 12, 328, 641, 170, 569, 950, 776, 136, 11, 1024, 204, 970, 981, 596, 168, 780, 844, 255, 343, 563, 1024, 482, 0, 776, 291, 267, 865]"
83,24,3499,2030,7738,0,1200,2299,"[353, 70, 278, 256, 646, 360, 631, 485, 655, 613, 163, 766, 211, 16, 690, 132, 386, 433, 415, 630, 268, 76, 766, 566, 0, 382, 232, 333, 580]"
84,24,3203,875,10000,66,443,2760,"[797, 421, 526, 559, 710, 69, 854, 449, 618, 858, 798, 920, 464, 907, 25, 265, 429, 543, 653, 788, 613, 706, 920, 872, 0, 122, 384, 52, 42]"
85,24,4348,6438,7910,0,2677,1671,"[23, 157, 5, 231, 274, 28, 427, 385, 425, 325, 418, 557, 287, 538, 24, 396, 79, 500, 35, 7, 403, 534, 557, 142, 0, 177, 138, 130, 40]"
86,24,3828,5417,6321,0,463,3365,"[302, 141, 849, 555, 1040, 279, 475, 121, 1112, 249, 566, 1121, 472, 1050, 814, 963, 536, 1064, 870, 93, 768, 118, 1121, 156, 0, 792, 705, 848, 26]"
87,24,4554,172,10000,703,2625,1929,"[323, 336, 580, 335, 595, 622, 595, 264, 562, 144, 232, 643, 585, 394, 268, 7, 34, 126, 68, 343, 165, 467, 643, 291, 0, 436, 247, 298, 131]"
88,24,4259,6113,8146,0,2031,2228,"[512, 237, 180, 741, 414, 235, 494, 637, 183, 80, 736, 742, 177, 44, 219, 347, 321, 654, 208, 581, 131, 68, 742, 593, 0, 730, 163, 454, 586]"
89,24,4509,7431,5224,0,486,4023,"[761, 928, 1267, 1172, 234, 1037, 1155, 1145, 1264, 664, 1126, 1341, 369, 597, 812, 748, 710, 804, 463, 230, 813, 455, 1341, 887, 0, 1313, 1165, 406, 630]"
90,24,3779,3772,5231,0,644,3135,"[600, 893, 444, 980, 126, 154, 438, 1001, 303, 413, 748, 1045, 575, 638, 49, 671, 157, 183, 577, 260, 977, 949, 1045, 1000, 0, 256, 451, 516, 171]"
91,24,4695,3602,6324,0,2418,2277,"[153, 266, 560, 604, 393, 444, 121, 607, 409, 718, 602, 759, 650, 479, 619, 371, 9, 184, 590, 307, 720, 34, 759, 309, 0, 354, 698, 686, 215]"
92,24,3372,688,9008,0,1317,2055,"[77, 438, 649, 416, 656, 377, 388, 333, 122, 437, 255, 685, 82, 39, 99, 498, 141, 543, 453, 665, 620, 279, 685, 60, 0, 649, 151, 571, 153]"
93,24,4739,6659,7088,0,1852,2887,"[792, 755, 917, 573, 311, 604, 627, 650, 777, 160, 237, 962, 22, 953, 701, 714, 214, 552, 489, 912, 24, 952, 962, 512, 0, 631, 875, 91, 923]"
94,24,4828,5763,6153,0,1092,3736,"[1161, 1173, 1168, 93, 739, 27, 939, 428, 919, 497, 424, 1245, 307, 122, 41, 801, 288, 681, 489, 505, 621, 821, 1245, 1143, 0, 236, 783, 1201, 576]"
95,24,3562,2070,7645,0,2465,1097,"[151, 219, 53, 56, 171, 104, 304, 159, 105, 136, 39, 365, 230, 299, 266, 258, 182, 157, 106, 255, 188, 74, 365, 20, 0, 120, 206, 62, 90]"
96,24,4419,7246,4818,0,636,3783,"[1244, 645, 412, 1147, 2, 565, 355, 716, 1199, 928, 251, 1261, 1117, 1249, 36, 162, 502, 307, 366, 331, 492, 1200, 1261, 211, 0, 270, 523, 257, 1220]"
97,24,3399,2533,5684,0,3240,159,"[1, 36, 33, 6, 41, 21, 33, 7, 6, 18, 15, 53, 29, 51, 32, 44, 40, 52, 26, 37, 32, 34, 53, 22, 0, 21, 40, 5, 48]"
98,24,4207,1601,8290,0,1803,2404,"[669, 317, 330, 282, 125, 234, 743, 526, 516, 798, 616, 801, 724, 611, 471, 724, 36, 691, 668, 571, 138, 781, 801, 297, 0, 417, 0, 467, 653]"
99,24,4842,6541,6591,0,451,4391,"[1281, 1150, 206, 971, 76, 971, 1255, 537, 1202, 1193, 291, 1463, 715, 401, 417, 1052, 701, 1018, 1321, 870, 935, 451, 1463, 982, 0, 179, 606, 1225, 1448]"
100,24,3039,932,8698,0,1074,1965,"[14, 563, 386, 221, 205, 327, 609, 146, 567, 559, 554, 655, 441, 300, 621, 205, 612, 289, 180, 565, 149, 531, 655, 550, 0, 223, 396, 633, 286]"
101,24,3853,6216,6335,0,3662,191,"[50, 19, 32, 56, 16, 3, 2, 61, 36, 16, 38, 63, 29, 61, 20, 21, 42, 32, 48, 45, 37, 47, 63, 25, 0, 61, 32, 22, 37]"
102,24,3074,336,9073,0,1423,1651,"[397, 118, 455, 443, 384, 505, 234, 483, 24, 171, 87, 550, 462, 474, 367, 37, 42, 464, 123, 403, 351, 277, 550, 144, 0, 524, 121, 489, 455]"
103,24,4084,5689,7468,0,745,3339,"[259, 697, 750, 389, 314, 705, 691, 517, 441, 576, 72, 1113, 165, 503, 629, 114, 1004, 1029, 81, 54, 808, 419, 1113, 487, 0, 864, 350, 530, 965]"
104,24,3662,6370,4760,0,2742,920,"[43, 74, 118, 10, 180, 88, 260, 196, 86, 143, 57, 306, 160, 260, 296, 242, 185, 22, 270, 102, 62, 281, 306, 302, 0, 270, 36, 240, 120]"
105,24,3194,1163,6791,0,2853,341,"[55, 99, 56, 5, 9, 38, 70, 107, 98, 95, 54, 113, 98, 9, 41, 68, 82, 28, 48, 21, 94, 16, 113, 29, 0, 13, 82, 33, 44]"
106,24,4869,6170,5490,0,1289,3580,"[1008, 1079, 745, 971, 1118, 212, 1012, 719, 858, 163, 528, 1193, 771, 1024, 285, 827, 523, 902, 390, 932, 205, 712, 1193, 972, 0, 48, 471, 1023, 375]"
107,24,4362,3846,6006,0,655,3707,"[356, 65, 194, 678, 1006, 833, 374, 274, 672, 344, 1156, 1235, 984, 823, 569, 615, 1194, 1036, 1225, 1013, 893, 1105, 1235, 277, 0, 652, 516, 853, 832]"
108,24,3393,1611,7788,0,793,2600,"[245, 526, 827, 474, 313, 340, 180, 732, 569, 285, 662, 866, 658, 387, 520, 761, 595, 628, 493, 600, 534, 502, 866, 438, 0, 213, 124, 477, 321]"
109,24,4742,7220,5310,0,3405,1337,"[147, 209, 389, 377, 394, 100, 166, 243, 255, 364, 24, 445, 83, 117, 142, 439, 444, 100, 157, 429, 155, 372, 445, 275, 0, 145, 180, 319, 25]"
110,24,3222,1959,6573,0,2370,852,"[22, 51, 61, 246, 113, 212, 56, 283, 136, 236, 25, 284, 33, 148, 228, 191, 147, 149, 205, 271, 17, 158, 284, 112, 0, 205, 125, 223, 216]"
111,24,4225,3882,6916,0,2572,1653,"[406, 406, 511, 294, 207, 226, 338, 151, 72, 358, 493, 551, 261, 399, 309, 224, 10, 205, 299, 366, 253, 20, 551, 441, 0, 175, 221, 226, 408]"
112,24,3463,1141,9238,0,1739,1724,"[304, 57, 227, 373, 199, 425, 546, 343, 164, 324, 47, 574, 456, 549, 492, 468, 93, 94, 250, 549, 112, 552, 574, 179, 0, 477, 455, 122, 141]"
113,24,3248,5687,6799,0,2660,588,"[126, 50, 123, 11, 194, 34, 4, 16, 117, 42, 137, 196, 102, 127, 114, 119, 113, 189, 59, 102, 123, 159, 196, 86, 0, 123, 104, 86, 46]"
114,24,4760,6197,5362,0,1176,3584,"[519, 833, 964, 248, 32, 864, 152, 1026, 1069, 1088, 693, 1194, 137, 643, 1029, 1169, 428, 1186, 1106, 616, 28, 89, 1194, 1160, 0, 850, 39, 245, 775]"
115,24,3474,2867,5969,0,1200,2274,"[6, 122, 480, 717, 264, 311, 101, 395, 208, 505, 565, 758, 161, 280, 435, 503, 283, 263, 301, 90, 194, 222, 758, 631, 0, 237, 358, 541, 97]"
116,24,4893,1035,9827,0,1480,3413,"[514, 1060, 1052, 842, 430, 287, 909, 263, 831, 447, 73, 1137, 187, 20, 871, 1065, 284, 744, 803, 928, 776, 1118, 1137, 436, 0, 697, 777, 59, 1064]"
117,24,4404,7273,6958,0,4313,91,"[16, 4, 28, 14, 3, 25, 27, 4, 14, 2, 26, 30, 3, 27, 19, 26, 28, 19, 15, 6, 3, 22, 30, 5, 0, 0, 19, 16, 30]"
118,24,4821,7449,4330,0,2712,2109,"[37, 696, 497, 188, 599, 93, 496, 695, 341, 392, 112, 703, 579, 657, 180, 509, 137, 700, 560, 357, 544, 291, 703, 643, 0, 695, 504, 4, 617]"
119,24,3116,214,7232,0,1652,1464,"[245, 381, 435, 75, 306, 156, 177, 342, 9, 329, 209, 488, 476, 354, 102, 455, 279, 292, 215, 194, 156, 235, 488, 103, 0, 396, 52, 374, 259]"
0,25,4905,0,4905,0,4352,553,"[70, 136, 44, 29, 36, 148, 75, 155, 73, 47, 40, 30, 184, 34, 35, 120, 9, 109, 88, 87, 84, 171, 86, 68, 28, 0, 12, 10, 184]"
1,25,4923,171,9657,0,4579,344,"[29, 61, 66, 8, 59, 110, 71, 83, 100, 71, 91, 83, 114, 39, 21, 23, 24, 56, 67, 4, 107, 72, 18, 18, 107, 0, 102, 67, 114]"
2,25,4069,7003,6723,0,1721,2348,"[41, 299, 201, 650, 324, 232, 274, 417, 530, 287, 676, 398, 782, 779, 247, 660, 601, 610, 260, 678, 362, 360, 78, 145, 368, 0, 574, 16, 782]"
3,25,4926,7257,4392,0,3141,1785,"[571, 67, 552, 317, 558, 561, 568, 554, 587, 180, 384, 95, 595, 454, 527, 220, 249, 453, 148, 519, 393, 259, 103, 39, 301, 0, 1, 325, 595]"
4,25,4718,1177,7933,0,959,3759,"[514, 307, 161, 725, 962, 175, 462, 856, 21, 1106, 461, 84, 1253, 895, 726, 293, 427, 528, 542, 232, 366, 12, 64, 1148, 1140, 0, 1094, 201, 1253]"
5,25,4537,6108,6362,0,1752,2785,"[83, 717, 852, 644, 412, 658, 415, 919, 297, 274, 286, 420, 928, 149, 529, 729, 88, 170, 683, 610, 393, 95, 331, 472, 767, 0, 63, 869, 928]"
6,25,3889,2201,8050,0,2780,1109,"[346, 25, 278, 160, 212, 328, 129, 48, 168, 130, 247, 128, 369, 123, 131, 287, 215, 27, 57, 149, 178, 163, 307, 104, 169, 0, 334, 119, 369]"
7,25,3474,5119,6405,0,656,2818,"[669, 14, 756, 13, 131, 679, 893, 72, 422, 867, 801, 523, 939, 498, 795, 396, 900, 90, 146, 638, 419, 832, 816, 190, 907, 0, 916, 770, 939]"
8,25,4751,7498,3658,0,1344,3407,"[993, 869, 766, 842, 391, 522, 465, 230, 352, 163, 479, 709, 1135, 418, 839, 461, 633, 767, 982, 640, 810, 423, 761, 164, 714, 0, 456, 1129, 1135]"
9,25,4545,3151,5052,0,2885,1660,"[273, 471, 2, 366, 24, 458, 217, 515, 97, 331, 415, 96, 553, 226, 213, 373, 247, 321, 243, 402, 313, 393, 417, 472, 460, 0, 524, 392, 553]"
10,25,3713,3387,5378,0,217,3496,"[18, 331, 789, 835, 625, 344, 86, 208, 755, 806, 1124, 375, 1165, 893, 926, 399, 778, 807, 500, 180, 880, 395, 399, 503, 294, 0, 1059, 796, 1165]"
11,25,4092,3027,6443,0,3333,759,"[65, 14, 22, 41, 63, 14, 154, 21, 156, 191, 207, 63, 253, 93, 174, 0, 60, 8, 88, 212, 127, 150, 28, 92, 233, 0, 198, 92, 253]"
12,25,4762,5206,5999,0,2223,2539,"[697, 97, 836, 319, 262, 631, 440, 149, 393, 802, 18, 639, 846, 211, 662, 516, 729, 392, 85, 94, 37, 504, 503, 438, 702, 0, 211, 357, 846]"
13,25,4793,539,10000,253,4350,443,"[129, 78, 103, 23, 0, 51, 17, 129, 136, 118, 88, 113, 147, 29, 94, 79, 11, 31, 93, 74, 93, 18, 4, 54, 6, 0, 137, 127, 147]"
14,25,3739,5891,7848,0,243,3496,"[548, 292, 393, 590, 845, 811, 641, 443, 336, 350, 14, 430, 1165, 1081, 1059, 683, 277, 153, 207, 768, 446, 22, 250, 254, 252, 0, 452, 851, 1165]"
15,25,3880,6823,4905,0,1697,2183,"[537, 582, 188, 592, 572, 25, 486, 566, 103, 187, 558, 597, 727, 429, 445, 553, 489, 72, 404, 65, 128, 282, 714, 552, 113, 0, 489, 483, 727]"
16,25,4989,1150,8744,0,497,4492,"[3, 519, 528, 214, 742, 1260, 965, 416, 891, 1258, 1183, 648, 1497, 692, 696, 277, 189, 130, 1496, 828, 36, 375, 431, 1225, 217, 0, 1235, 685, 1497]"
17,25,4361,6160,6945,0,90,4271,"[1052, 113, 531, 1051, 478, 304, 417, 1241, 1301, 1135, 821, 655, 1423, 959, 514, 739, 482, 698, 753, 813, 326, 1329, 448, 503, 447, 0, 12, 1284, 1423]"
18,25,3554,710,9789,0,105,3449,"[618, 65, 9, 134, 322, 313, 650, 765, 889, 719, 75, 123, 1149, 468, 1002, 436, 987, 228, 574, 825, 500, 1132, 470, 702, 715, 0, 966, 696, 1149]"
19,25,3954,5956,7787,0,1160,2794,"[466, 585, 769, 562, 795, 862, 258, 801, 108, 832, 226, 437, 931, 143, 588, 155, 909, 41, 544, 473, 811, 448, 367, 148, 454, 0, 771, 301, 931]"
20,25,4720,5959,6548,0,2549,2171,"[13, 121, 286, 622, 324, 521, 257, 570, 386, 172, 602, 146, 723, 492, 78, 132, 509, 291, 495, 55, 594, 69, 705, 309, 487, 0, 618, 432, 723]"
21,25,4922,6422,5048,0,562,4360,"[1014, 366, 789, 1112, 249, 79, 830, 1188, 344, 96, 147, 1053, 1453, 383, 721, 814, 1115, 236, 523, 1449, 1199, 246, 729, 183, 602, 0, 251, 405, 1453]"
22,25,4145,3224,5969,0,3148,997,"[53, 199, 108, 323, 144, 61, 116, 84, 137, 48, 151, 164, 332, 266, 254, 189, 103, 174, 332, 245, 227, 243, 288, 201, 36, 0, 204, 114, 332]"
23,25,4846,302,10000,513,3326,1520,"[254, 278, 278, 304, 135, 486, 61, 343, 60, 172, 398, 274, 506, 430, 28, 105, 291, 309, 158, 429, 336, 360, 364, 333, 314, 0, 10, 478, 506]"
24,25,3387,6507,6880,0,397,2990,"[493, 562, 182, 962, 40, 543, 856, 825, 702, 784, 98, 838, 996, 478, 297, 456, 499, 608, 455, 489, 690, 462, 613, 181, 463, 0, 606, 406, 996]"
25,25,3117,2765,7232,0,2550,567,"[87, 52, 181, 72, 24, 16, 58, 67, 173, 170, 115, 151, 189, 105, 83, 106, 69, 80, 61, 171, 40, 23, 29, 69, 166, 0, 73, 72, 189]"
26,25,4640,5461,6411,0,1959,2681,"[176, 674, 428, 230, 407, 168, 411, 209, 852, 740, 38, 653, 893, 691, 50, 477, 0, 163, 63, 337, 169, 668, 496, 533, 142, 0, 442, 337, 893]"
27,25,4933,7196,4148,0,761,4172,"[806, 613, 602, 135, 15, 390, 1064, 875, 182, 1305, 1183, 555, 1390, 594, 323, 834, 839, 672, 1072, 1310, 518, 1291, 245, 209, 764, 0, 282, 1083, 1390]"
28,25,4359,4161,4346,0,4125,234,"[57, 17, 5, 22, 61, 73, 37, 44, 68, 41, 4, 39, 78, 43, 72, 21, 52, 34, 41, 2, 27, 3, 16, 69, 70, 0, 75, 20, 78]"
29,25,3040,1967,5419,0,3028,12,"[3, 1, 1, 4, 0, 1, 3, 4, 3, 3, 1, 3, 4, 3, 2, 3, 4, 2, 3, 3, 2, 3, 1, 0, 3, 0, 1, 4, 4]"
30,25,3558,2898,6079,0,437,3121,"[99, 977, 704, 883, 906, 1039, 915, 213, 647, 44, 874, 207, 1040, 1028, 309, 116, 49, 283, 240, 468, 452, 552, 453, 688, 769, 0, 893, 402, 1040]"
31,25,3504,3450,6133,0,260,3244,"[944, 9, 610, 248, 770, 127, 196, 918, 170, 147, 774, 615, 1081, 562, 301, 694, 298, 488, 926, 419, 910, 1066, 623, 1018, 1068, 0, 60, 495, 1081]"
32,25,4187,916,9404,0,1169,3018,"[938, 804, 663, 622, 750, 948, 914, 225, 643, 72, 561, 284, 1006, 255, 116, 268, 740, 528, 560, 899, 222, 985, 622, 585, 202, 0, 366, 1003, 1006]"
33,25,3439,6588,6255,0,1240,2199,"[354, 621, 402, 176, 460, 723, 196, 716, 651, 383, 297, 252, 733, 39, 83, 646, 181, 664, 135, 285, 306, 698, 499, 483, 335, 0, 244, 82, 733]"
34,25,4785,7499,3541,0,1879,2906,"[925, 541, 278, 56, 202, 325, 269, 907, 286, 94, 580, 231, 968, 666, 171, 211, 829, 793, 557, 322, 493, 660, 623, 164, 367, 0, 967, 255, 968]"
35,25,3194,1905,4830,0,1485,1709,"[311, 208, 340, 180, 73, 14, 391, 390, 197, 220, 293, 531, 569, 46, 403, 398, 314, 469, 192, 567, 97, 383, 455, 59, 54, 0, 297, 148, 569]"
36,25,4479,248,9061,0,4048,431,"[33, 69, 123, 88, 2, 119, 41, 19, 111, 112, 27, 17, 143, 98, 45, 33, 82, 127, 128, 70, 70, 46, 42, 97, 127, 0, 123, 143, 143]"
37,25,4750,5871,7940,0,3209,1541,"[242, 50, 477, 480, 137, 102, 478, 246, 282, 496, 324, 39, 513, 484, 208, 370, 129, 466, 226, 507, 257, 153, 152, 266, 239, 0, 155, 34, 513]"
38,25,4896,7475,5361,0,3769,1127,"[326, 280, 129, 160, 279, 290, 185, 142, 316, 89, 124, 195, 375, 68, 284, 31, 116, 213, 350, 89, 162, 61, 30, 313, 92, 0, 186, 53, 375]"
39,25,4480,2645,7196,0,74,4406,"[718, 1333, 1117, 1159, 1454, 542, 1119, 1442, 90, 250, 1375, 155, 1468, 1293, 220, 786, 359, 1043, 194, 267, 954, 150, 1380, 1185, 887, 0, 636, 815, 1468]"
40,25,3891,5754,5333,0,2939,952,"[245, 281, 109, 299, 7, 180, 275, 300, 11, 109, 92, 225, 317, 261, 115, 155, 203, 162, 122, 248, 185, 91, 216, 228, 72, 0, 57, 57, 317]"
41,25,4204,896,8641,0,512,3692,"[476, 292, 112, 745, 908, 651, 251, 136, 512, 1182, 571, 669, 1230, 158, 1123, 1105, 611, 902, 350, 628, 546, 1113, 470, 591, 554, 0, 902, 873, 1230]"
42,25,4082,6620,6103,0,2034,2048,"[502, 279, 114, 664, 200, 127, 372, 353, 109, 1, 160, 110, 682, 13, 552, 9, 397, 672, 135, 645, 652, 119, 382, 55, 443, 0, 11, 273, 682]"
43,25,3304,1448,7959,0,301,3003,"[921, 544, 787, 210, 508, 259, 445, 326, 6, 940, 712, 362, 1001, 378, 980, 447, 736, 131, 236, 211, 149, 551, 46, 399, 748, 0, 523, 615, 1001]"
44,25,4361,6465,5855,0,1702,2659,"[310, 35, 845, 582, 314, 246, 708, 89, 215, 757, 18, 151, 886, 420, 727, 111, 316, 368, 381, 631, 680, 172, 596, 838, 14, 0, 327, 668, 886]"
45,25,4247,2511,7591,0,3582,665,"[16, 32, 96, 101, 92, 176, 133, 4, 12, 89, 116, 151, 221, 44, 144, 114, 51, 160, 183, 93, 68, 132, 60, 45, 135, 0, 90, 42, 221]"
46,25,3341,826,10000,106,1988,1353,"[127, 106, 277, 246, 96, 116, 411, 35, 106, 278, 123, 310, 451, 66, 180, 3, 403, 58, 123, 244, 248, 236, 252, 94, 86, 0, 59, 167, 451]"
47,25,4577,5685,8892,0,402,4175,"[321, 1143, 542, 84, 1063, 107, 852, 1302, 398, 799, 1160, 1159, 1391, 733, 391, 894, 1154, 511, 1266, 1278, 824, 51, 495, 1276, 124, 0, 94, 697, 1391]"
48,25,3926,5728,7090,0,3546,380,"[87, 99, 26, 44, 18, 88, 11, 78, 30, 58, 76, 60, 126, 107, 75, 11, 102, 65, 43, 40, 100, 55, 118, 53, 84, 0, 81, 17, 126]"
49,25,4687,5971,5806,0,1895,2792,"[42, 298, 738, 294, 155, 36, 825, 529, 316, 910, 857, 242, 930, 436, 118, 555, 902, 563, 10, 743, 796, 500, 128, 65, 86, 0, 123, 676, 930]"
50,25,3733,2020,7519,0,423,3310,"[410, 777, 286, 310, 1006, 973, 465, 363, 42, 198, 427, 1046, 1103, 193, 377, 197, 287, 906, 767, 926, 967, 527, 324, 331, 843, 0, 341, 690, 1103]"
51,25,4815,6674,5660,0,3045,1770,"[137, 343, 196, 355, 250, 137, 428, 376, 118, 242, 107, 14, 590, 63, 489, 218, 26, 278, 427, 263, 311, 39, 573, 51, 204, 0, 246, 318, 590]"
52,25,4929,1183,9406,0,2802,2127,"[156, 524, 127, 411, 215, 664, 610, 10, 152, 640, 28, 621, 709, 353, 272, 227, 362, 322, 35, 282, 391, 533, 136, 84, 286, 0, 657, 638, 709]"
53,25,4305,7393,6318,0,904,3401,"[120, 480, 335, 901, 99, 664, 737, 585, 623, 961, 362, 722, 1133, 501, 69, 458, 885, 494, 1034, 1128, 393, 396, 553, 359, 497, 0, 78, 317, 1133]"
54,25,4500,2596,8222,0,2377,2123,"[675, 607, 634, 192, 281, 412, 513, 345, 615, 614, 84, 105, 707, 32, 197, 160, 380, 156, 411, 633, 312, 58, 528, 78, 516, 0, 31, 386, 707]"
55,25,3179,5150,6251,0,2921,258,"[51, 70, 84, 35, 32, 14, 45, 59, 22, 44, 31, 17, 86, 2, 75, 83, 41, 23, 58, 2, 79, 34, 46, 72, 28, 0, 48, 83, 86]"
56,25,3740,2584,7407,0,660,3080,"[390, 814, 858, 158, 910, 454, 480, 43, 103, 224, 178, 689, 1026, 640, 557, 583, 992, 59, 289, 418, 35, 128, 266, 34, 303, 0, 924, 334, 1026]"
57,25,4893,6647,5653,0,4555,338,"[89, 98, 40, 46, 78, 15, 103, 83, 90, 38, 81, 18, 112, 80, 61, 50, 20, 51, 102, 44, 5, 3, 78, 112, 92, 0, 67, 64, 112]"
58,25,3115,1564,7204,0,2140,975,"[258, 161, 177, 110, 151, 46, 257, 141, 252, 175, 318, 175, 325, 307, 131, 182, 157, 138, 25, 33, 186, 232, 162, 90, 300, 0, 148, 299, 325]"
59,25,4045,5511,5738,0,800,3245,"[815, 120, 807, 141, 644, 305, 1009, 884, 177, 767, 438, 110, 1081, 533, 678, 688, 689, 876, 577, 53, 759, 709, 360, 95, 799, 0, 307, 304, 1081]"
60,25,3270,1496,7512,0,38,3232,"[811, 412, 548, 1024, 1057, 949, 795, 111, 40, 780, 1063, 664, 1077, 428, 322, 226, 382, 91, 437, 847, 107, 238, 255, 384, 83, 0, 230, 168, 1077]"
61,25,3325,3021,7816,0,1723,1602,"[117, 46, 52, 344, 398, 13, 250, 56, 252, 403, 342, 519, 534, 212, 392, 157, 424, 57, 169, 246, 309, 530, 393, 372, 321, 0, 383, 305, 534]"
62,25,3364,5521,5659,0,1075,2289,"[478, 430, 324, 230, 295, 674, 556, 79, 356, 636, 162, 169, 763, 292, 525, 61, 225, 395, 272, 283, 444, 155, 62, 186, 758, 0, 679, 153, 763]"
63,25,3324,260,8723,0,441,2883,"[830, 844, 443, 179, 43, 686, 956, 98, 666, 597, 35, 675, 961, 472, 318, 743, 951, 917, 31, 206, 388, 533, 670, 910, 4, 0, 141, 207, 961]"
64,25,4321,5401,7643,0,1378,2943,"[815, 52, 238, 230, 711, 47, 905, 814, 253, 324, 466, 770, 981, 747, 711, 665, 346, 739, 210, 878, 588, 206, 694, 610, 952, 0, 498, 473, 981]"
65,25,4005,7029,4619,0,3674,331,"[26, 13, 18, 28, 110, 47, 104, 17, 0, 61, 67, 79, 110, 41, 76, 90, 93, 48, 72, 54, 102, 44, 81, 33, 68, 0, 69, 65, 110]"
66,25,4572,881,8310,0,2120,2452,"[163, 541, 773, 278, 487, 50, 576, 790, 49, 144, 741, 517, 817, 36, 359, 814, 417, 555, 490, 81, 786, 488, 359, 611, 652, 0, 618, 262, 817]"
67,25,3787,7129,4968,0,1528,2259,"[406, 589, 631, 141, 345, 402, 420, 179, 390, 274, 677, 752, 753, 727, 517, 418, 204, 42, 728, 455, 498, 165, 584, 236, 566, 0, 499, 526, 753]"
68,25,3067,384,7651,0,776,2291,"[695, 334, 643, 564, 69, 704, 333, 243, 621, 155, 749, 307, 763, 20, 705, 79, 666, 119, 331, 441, 134, 101, 634, 511, 642, 0, 180, 651, 763]"
69,25,4038,7049,4640,0,1604,2434,"[692, 28, 181, 715, 522, 664, 691, 402, 341, 225, 725, 517, 811, 76, 571, 567, 467, 190, 765, 557, 781, 430, 396, 702, 675, 0, 200, 530, 811]"
70,25,4688,70,9258,0,2842,1846,"[172, 118, 459, 154, 428, 550, 28, 509, 568, 351, 166, 122, 615, 260, 593, 200, 288, 504, 405, 122, 125, 218, 162, 450, 416, 0, 49, 153, 615]"
71,25,3563,5426,7395,0,2987,576,"[77, 5, 58, 72, 181, 21, 143, 40, 112, 37, 29, 118, 192, 171, 64, 104, 45, 151, 47, 61, 180, 138, 73, 67, 17, 0, 175, 5, 192]"
72,25,4588,7138,4845,0,1075,3513,"[835, 988, 392, 200, 811, 567, 271, 341, 534, 658, 444, 822, 1171, 601, 416, 165, 208, 608, 419, 232, 910, 18, 690, 769, 1161, 0, 576, 859, 1171]"
73,25,4333,767,8411,0,2959,1374,"[453, 425, 312, 266, 344, 414, 429, 197, 75, 440, 219, 21, 458, 357, 456, 171, 282, 275, 73, 150, 346, 13, 95, 3, 131, 0, 119, 259, 458]"
74,25,4474,5601,7284,0,2423,2051,"[136, 85, 193, 358, 450, 415, 221, 462, 228, 320, 95, 26, 683, 590, 90, 72, 612, 633, 287, 157, 90, 551, 108, 336, 122, 0, 91, 537, 683]"
75,25,4197,5852,5629,0,3631,566,"[107, 9, 0, 47, 15, 157, 147, 187, 76, 44, 149, 67, 188, 52, 170, 17, 37, 75, 4, 117, 127, 112, 76, 20, 48, 0, 95, 175, 188]"
76,25,3791,2045,7375,0,2911,880,"[127, 138, 200, 230, 192, 178, 144, 249, 111, 89, 20, 32, 293, 150, 211, 108, 171, 44, 268, 104, 167, 282, 262, 21, 51, 0, 185, 82, 293]"
77,25,3478,1911,8942,0,562,2916,"[742, 786, 751, 795, 596, 89, 710, 481, 366, 221, 754, 269, 972, 499, 663, 456, 505, 780, 221, 518, 214, 8, 819, 439, 597, 0, 285, 211, 972]"
78,25,3922,5538,7326,0,3072,850,"[106, 20, 176, 73, 235, 116, 155, 29, 91, 228, 159, 175, 283, 107, 62, 142, 227, 109, 59, 99, 129, 228, 232, 159, 116, 0, 188, 238, 283]"
79,25,4986,5052,7260,0,948,4038,"[1157, 856, 781, 806, 729, 183, 204, 1074, 1234, 1121, 897, 839, 1346, 193, 760, 1269, 546, 322, 580, 1259, 1278, 1222, 828, 1053, 1313, 0, 249, 119, 1346]"
80,25,3422,202,10000,480,3185,237,"[74, 73, 58, 29, 41, 41, 79, 73, 71, 57, 72, 43, 79, 27, 3, 15, 20, 55, 38, 78, 32, 70, 43, 62, 69, 0, 65, 7, 79]"
81,25,3831,6668,7163,0,646,3185,"[425, 838, 356, 1046, 240, 122, 843, 312, 765, 170, 71, 718, 1061, 316, 167, 962, 205, 100, 693, 145, 671, 351, 256, 859, 192, 0, 148, 542, 1061]"
82,25,3917,5223,5857,0,2899,1018,"[3, 35, 133, 225, 113, 200, 261, 238, 284, 235, 285, 97, 339, 40, 192, 330, 325, 188, 49, 49, 336, 202, 283, 117, 144, 0, 21, 312, 339]"
83,25,4523,4521,5859,0,3231,1292,"[125, 11, 422, 220, 280, 223, 388, 189, 227, 268, 36, 322, 430, 418, 401, 390, 131, 3, 66, 315, 411, 132, 328, 172, 177, 0, 28, 128, 430]"
84,25,4803,4757,5905,0,1280,3523,"[303, 753, 642, 1064, 737, 978, 457, 865, 400, 701, 195, 555, 1174, 603, 744, 69, 1157, 924, 1050, 1026, 540, 1148, 390, 690, 1020, 0, 1109, 335, 1174]"
85,25,4148,785,9268,0,1693,2455,"[716, 492, 203, 758, 792, 30, 243, 315, 452, 591, 673, 367, 818, 256, 681, 401, 313, 182, 178, 280, 14, 257, 508, 290, 355, 0, 387, 287, 818]"
86,25,3878,6431,6715,0,1031,2847,"[605, 784, 693, 236, 659, 305, 13, 748, 786, 516, 100, 796, 949, 288, 362, 154, 523, 7, 508, 151, 731, 925, 852, 919, 803, 0, 451, 178, 949]"
87,25,4702,7433,3984,0,2741,1961,"[207, 289, 145, 271, 616, 285, 564, 506, 394, 594, 284, 380, 653, 35, 112, 507, 251, 330, 118, 462, 289, 203, 553, 503, 198, 0, 296, 461, 653]"
88,25,4707,3405,5286,0,3153,1554,"[31, 232, 460, 231, 379, 103, 244, 435, 164, 178, 312, 55, 518, 111, 398, 372, 413, 275, 78, 163, 315, 321, 304, 342, 168, 0, 434, 282, 518]"
89,25,4681,2668,7299,0,214,4467,"[51, 1356, 924, 946, 699, 195, 555, 486, 1385, 1197, 1145, 938, 1489, 798, 1118, 516, 128, 1129, 539, 361, 1397, 831, 671, 798, 1018, 0, 861, 419, 1489]"
90,25,4705,6652,5352,0,645,4060,"[428, 1171, 836, 25, 482, 283, 286, 52, 612, 629, 1320, 192, 1353, 455, 92, 728, 396, 729, 1303, 931, 1298, 1082, 500, 703, 917, 0, 1177, 595, 1353]"
91,25,3164,752,7764,0,3024,140,"[32, 41, 39, 5, 44, 13, 45, 11, 19, 16, 4, 38, 46, 22, 45, 43, 44, 3, 35, 6, 18, 0, 39, 10, 9, 0, 2, 23, 46]"
92,25,3870,6325,5309,0,3694,176,"[12, 39, 32, 22, 5, 54, 24, 54, 51, 17, 41, 28, 58, 44, 48, 13, 35, 58, 49, 24, 29, 3, 38, 7, 22, 0, 48, 16, 58]"
93,25,4866,1524,8651,0,3242,1624,"[537, 456, 77, 517, 351, 169, 207, 412, 385, 320, 538, 77, 541, 191, 373, 23, 437, 319, 433, 351, 252, 73, 57, 173, 126, 0, 199, 526, 541]"
94,25,3726,5931,6446,0,1211,2515,"[812, 282, 333, 194, 679, 1, 809, 159, 757, 716, 497, 511, 838, 390, 179, 463, 775, 601, 359, 259, 231, 539, 599, 93, 587, 0, 562, 440, 838]"
95,25,3370,1353,8463,0,2745,625,"[70, 52, 8, 27, 146, 59, 128, 138, 101, 181, 99, 116, 208, 186, 9, 151, 67, 131, 185, 9, 28, 60, 5, 173, 79, 0, 124, 73, 208]"
96,25,4522,5368,7617,0,1705,2817,"[279, 522, 60, 35, 658, 202, 698, 535, 456, 98, 128, 837, 939, 834, 576, 722, 499, 913, 439, 704, 82, 537, 749, 149, 665, 0, 360, 903, 939]"
97,25,3696,6070,5243,0,3423,273,"[85, 43, 48, 66, 55, 61, 90, 28, 65, 31, 9, 72, 91, 7, 16, 85, 12, 73, 7, 48, 88, 20, 30, 65, 1, 0, 31, 77, 91]"
98,25,4230,1837,7636,0,451,3779,"[602, 1196, 474, 725, 606, 1006, 623, 659, 374, 1046, 706, 482, 1259, 722, 269, 1114, 350, 646, 835, 816, 813, 1258, 321, 1070, 385, 0, 815, 558, 1259]"
99,25,3836,6701,4771,0,777,3059,"[197, 213, 169, 718, 5, 677, 371, 772, 695, 844, 279, 18, 1019, 91, 248, 615, 563, 71, 281, 334, 192, 94, 584, 848, 681, 0, 810, 748, 1019]"
100,25,3464,484,7751,0,230,3234,"[795, 596, 1013, 467, 869, 997, 105, 597, 704, 350, 817, 143, 1078, 399, 494, 229, 136, 496, 787, 954, 391, 357, 888, 1059, 812, 0, 565, 422, 1078]"
101,25,3667,6338,5080,0,2095,1572,"[233, 233, 296, 88, 245, 131, 56, 230, 223, 229, 44, 419, 524, 116, 391, 305, 197, 433, 433, 25, 506, 383, 271, 385, 447, 0, 42, 30, 524]"
102,25,3571,1366,7285,0,2217,1354,"[274, 266, 178, 110, 17, 428, 301, 42, 304, 109, 293, 214, 451, 152, 274, 424, 415, 80, 125, 56, 52, 190, 442, 436, 156, 0, 68, 300, 451]"
103,25,3367,2401,8251,0,1661,1706,"[138, 254, 418, 303, 561, 117, 562, 358, 253, 204, 126, 229, 568, 198, 460, 201, 14, 513, 406, 329, 341, 49, 39, 549, 96, 0, 559, 400, 568]"
104,25,4049,7128,5172,0,331,3718,"[1238, 726, 352, 62, 284, 905, 512, 941, 477, 334, 54, 780, 1239, 583, 1013, 999, 482, 135, 520, 334, 1094, 114, 1206, 951, 29, 0, 1069, 912, 1239]"
105,25,3456,1779,6849,0,2154,1302,"[384, 110, 20, 290, 99, 315, 89, 281, 16, 354, 265, 191, 434, 66, 425, 73, 200, 351, 343, 84, 78, 405, 146, 394, 307, 0, 390, 393, 434]"
106,25,3968,3856,6961,0,1631,2337,"[216, 301, 162, 368, 16, 734, 529, 148, 90, 227, 533, 512, 779, 213, 50, 28, 574, 480, 255, 218, 297, 498, 425, 106, 727, 0, 622, 443, 779]"
107,25,4100,6571,4490,0,4100,0,"[0, 0, 0, 0, 0, 0, 0, 0, 0, 0, 0, 0, 0, 0, 0, 0, 0, 0, 0, 0, 0, 0, 0, 0, 0, 0, 0, 0, 0]"
108,25,3023,2345,5168,0,2607,416,"[18, 32, 65, 4, 41, 88, 130, 55, 63, 47, 42, 43, 138, 85, 111, 136, 33, 67, 132, 56, 110, 29, 113, 118, 134, 0, 129, 67, 138]"
109,25,4688,4604,5252,0,3388,1300,"[113, 142, 157, 92, 185, 231, 384, 265, 212, 124, 381, 275, 433, 347, 433, 188, 33, 187, 413, 38, 126, 407, 298, 257, 426, 0, 386, 51, 433]"
110,25,3783,164,8871,0,2364,1419,"[383, 248, 303, 139, 355, 84, 373, 53, 305, 13, 336, 433, 473, 374, 431, 1, 48, 146, 208, 282, 359, 63, 272, 201, 110, 0, 236, 406, 473]"
111,25,3863,5959,6775,0,1344,2519,"[45, 318, 620, 525, 691, 137, 224, 175, 527, 587, 694, 88, 839, 679, 640, 426, 682, 349, 75, 350, 71, 22, 225, 608, 669, 0, 502, 829, 839]"
112,25,4016,85,10000,706,484,3532,"[964, 407, 876, 93, 1111, 856, 1019, 511, 480, 669, 360, 916, 1177, 45, 659, 576, 548, 1130, 835, 412, 130, 387, 1089, 489, 209, 0, 847, 38, 1177]"
113,25,3320,6296,7024,0,58,3262,"[51, 552, 736, 829, 956, 774, 591, 286, 316, 303, 347, 379, 1087, 572, 616, 890, 114, 779, 8, 488, 64, 951, 286, 1067, 391, 0, 966, 909, 1087]"
114,25,4252,6074,5202,0,3580,672,"[127, 16, 40, 106, 151, 120, 35, 124, 155, 164, 75, 131, 224, 156, 148, 138, 140, 217, 176, 3, 132, 217, 96, 3, 158, 0, 178, 175, 224]"
115,25,4139,1562,7779,0,775,3364,"[882, 843, 28, 818, 547, 1104, 661, 786, 524, 627, 428, 1071, 1121, 933, 750, 213, 950, 212, 475, 908, 133, 900, 410, 1062, 282, 0, 626, 191, 1121]"
116,25,4888,7455,5212,0,922,3966,"[950, 737, 66, 798, 848, 447, 1155, 1237, 749, 300, 997, 158, 1322, 4, 403, 1022, 1153, 159, 14, 887, 1314, 743, 587, 1284, 1296, 0, 649, 1178, 1322]"
117,25,4274,2875,6611,0,2196,2078,"[74, 74, 416, 617, 238, 402, 629, 690, 309, 524, 8, 645, 692, 488, 79, 118, 522, 467, 509, 106, 373, 373, 370, 352, 357, 0, 649, 239, 692]"
118,25,4161,2765,8007,0,1411,2750,"[522, 202, 797, 364, 107, 619, 78, 777, 803, 706, 26, 592, 916, 412, 37, 623, 705, 130, 425, 379, 188, 519, 472, 899, 2, 0, 404, 439, 916]"
119,25,3820,5476,6351,0,855,2965,"[28, 585, 920, 903, 895, 52, 547, 434, 383, 660, 543, 80, 988, 452, 520, 810, 58, 263, 699, 647, 528, 360, 128, 371, 650, 0, 232, 727, 988]"
0,26,1649,0,1649,0,591,1058,"[206, 2, 103, 139, 172, 101, 341, 279, 352, 89, 347, 39, 315, 152, 256, 197, 40, 352, 113, 352, 267, 80, 342, 289, 132, 321, 0, 94, 238]"
1,26,2000,268,3381,0,1362,638,"[87, 14, 138, 43, 10, 145, 24, 130, 139, 163, 30, 206, 212, 169, 144, 174, 10, 212, 9, 212, 76, 88, 108, 66, 124, 119, 0, 121, 19]"
2,26,2106,840,4647,0,137,1969,"[446, 484, 306, 411, 457, 175, 302, 86, 1, 609, 641, 323, 195, 581, 429, 16, 162, 656, 128, 656, 639, 625, 196, 339, 38, 347, 0, 516, 550]"
3,26,2599,1481,5765,0,2045,554,"[14, 64, 105, 178, 171, 83, 135, 147, 82, 164, 79, 32, 155, 178, 66, 170, 157, 184, 98, 184, 125, 178, 91, 79, 177, 135, 0, 175, 168]"
4,26,1038,565,6238,0,868,170,"[9, 30, 6, 12, 9, 27, 42, 54, 14, 16, 29, 15, 48, 10, 54, 47, 31, 56, 30, 56, 35, 32, 22, 41, 29, 7, 0, 35, 42]"
5,26,1337,752,6823,0,658,679,"[75, 188, 81, 195, 14, 62, 202, 56, 79, 127, 63, 72, 197, 177, 81, 145, 34, 226, 143, 226, 122, 72, 159, 186, 169, 89, 0, 214, 19]"
6,26,2769,867,8725,0,726,2043,"[7, 523, 349, 109, 491, 501, 90, 153, 584, 28, 627, 317, 12, 485, 204, 104, 79, 681, 430, 681, 627, 563, 333, 522, 248, 21, 0, 312, 587]"
7,26,2397,6055,5067,0,289,2108,"[510, 218, 621, 330, 699, 327, 161, 109, 392, 667, 668, 384, 30, 156, 38, 327, 252, 702, 583, 702, 71, 457, 584, 70, 416, 131, 0, 499, 383]"
8,26,2865,1479,6453,0,1610,1255,"[202, 65, 232, 243, 257, 9, 344, 223, 184, 256, 244, 213, 345, 281, 170, 269, 289, 418, 316, 418, 90, 174, 280, 292, 362, 206, 0, 320, 45]"
9,26,2656,62,9047,0,1330,1326,"[161, 228, 403, 34, 5, 304, 286, 177, 78, 378, 272, 64, 367, 409, 383, 158, 240, 442, 135, 442, 313, 330, 57, 393, 329, 394, 0, 302, 430]"
10,26,1221,428,9840,0,985,236,"[66, 55, 68, 37, 26, 14, 30, 49, 28, 34, 32, 27, 34, 77, 55, 16, 10, 78, 47, 78, 19, 61, 1, 12, 62, 74, 0, 62, 20]"
11,26,2846,7039,5647,0,453,2393,"[500, 344, 510, 634, 114, 701, 164, 65, 244, 333, 388, 42, 629, 572, 581, 372, 60, 797, 292, 797, 457, 13, 201, 589, 118, 608, 0, 458, 480]"
12,26,2143,1885,5905,0,2091,52,"[1, 13, 13, 8, 3, 17, 16, 1, 1, 0, 6, 13, 17, 5, 4, 11, 9, 17, 11, 17, 7, 0, 9, 9, 2, 15, 0, 12, 6]"
13,26,2123,410,7618,0,2036,87,"[1, 19, 8, 8, 7, 0, 7, 5, 2, 2, 27, 12, 29, 22, 11, 8, 20, 29, 7, 29, 12, 23, 8, 3, 26, 20, 0, 7, 14]"
14,26,2303,1600,8321,0,269,2034,"[12, 115, 277, 38, 389, 515, 561, 410, 643, 66, 171, 253, 497, 532, 521, 517, 562, 678, 545, 678, 317, 326, 585, 518, 114, 427, 0, 518, 300]"
15,26,2004,135,10000,190,1201,803,"[237, 29, 255, 51, 121, 91, 137, 157, 212, 0, 178, 219, 234, 201, 118, 53, 139, 267, 135, 267, 251, 32, 187, 96, 104, 156, 0, 111, 117]"
16,26,2462,6117,6345,0,895,1567,"[229, 495, 254, 275, 290, 23, 89, 499, 11, 474, 212, 59, 207, 196, 343, 13, 85, 522, 215, 522, 419, 512, 255, 310, 280, 429, 0, 367, 51]"
17,26,2860,2284,6921,0,1360,1500,"[251, 397, 268, 133, 160, 410, 280, 174, 134, 373, 98, 75, 362, 321, 88, 264, 314, 500, 235, 500, 472, 288, 462, 200, 177, 315, 0, 251, 96]"
18,26,1897,666,8152,0,425,1472,"[419, 320, 352, 78, 209, 62, 230, 436, 85, 0, 198, 312, 108, 278, 147, 127, 149, 490, 325, 490, 92, 422, 15, 459, 386, 110, 0, 89, 430]"
19,26,2937,6404,4685,0,1976,961,"[180, 188, 131, 133, 281, 143, 16, 156, 290, 311, 306, 260, 243, 120, 36, 217, 195, 320, 5, 320, 110, 30, 185, 27, 292, 88, 0, 308, 298]"
20,26,2705,1185,6205,0,2584,121,"[1, 13, 33, 21, 17, 28, 26, 39, 36, 35, 36, 18, 0, 5, 8, 7, 2, 40, 35, 40, 25, 8, 31, 20, 14, 18, 0, 5, 33]"
21,26,1553,185,7573,0,1281,272,"[73, 90, 65, 48, 22, 8, 76, 1, 73, 73, 69, 7, 81, 40, 71, 56, 7, 90, 6, 90, 45, 38, 67, 48, 84, 74, 0, 81, 56]"
22,26,1416,554,8435,0,612,804,"[108, 140, 55, 168, 111, 33, 167, 244, 11, 57, 84, 77, 236, 89, 26, 126, 206, 268, 21, 268, 2, 111, 256, 254, 252, 145, 0, 42, 159]"
23,26,2367,1851,8951,0,463,1904,"[314, 219, 257, 626, 323, 384, 534, 518, 300, 140, 212, 427, 501, 206, 430, 579, 324, 634, 631, 634, 460, 162, 220, 219, 81, 35, 0, 199, 46]"
24,26,2460,6948,4463,0,942,1518,"[324, 157, 498, 93, 64, 143, 7, 177, 203, 175, 130, 289, 36, 335, 230, 14, 236, 506, 253, 506, 112, 461, 322, 76, 203, 234, 0, 160, 130]"
25,26,1433,910,4986,0,751,682,"[52, 107, 26, 207, 67, 153, 116, 154, 52, 174, 222, 142, 70, 88, 195, 147, 57, 227, 100, 227, 129, 127, 129, 97, 98, 53, 0, 134, 224]"
26,26,2573,631,6928,0,1832,741,"[52, 58, 135, 174, 95, 199, 85, 66, 186, 107, 85, 224, 6, 66, 28, 192, 152, 247, 184, 247, 31, 195, 201, 54, 86, 132, 0, 1, 189]"
27,26,1053,72,7909,0,419,634,"[75, 80, 53, 73, 150, 43, 164, 119, 114, 150, 186, 0, 108, 35, 59, 175, 122, 211, 161, 211, 80, 129, 104, 57, 145, 108, 0, 104, 50]"
28,26,1426,758,8577,0,189,1237,"[95, 264, 338, 3, 109, 233, 308, 352, 205, 76, 189, 283, 274, 219, 236, 349, 18, 412, 42, 412, 334, 29, 300, 203, 134, 336, 0, 20, 213]"
29,26,1281,982,8876,0,376,905,"[73, 79, 283, 207, 110, 196, 215, 92, 21, 46, 15, 61, 32, 93, 16, 271, 55, 301, 161, 301, 269, 119, 250, 70, 61, 38, 0, 32, 219]"
30,26,2286,5038,6124,0,2127,159,"[5, 53, 51, 41, 17, 7, 15, 0, 25, 52, 1, 18, 1, 38, 18, 20, 43, 53, 51, 53, 23, 7, 38, 11, 43, 15, 0, 30, 43]"
31,26,1801,940,6985,0,1215,586,"[24, 113, 50, 139, 137, 153, 142, 26, 55, 85, 98, 155, 83, 4, 128, 56, 124, 195, 189, 195, 49, 109, 40, 93, 105, 49, 0, 173, 136]"
32,26,2065,643,8407,0,720,1345,"[405, 380, 82, 190, 179, 196, 320, 372, 251, 243, 18, 153, 336, 265, 135, 339, 295, 448, 161, 448, 289, 256, 14, 313, 331, 150, 0, 51, 173]"
33,26,2383,1322,9468,0,210,2173,"[488, 626, 141, 131, 154, 665, 380, 679, 587, 464, 237, 584, 159, 568, 460, 72, 225, 724, 545, 724, 113, 626, 205, 333, 467, 642, 0, 240, 116]"
34,26,1338,1166,9640,0,827,511,"[2, 135, 7, 95, 96, 118, 35, 157, 76, 38, 141, 79, 116, 149, 56, 60, 24, 170, 77, 170, 139, 97, 117, 71, 111, 89, 0, 109, 23]"
35,26,1229,1054,9815,0,114,1115,"[171, 212, 347, 287, 89, 107, 334, 28, 333, 164, 355, 273, 269, 304, 190, 199, 2, 371, 178, 371, 71, 263, 164, 369, 200, 235, 0, 116, 368]"
36,26,2143,6276,5682,0,744,1399,"[265, 14, 243, 31, 429, 50, 381, 302, 9, 11, 360, 296, 446, 315, 151, 138, 426, 466, 444, 466, 414, 16, 212, 1, 447, 103, 0, 79, 407]"
37,26,1772,1510,5944,0,1432,340,"[14, 64, 9, 2, 1, 72, 32, 90, 3, 94, 80, 27, 87, 40, 95, 94, 9, 113, 28, 113, 38, 15, 74, 101, 75, 72, 0, 13, 6]"
38,26,2045,1402,6587,0,1241,804,"[213, 209, 228, 140, 65, 122, 246, 118, 252, 142, 187, 207, 66, 7, 98, 22, 79, 268, 245, 268, 262, 65, 232, 24, 81, 120, 0, 261, 106]"
39,26,1133,1022,6698,0,491,642,"[142, 115, 156, 212, 5, 155, 38, 183, 175, 28, 120, 172, 116, 130, 164, 169, 164, 214, 211, 214, 187, 204, 52, 125, 7, 99, 0, 75, 91]"
40,26,1182,88,7792,0,289,893,"[17, 105, 15, 244, 162, 225, 238, 180, 267, 2, 158, 256, 289, 81, 142, 4, 247, 297, 81, 297, 251, 229, 163, 67, 213, 59, 0, 235, 294]"
41,26,1302,1251,7843,0,391,911,"[177, 223, 289, 261, 18, 53, 99, 42, 78, 261, 219, 47, 129, 284, 219, 145, 239, 303, 264, 303, 112, 135, 6, 109, 147, 124, 0, 24, 122]"
42,26,1744,803,8784,0,378,1366,"[22, 187, 447, 410, 81, 382, 89, 317, 343, 32, 143, 432, 128, 426, 1, 96, 173, 455, 395, 455, 299, 381, 137, 228, 392, 36, 0, 62, 177]"
43,26,2048,1640,9192,0,724,1324,"[329, 241, 365, 59, 194, 235, 408, 49, 328, 283, 105, 239, 419, 177, 258, 99, 287, 441, 43, 441, 354, 124, 382, 5, 22, 408, 0, 334, 330]"
44,26,1109,679,9622,0,1053,56,"[3, 16, 16, 4, 16, 13, 17, 8, 7, 2, 5, 2, 10, 11, 12, 12, 12, 18, 1, 18, 10, 2, 3, 5, 17, 8, 0, 17, 1]"
45,26,1845,6857,4610,0,1138,707,"[119, 203, 191, 108, 229, 47, 36, 17, 12, 209, 7, 96, 181, 19, 200, 80, 39, 235, 102, 235, 70, 26, 44, 120, 231, 105, 0, 112, 71]"
46,26,2840,2799,4651,0,1472,1368,"[146, 116, 71, 377, 74, 358, 37, 214, 452, 323, 413, 180, 311, 110, 284, 245, 95, 456, 326, 456, 260, 42, 134, 106, 438, 139, 0, 352, 168]"
47,26,1917,51,6517,0,739,1178,"[20, 78, 124, 202, 392, 64, 217, 236, 258, 115, 39, 310, 79, 56, 275, 126, 87, 392, 270, 392, 215, 336, 195, 117, 190, 42, 0, 320, 84]"
48,26,2910,968,8459,0,2738,172,"[13, 32, 33, 2, 25, 23, 12, 56, 28, 41, 28, 51, 32, 49, 22, 27, 50, 57, 24, 57, 53, 1, 35, 9, 11, 57, 0, 28, 28]"
49,26,1795,1784,8470,0,102,1693,"[52, 340, 300, 540, 370, 523, 504, 349, 10, 34, 231, 208, 322, 9, 37, 511, 425, 564, 305, 564, 12, 542, 87, 285, 205, 243, 0, 325, 452]"
50,26,1573,908,9135,0,979,594,"[102, 125, 50, 100, 180, 75, 177, 133, 80, 76, 135, 120, 119, 172, 143, 46, 70, 198, 4, 198, 141, 135, 71, 125, 154, 18, 0, 104, 67]"
51,26,1024,361,9798,0,73,951,"[190, 72, 115, 198, 93, 199, 8, 144, 260, 156, 117, 171, 116, 155, 233, 251, 119, 317, 168, 317, 293, 74, 89, 290, 134, 128, 0, 300, 200]"
52,26,1567,6514,4851,0,239,1328,"[16, 416, 374, 118, 156, 88, 200, 207, 420, 362, 149, 229, 200, 388, 43, 256, 346, 442, 330, 442, 175, 25, 418, 48, 380, 407, 0, 197, 207]"
53,26,1378,638,5591,0,195,1183,"[280, 74, 158, 317, 169, 319, 43, 218, 3, 375, 135, 325, 0, 79, 312, 107, 164, 394, 59, 394, 252, 204, 257, 301, 224, 23, 0, 128, 47]"
54,26,1737,343,6985,0,750,987,"[40, 214, 76, 183, 248, 109, 250, 256, 282, 74, 82, 33, 286, 243, 183, 215, 155, 329, 179, 329, 266, 285, 279, 220, 315, 185, 0, 26, 114]"
55,26,2377,2207,7155,0,1847,530,"[38, 50, 145, 43, 29, 82, 148, 72, 127, 17, 51, 96, 81, 0, 37, 19, 40, 176, 42, 176, 104, 32, 73, 43, 44, 140, 0, 31, 84]"
56,26,1227,772,7610,0,1035,192,"[48, 62, 26, 9, 13, 10, 14, 4, 12, 42, 8, 23, 17, 41, 47, 5, 36, 64, 43, 64, 30, 32, 25, 23, 35, 10, 0, 52, 23]"
57,26,2122,1666,8066,0,267,1855,"[466, 322, 28, 369, 315, 494, 121, 355, 221, 0, 162, 42, 349, 535, 299, 596, 64, 618, 26, 618, 107, 588, 448, 86, 580, 495, 0, 577, 108]"
58,26,1635,805,8896,0,640,995,"[187, 227, 125, 194, 186, 95, 329, 239, 13, 149, 113, 44, 254, 118, 305, 124, 101, 331, 273, 331, 202, 217, 242, 241, 121, 121, 0, 1, 277]"
59,26,2977,6923,4950,0,857,2120,"[206, 343, 142, 52, 257, 554, 558, 248, 67, 197, 150, 122, 396, 500, 220, 398, 448, 706, 203, 706, 234, 550, 438, 433, 294, 296, 0, 375, 280]"
60,26,2400,612,6738,0,2094,306,"[43, 65, 11, 12, 27, 47, 4, 73, 95, 99, 92, 99, 91, 12, 25, 37, 78, 102, 64, 102, 15, 84, 2, 76, 72, 71, 0, 53, 75]"
61,26,2029,1110,7657,0,1767,262,"[67, 55, 63, 0, 56, 14, 56, 54, 26, 36, 81, 64, 16, 76, 50, 8, 39, 87, 43, 87, 20, 64, 20, 61, 23, 37, 0, 54, 5]"
62,26,1395,648,8404,0,1065,330,"[101, 64, 46, 28, 37, 60, 63, 75, 55, 66, 55, 9, 49, 36, 98, 19, 36, 110, 107, 110, 67, 105, 54, 20, 23, 108, 0, 109, 73]"
63,26,1741,1226,8919,0,305,1436,"[165, 439, 267, 98, 343, 216, 129, 353, 144, 268, 299, 298, 445, 141, 133, 371, 389, 478, 176, 478, 206, 16, 394, 131, 185, 81, 0, 404, 353]"
64,26,2529,5802,5646,0,1171,1358,"[313, 417, 25, 146, 305, 301, 61, 186, 133, 349, 50, 226, 314, 31, 34, 112, 188, 452, 384, 452, 430, 218, 157, 345, 112, 377, 0, 280, 224]"
65,26,2418,383,7681,0,2314,104,"[33, 15, 34, 4, 11, 31, 20, 22, 14, 26, 16, 11, 28, 26, 3, 5, 14, 34, 17, 34, 3, 18, 25, 3, 1, 24, 0, 22, 32]"
66,26,1316,428,8569,0,576,740,"[61, 89, 241, 40, 29, 88, 75, 19, 47, 144, 109, 160, 141, 181, 32, 125, 45, 246, 5, 246, 44, 25, 42, 5, 89, 200, 0, 200, 166]"
67,26,1718,1532,8755,0,1522,196,"[52, 53, 54, 49, 33, 37, 4, 2, 29, 22, 44, 53, 10, 27, 14, 47, 20, 65, 61, 65, 60, 10, 47, 1, 8, 60, 0, 1, 12]"
68,26,2681,6072,5364,0,1751,930,"[130, 215, 213, 106, 212, 206, 44, 5, 57, 227, 225, 151, 306, 71, 24, 16, 127, 310, 23, 310, 231, 87, 261, 290, 58, 92, 0, 62, 54]"
69,26,2876,2017,6223,0,2014,862,"[180, 164, 184, 44, 238, 247, 166, 187, 46, 117, 212, 70, 251, 40, 169, 127, 105, 287, 144, 287, 175, 120, 98, 17, 47, 128, 0, 126, 223]"
70,26,1979,912,7290,0,1549,430,"[40, 115, 55, 8, 108, 103, 88, 49, 18, 139, 139, 32, 10, 141, 48, 98, 27, 143, 132, 143, 16, 96, 105, 4, 73, 87, 0, 57, 99]"
71,26,1003,534,7759,0,866,137,"[5, 21, 10, 40, 27, 12, 6, 1, 18, 23, 15, 43, 32, 15, 45, 31, 15, 45, 37, 45, 19, 44, 26, 23, 23, 24, 0, 19, 44]"
72,26,2088,204,9643,0,321,1767,"[484, 536, 310, 42, 397, 133, 163, 327, 514, 538, 53, 69, 18, 213, 512, 36, 324, 589, 448, 589, 477, 100, 340, 425, 298, 290, 0, 130, 540]"
73,26,1530,5945,5228,0,563,967,"[158, 35, 243, 88, 261, 145, 182, 155, 42, 321, 185, 15, 100, 297, 49, 299, 84, 322, 140, 322, 147, 286, 250, 222, 268, 119, 0, 171, 176]"
74,26,2493,606,7115,0,1493,1000,"[112, 101, 290, 263, 96, 14, 131, 286, 282, 224, 286, 50, 204, 126, 130, 60, 251, 333, 67, 333, 6, 71, 302, 262, 273, 304, 0, 230, 240]"
75,26,2176,1205,8086,0,912,1264,"[333, 139, 219, 31, 3, 206, 105, 174, 225, 292, 321, 36, 381, 226, 105, 342, 158, 421, 10, 421, 224, 54, 399, 192, 96, 94, 0, 376, 1]"
76,26,1353,631,8808,0,203,1150,"[34, 150, 189, 245, 81, 44, 295, 33, 59, 83, 45, 318, 76, 42, 0, 298, 240, 383, 202, 383, 12, 1, 197, 5, 360, 156, 0, 296, 291]"
77,26,2843,6015,5636,0,2244,599,"[13, 98, 128, 162, 45, 98, 26, 73, 23, 104, 7, 92, 58, 124, 92, 104, 136, 199, 191, 199, 126, 69, 14, 50, 135, 32, 0, 117, 178]"
78,26,1228,643,6221,0,197,1031,"[92, 221, 194, 338, 293, 152, 158, 288, 111, 61, 57, 331, 213, 325, 117, 57, 277, 343, 69, 343, 318, 233, 173, 291, 87, 239, 0, 319, 189]"
79,26,1131,842,6510,0,43,1088,"[346, 303, 11, 208, 7, 227, 269, 125, 355, 220, 125, 155, 333, 141, 308, 47, 338, 362, 321, 362, 294, 118, 356, 110, 196, 28, 0, 124, 291]"
80,26,1220,737,6993,0,533,687,"[188, 208, 141, 46, 111, 201, 166, 221, 40, 91, 33, 37, 22, 10, 10, 136, 64, 229, 48, 229, 205, 212, 87, 2, 224, 50, 0, 166, 229]"
81,26,1817,354,8456,0,1118,699,"[208, 145, 222, 72, 117, 37, 207, 213, 98, 9, 57, 112, 84, 28, 134, 90, 193, 233, 157, 233, 95, 135, 114, 103, 163, 167, 0, 142, 1]"
82,26,2413,2353,8516,0,1919,494,"[17, 100, 141, 66, 21, 53, 107, 108, 124, 61, 88, 134, 89, 11, 31, 32, 119, 164, 150, 164, 54, 53, 44, 70, 57, 157, 0, 116, 47]"
83,26,1593,1498,8611,0,575,1018,"[36, 59, 179, 38, 207, 29, 93, 97, 304, 16, 264, 263, 249, 213, 227, 224, 327, 339, 172, 339, 251, 186, 32, 133, 239, 110, 0, 146, 89]"
84,26,2489,6227,4873,0,94,2395,"[20, 406, 464, 212, 109, 737, 204, 722, 606, 467, 245, 282, 7, 608, 286, 112, 253, 798, 405, 798, 368, 790, 501, 230, 629, 578, 0, 34, 146]"
85,26,1208,366,5715,0,1011,197,"[65, 33, 24, 34, 60, 47, 53, 11, 65, 39, 49, 37, 51, 52, 8, 15, 51, 65, 50, 65, 11, 33, 14, 60, 48, 46, 0, 3, 10]"
86,26,1520,229,7006,0,358,1162,"[178, 270, 269, 144, 310, 164, 347, 330, 295, 193, 368, 198, 313, 97, 56, 31, 325, 387, 386, 387, 203, 312, 108, 348, 355, 113, 0, 233, 337]"
87,26,2150,21,9135,0,2012,138,"[9, 2, 24, 39, 1, 1, 40, 8, 40, 2, 38, 25, 45, 14, 44, 17, 18, 46, 1, 46, 10, 37, 11, 46, 13, 19, 0, 11, 0]"
88,26,2026,7354,3807,0,583,1443,"[232, 388, 247, 183, 432, 320, 178, 70, 403, 193, 363, 104, 127, 481, 269, 451, 185, 481, 220, 481, 61, 465, 346, 208, 159, 327, 0, 151, 187]"
89,26,2209,891,5125,0,1493,716,"[75, 4, 20, 47, 218, 107, 18, 111, 30, 205, 72, 199, 4, 165, 126, 60, 154, 238, 67, 238, 128, 134, 27, 103, 7, 122, 0, 163, 232]"
90,26,1211,892,5444,0,341,870,"[132, 276, 157, 132, 222, 45, 167, 163, 132, 106, 201, 271, 150, 186, 25, 227, 115, 290, 61, 290, 249, 153, 36, 155, 190, 209, 0, 256, 104]"
91,26,1816,1401,5859,0,574,1242,"[22, 94, 252, 103, 66, 314, 344, 343, 309, 125, 30, 336, 227, 53, 354, 39, 201, 414, 339, 414, 256, 127, 363, 208, 118, 125, 0, 381, 79]"
92,26,1590,611,6838,0,1316,274,"[75, 70, 74, 14, 71, 61, 56, 91, 0, 17, 77, 28, 90, 40, 68, 81, 17, 91, 35, 91, 26, 75, 23, 42, 14, 65, 0, 44, 42]"
93,26,2806,2396,7248,0,200,2606,"[353, 730, 282, 494, 224, 381, 865, 552, 44, 283, 402, 479, 519, 239, 495, 639, 82, 868, 853, 868, 643, 41, 765, 615, 31, 230, 0, 582, 796]"
94,26,1104,949,7403,0,344,760,"[221, 142, 51, 170, 35, 130, 146, 11, 112, 195, 216, 228, 111, 44, 113, 50, 59, 253, 188, 253, 202, 61, 53, 157, 211, 161, 0, 109, 200]"
95,26,1146,8,8541,0,579,567,"[90, 83, 154, 169, 158, 127, 92, 28, 126, 59, 39, 108, 140, 187, 75, 71, 11, 189, 142, 189, 127, 118, 87, 49, 131, 159, 0, 178, 142]"
96,26,1206,1160,8587,0,663,543,"[144, 109, 118, 126, 176, 17, 131, 59, 108, 143, 117, 177, 121, 20, 90, 153, 161, 181, 162, 181, 169, 169, 177, 159, 127, 79, 0, 35, 135]"
97,26,1870,1169,9288,0,301,1569,"[249, 1, 296, 463, 290, 317, 370, 269, 287, 494, 299, 482, 214, 251, 401, 342, 284, 523, 231, 523, 183, 381, 412, 41, 469, 284, 0, 146, 108]"
98,26,1104,456,9936,0,886,218,"[11, 14, 28, 7, 40, 22, 61, 60, 68, 29, 39, 71, 69, 48, 3, 51, 41, 72, 30, 72, 71, 16, 32, 66, 21, 57, 0, 72, 60]"
99,26,2045,7140,4841,0,1112,933,"[215, 178, 178, 15, 300, 68, 253, 172, 117, 82, 75, 226, 154, 211, 257, 133, 128, 311, 80, 311, 137, 98, 12, 302, 264, 218, 0, 242, 27]"
100,26,2061,1354,5548,0,1493,568,"[124, 62, 99, 41, 26, 90, 76, 79, 175, 135, 114, 81, 162, 36, 163, 156, 169, 189, 188, 189, 17, 100, 66, 48, 156, 125, 0, 62, 157]"
101,26,1585,809,6324,0,1260,325,"[48, 89, 68, 48, 26, 102, 81, 31, 100, 72, 90, 77, 104, 34, 5, 6, 90, 108, 55, 108, 35, 80, 100, 66, 97, 103, 0, 7, 33]"
102,26,2379,1828,6875,0,2274,105,"[9, 11, 29, 17, 29, 17, 15, 34, 12, 0, 28, 0, 0, 0, 9, 5, 21, 35, 6, 35, 21, 35, 13, 20, 27, 27, 0, 11, 33]"
103,26,2771,1410,8236,0,2512,259,"[69, 62, 44, 19, 35, 84, 85, 62, 21, 0, 15, 57, 82, 83, 74, 18, 69, 86, 12, 86, 17, 32, 44, 60, 3, 29, 0, 30, 86]"
104,26,1279,432,9083,0,110,1169,"[9, 63, 172, 204, 21, 162, 116, 352, 368, 353, 134, 345, 384, 310, 248, 87, 47, 389, 48, 389, 346, 287, 226, 49, 174, 381, 0, 354, 260]"
105,26,2225,6090,5218,0,1952,273,"[84, 67, 79, 53, 45, 32, 38, 86, 86, 83, 84, 0, 17, 34, 74, 17, 62, 91, 81, 91, 55, 32, 33, 40, 37, 20, 0, 66, 30]"
106,26,2365,1681,5902,0,239,2126,"[635, 661, 63, 693, 680, 567, 643, 1, 633, 259, 121, 430, 501, 204, 21, 33, 270, 708, 265, 708, 658, 569, 416, 628, 321, 286, 0, 164, 177]"
107,26,1645,327,7220,0,956,689,"[12, 143, 154, 88, 0, 77, 76, 225, 141, 90, 195, 53, 73, 73, 88, 173, 1, 229, 30, 229, 126, 9, 190, 219, 133, 105, 0, 9, 189]"
108,26,2725,1226,8719,0,2025,700,"[132, 203, 72, 116, 190, 111, 149, 180, 122, 192, 155, 90, 9, 154, 71, 64, 210, 233, 82, 233, 124, 18, 211, 200, 227, 179, 0, 115, 215]"
109,26,2770,6175,5314,0,2681,89,"[18, 18, 10, 27, 4, 28, 21, 2, 19, 7, 11, 23, 13, 28, 6, 15, 21, 29, 24, 29, 3, 25, 16, 16, 4, 15, 0, 24, 25]"
110,26,2326,1117,6523,0,341,1985,"[310, 226, 366, 437, 163, 488, 617, 220, 612, 408, 647, 572, 6, 535, 31, 258, 181, 661, 595, 661, 484, 307, 216, 496, 407, 565, 0, 340, 524]"
111,26,1768,879,7412,0,1135,633,"[195, 105, 153, 100, 123, 151, 65, 160, 7, 95, 139, 145, 188, 192, 27, 134, 31, 211, 168, 211, 39, 153, 26, 51, 47, 16, 0, 3, 39]"
112,26,2004,554,8862,0,860,1144,"[166, 182, 153, 128, 358, 348, 178, 0, 173, 154, 116, 48, 380, 253, 113, 95, 77, 381, 24, 381, 243, 182, 205, 246, 13, 102, 0, 30, 47]"
113,26,1626,1467,9021,0,129,1497,"[384, 83, 256, 334, 200, 12, 21, 118, 432, 239, 106, 388, 1, 246, 466, 111, 457, 499, 159, 499, 57, 235, 113, 115, 250, 80, 0, 30, 234]"
114,26,1167,314,9874,0,35,1132,"[277, 276, 177, 284, 230, 137, 124, 31, 32, 112, 13, 362, 152, 328, 293, 338, 206, 377, 298, 377, 376, 14, 278, 258, 153, 76, 0, 137, 298]"
115,26,1708,5824,5758,0,477,1231,"[11, 25, 319, 91, 101, 65, 62, 340, 216, 324, 229, 101, 172, 145, 89, 14, 287, 410, 11, 410, 346, 61, 144, 229, 200, 120, 0, 28, 127]"
116,26,2415,1252,6921,0,1461,954,"[82, 35, 263, 251, 141, 15, 38, 191, 272, 300, 311, 33, 152, 258, 125, 299, 131, 318, 80, 318, 74, 60, 80, 95, 83, 110, 0, 66, 316]"
117,26,2880,1173,8628,0,1692,1188,"[386, 215, 249, 124, 277, 196, 205, 70, 175, 213, 153, 382, 225, 153, 91, 216, 98, 396, 112, 396, 16, 391, 19, 146, 238, 219, 0, 313, 232]"
118,26,1666,1654,8640,0,493,1173,"[67, 245, 24, 252, 246, 300, 141, 208, 170, 116, 97, 173, 202, 242, 349, 223, 300, 391, 11, 391, 240, 196, 280, 341, 243, 211, 0, 161, 273]"
119,26,1819,177,10000,282,1550,269,"[44, 39, 42, 29, 32, 38, 24, 69, 77, 2, 34, 49, 66, 67, 81, 65, 37, 89, 36, 89, 28, 34, 76, 82, 80, 8, 0, 28, 50]"
0,27,93,0,93,0,57,36,"[3, 7, 9, 12, 6, 10, 4, 0, 0, 10, 12, 6, 8, 6, 2, 5, 12, 4, 2, 6, 6, 1, 11, 3, 8, 9, 10, 0, 6]"
1,27,42,40,95,0,40,2,"[0, 0, 0, 0, 0, 0, 0, 0, 0, 0, 0, 0, 0, 0, 0, 0, 0, 0, 0, 0, 0, 0, 0, 0, 0, 0, 0, 0, 0]"
2,27,4,3,96,0,3,1,"[0, 0, 0, 0, 0, 0, 0, 0, 0, 0, 0, 0, 0, 0, 0, 0, 0, 0, 0, 0, 0, 0, 0, 0, 0, 0, 0, 0, 0]"
3,27,14,12,98,0,1,13,"[2, 1, 3, 4, 2, 1, 1, 4, 4, 1, 4, 1, 4, 2, 1, 2, 1, 4, 0, 3, 1, 4, 1, 1, 1, 2, 4, 0, 3]"
4,27,88,81,105,0,32,56,"[12, 18, 18, 18, 13, 11, 14, 7, 11, 9, 18, 6, 12, 10, 13, 13, 3, 2, 16, 4, 7, 10, 10, 3, 6, 15, 10, 0, 9]"
5,27,39,37,107,0,39,0,"[0, 0, 0, 0, 0, 0, 0, 0, 0, 0, 0, 0, 0, 0, 0, 0, 0, 0, 0, 0, 0, 0, 0, 0, 0, 0, 0, 0, 0]"
6,27,8,1,114,0,3,5,"[1, 0, 0, 1, 1, 1, 1, 1, 0, 1, 1, 1, 0, 0, 0, 0, 0, 1, 0, 0, 1, 0, 1, 0, 1, 1, 1, 0, 1]"
7,27,66,0,180,0,31,35,"[8, 2, 4, 11, 0, 10, 8, 2, 10, 6, 11, 1, 5, 3, 0, 1, 7, 5, 9, 0, 10, 6, 4, 9, 3, 7, 5, 0, 4]"
8,27,37,9,208,0,24,13,"[2, 1, 2, 4, 3, 3, 3, 4, 0, 0, 4, 1, 0, 3, 2, 0, 0, 0, 0, 0, 1, 0, 3, 4, 0, 0, 0, 0, 2]"
9,27,9,8,209,0,4,5,"[0, 0, 1, 1, 1, 0, 1, 0, 1, 0, 1, 1, 0, 1, 1, 1, 1, 0, 0, 1, 0, 0, 1, 0, 0, 1, 0, 0, 0]"
10,27,8,3,214,0,8,0,"[0, 0, 0, 0, 0, 0, 0, 0, 0, 0, 0, 0, 0, 0, 0, 0, 0, 0, 0, 0, 0, 0, 0, 0, 0, 0, 0, 0, 0]"
11,27,86,39,261,0,75,11,"[0, 3, 2, 3, 2, 0, 3, 1, 2, 0, 3, 2, 0, 2, 3, 2, 1, 0, 0, 2, 3, 3, 2, 0, 2, 2, 2, 0, 3]"
12,27,4,1,264,0,4,0,"[0, 0, 0, 0, 0, 0, 0, 0, 0, 0, 0, 0, 0, 0, 0, 0, 0, 0, 0, 0, 0, 0, 0, 0, 0, 0, 0, 0, 0]"
13,27,1,0,262,0,1,0,"[0, 0, 0, 0, 0, 0, 0, 0, 0, 0, 0, 0, 0, 0, 0, 0, 0, 0, 0, 0, 0, 0, 0, 0, 0, 0, 0, 0, 0]"
14,27,7,6,263,0,2,5,"[1, 0, 1, 1, 0, 0, 0, 1, 1, 0, 1, 1, 0, 0, 1, 1, 0, 0, 0, 0, 1, 0, 0, 0, 0, 0, 0, 0, 1]"
15,27,35,30,268,0,31,4,"[1, 1, 0, 1, 0, 0, 1, 1, 1, 0, 1, 1, 1, 1, 1, 1, 0, 1, 1, 0, 1, 1, 1, 0, 1, 1, 0, 0, 1]"
16,27,60,58,270,0,17,43,"[4, 11, 9, 14, 0, 13, 14, 4, 12, 9, 14, 1, 11, 11, 5, 8, 14, 12, 13, 4, 1, 2, 3, 10, 2, 6, 4, 0, 8]"
17,27,53,15,308,0,44,9,"[3, 0, 2, 3, 3, 3, 3, 1, 1, 2, 3, 1, 2, 2, 3, 0, 2, 0, 1, 1, 2, 3, 1, 0, 0, 3, 1, 0, 1]"
18,27,13,7,314,0,10,3,"[1, 1, 0, 1, 1, 0, 1, 1, 0, 0, 1, 0, 1, 0, 0, 1, 1, 0, 0, 0, 1, 0, 1, 0, 1, 1, 0, 0, 0]"
19,27,20,17,317,0,1,19,"[0, 1, 1, 6, 2, 6, 6, 1, 2, 4, 6, 5, 3, 1, 6, 3, 4, 6, 3, 3, 0, 2, 4, 1, 1, 2, 6, 0, 6]"
20,27,68,48,337,0,45,23,"[4, 7, 0, 7, 3, 7, 0, 6, 5, 7, 7, 4, 0, 0, 4, 7, 0, 5, 1, 2, 5, 6, 0, 6, 6, 3, 7, 0, 1]"
21,27,65,19,383,0,28,37,"[8, 8, 3, 12, 12, 11, 4, 5, 10, 2, 12, 3, 6, 4, 10, 2, 10, 6, 12, 8, 11, 1, 9, 4, 4, 11, 10, 0, 10]"
22,27,51,19,415,0,8,43,"[9, 2, 8, 14, 13, 10, 14, 10, 13, 14, 14, 13, 7, 3, 1, 3, 13, 7, 1, 13, 8, 5, 2, 14, 3, 10, 14, 0, 6]"
23,27,18,1,432,0,14,4,"[1, 0, 0, 1, 0, 0, 1, 1, 1, 1, 1, 0, 0, 0, 1, 0, 0, 1, 0, 0, 1, 1, 1, 0, 0, 0, 0, 0, 1]"
24,27,22,21,433,0,15,7,"[0, 0, 2, 2, 1, 0, 1, 2, 1, 2, 2, 2, 2, 2, 1, 1, 2, 1, 2, 2, 2, 1, 1, 0, 0, 0, 0, 0, 0]"
25,27,68,45,456,0,6,62,"[5, 5, 14, 20, 5, 16, 15, 11, 8, 17, 20, 15, 7, 6, 10, 3, 11, 11, 18, 6, 2, 0, 1, 7, 15, 8, 17, 0, 16]"
26,27,19,17,458,0,17,2,"[0, 0, 0, 0, 0, 0, 0, 0, 0, 0, 0, 0, 0, 0, 0, 0, 0, 0, 0, 0, 0, 0, 0, 0, 0, 0, 0, 0, 0]"
27,27,7,6,459,0,7,0,"[0, 0, 0, 0, 0, 0, 0, 0, 0, 0, 0, 0, 0, 0, 0, 0, 0, 0, 0, 0, 0, 0, 0, 0, 0, 0, 0, 0, 0]"
28,27,40,29,470,0,17,23,"[3, 2, 7, 7, 7, 7, 6, 5, 5, 6, 7, 2, 0, 6, 7, 1, 4, 3, 4, 6, 1, 6, 5, 7, 3, 7, 0, 0, 0]"
29,27,71,69,472,0,60,11,"[1, 1, 2, 3, 3, 0, 0, 1, 1, 3, 3, 3, 2, 3, 2, 2, 3, 1, 1, 0, 1, 0, 2, 2, 0, 0, 3, 0, 3]"
30,27,62,42,492,0,3,59,"[12, 11, 1, 19, 10, 18, 10, 19, 3, 0, 19, 9, 19, 18, 4, 9, 19, 3, 14, 0, 4, 3, 2, 14, 5, 16, 11, 0, 17]"
31,27,90,88,494,0,20,70,"[21, 1, 23, 23, 12, 16, 10, 5, 5, 13, 23, 5, 16, 6, 4, 7, 7, 13, 5, 15, 9, 14, 19, 20, 6, 12, 19, 0, 19]"
32,27,63,21,536,0,59,4,"[0, 1, 0, 1, 0, 0, 0, 0, 0, 1, 1, 0, 0, 0, 0, 1, 1, 0, 0, 1, 0, 1, 0, 1, 0, 1, 1, 0, 0]"
33,27,90,64,562,0,45,45,"[4, 7, 1, 15, 13, 3, 6, 4, 8, 12, 15, 3, 1, 5, 0, 3, 10, 0, 15, 7, 13, 11, 4, 15, 0, 9, 1, 0, 2]"
34,27,74,52,584,0,1,73,"[2, 22, 10, 24, 4, 14, 7, 20, 20, 15, 24, 21, 12, 5, 19, 12, 7, 0, 20, 17, 10, 12, 10, 21, 21, 11, 2, 0, 12]"
35,27,49,32,601,0,25,24,"[3, 5, 7, 8, 2, 2, 5, 4, 5, 3, 8, 2, 5, 6, 6, 5, 6, 1, 6, 1, 6, 6, 7, 2, 8, 7, 5, 0, 5]"
36,27,31,3,629,0,26,5,"[0, 1, 1, 1, 0, 0, 1, 0, 1, 1, 1, 1, 1, 0, 1, 1, 0, 1, 0, 0, 0, 1, 1, 0, 1, 1, 1, 0, 1]"
37,27,80,33,676,0,29,51,"[1, 6, 12, 17, 8, 10, 3, 15, 7, 3, 17, 0, 10, 12, 9, 7, 12, 15, 8, 7, 5, 4, 7, 2, 15, 16, 13, 0, 16]"
38,27,26,21,681,0,15,11,"[0, 2, 0, 3, 0, 0, 3, 1, 2, 2, 3, 2, 2, 2, 1, 0, 3, 2, 1, 1, 0, 1, 2, 2, 2, 1, 0, 0, 2]"
39,27,10,4,687,0,1,9,"[2, 3, 2, 3, 3, 1, 3, 3, 2, 2, 3, 0, 3, 2, 0, 3, 2, 1, 3, 0, 2, 1, 1, 3, 1, 3, 0, 0, 3]"
40,27,32,31,688,0,1,31,"[9, 6, 1, 10, 9, 9, 8, 2, 5, 9, 10, 10, 7, 9, 8, 7, 4, 9, 7, 7, 6, 0, 10, 5, 4, 7, 1, 0, 1]"
41,27,16,16,688,0,3,13,"[1, 0, 0, 4, 2, 3, 3, 4, 1, 0, 4, 4, 1, 3, 3, 0, 4, 2, 2, 3, 0, 4, 2, 2, 3, 2, 1, 0, 3]"
42,27,64,33,719,0,27,37,"[8, 12, 2, 12, 4, 2, 3, 7, 7, 6, 12, 1, 2, 3, 1, 6, 1, 1, 2, 11, 0, 10, 6, 5, 5, 4, 8, 0, 4]"
43,27,73,65,727,0,20,53,"[1, 3, 9, 17, 3, 2, 6, 9, 9, 17, 17, 11, 1, 9, 17, 13, 6, 13, 3, 6, 0, 15, 4, 14, 15, 1, 4, 0, 15]"
44,27,32,4,755,0,11,21,"[7, 4, 1, 7, 7, 6, 2, 0, 0, 2, 7, 3, 5, 7, 1, 5, 7, 7, 3, 1, 3, 5, 2, 3, 6, 1, 1, 0, 5]"
45,27,94,48,801,0,26,68,"[0, 2, 4, 22, 3, 2, 16, 9, 8, 5, 22, 20, 9, 3, 8, 2, 19, 6, 1, 14, 8, 6, 9, 6, 6, 5, 16, 0, 12]"
46,27,91,44,848,0,55,36,"[1, 10, 7, 12, 8, 0, 0, 10, 5, 8, 12, 9, 8, 12, 8, 7, 4, 12, 6, 6, 1, 3, 12, 6, 10, 8, 5, 0, 2]"
47,27,65,50,863,0,19,46,"[8, 14, 14, 15, 8, 4, 13, 2, 13, 11, 15, 7, 4, 1, 4, 11, 5, 7, 11, 11, 14, 13, 11, 15, 5, 8, 15, 0, 15]"
48,27,62,12,913,0,61,1,"[0, 0, 0, 0, 0, 0, 0, 0, 0, 0, 0, 0, 0, 0, 0, 0, 0, 0, 0, 0, 0, 0, 0, 0, 0, 0, 0, 0, 0]"
49,27,38,31,920,0,18,20,"[4, 1, 2, 6, 2, 0, 6, 1, 2, 2, 6, 4, 3, 0, 2, 3, 1, 6, 6, 0, 3, 1, 4, 1, 1, 4, 4, 0, 5]"
50,27,61,1,980,0,8,53,"[9, 8, 4, 17, 16, 4, 1, 6, 4, 6, 17, 2, 15, 9, 15, 2, 16, 9, 7, 16, 8, 11, 17, 15, 5, 8, 6, 0, 17]"
51,27,98,61,1017,0,15,83,"[10, 4, 20, 27, 14, 11, 12, 8, 14, 22, 27, 12, 10, 9, 3, 10, 15, 21, 9, 14, 0, 0, 23, 25, 9, 16, 18, 0, 5]"
52,27,77,13,1081,0,0,77,"[23, 17, 17, 25, 4, 23, 7, 25, 21, 15, 25, 2, 18, 25, 23, 7, 25, 7, 5, 9, 23, 10, 20, 4, 15, 4, 6, 0, 4]"
53,27,80,26,1135,0,50,30,"[0, 2, 3, 10, 8, 4, 4, 4, 0, 1, 10, 7, 6, 9, 10, 4, 6, 6, 4, 7, 3, 2, 2, 9, 4, 8, 6, 0, 10]"
54,27,18,7,1146,0,10,8,"[1, 1, 0, 2, 0, 2, 2, 1, 2, 0, 2, 0, 1, 1, 1, 2, 2, 2, 0, 2, 2, 2, 1, 1, 2, 1, 0, 0, 0]"
55,27,35,5,1176,0,4,31,"[7, 7, 2, 10, 5, 4, 9, 10, 5, 8, 10, 2, 5, 2, 7, 1, 4, 4, 3, 2, 4, 10, 7, 5, 9, 5, 0, 0, 5]"
56,27,77,77,1176,0,74,3,"[1, 1, 0, 1, 1, 1, 0, 1, 1, 1, 1, 1, 1, 0, 1, 0, 0, 0, 0, 0, 1, 1, 0, 1, 1, 0, 1, 0, 1]"
57,27,60,54,1182,0,32,28,"[4, 3, 7, 9, 3, 1, 4, 0, 7, 7, 9, 7, 8, 6, 3, 2, 9, 4, 2, 0, 8, 2, 6, 4, 3, 6, 4, 0, 9]"
58,27,92,89,1185,0,53,39,"[0, 8, 10, 13, 8, 7, 10, 11, 9, 7, 13, 8, 1, 10, 7, 10, 6, 6, 7, 7, 12, 12, 13, 10, 11, 13, 10, 0, 7]"
59,27,12,12,1185,0,1,11,"[3, 2, 2, 3, 3, 3, 3, 2, 2, 1, 3, 0, 0, 0, 3, 3, 2, 2, 1, 2, 1, 2, 2, 3, 1, 3, 1, 0, 0]"
60,27,57,46,1196,0,20,37,"[3, 10, 1, 12, 2, 4, 12, 6, 10, 5, 12, 5, 1, 4, 7, 3, 1, 3, 4, 9, 7, 7, 0, 2, 11, 6, 9, 0, 6]"
61,27,14,4,1206,0,3,11,"[1, 2, 3, 3, 3, 1, 3, 3, 1, 0, 3, 2, 0, 2, 3, 1, 0, 1, 3, 3, 2, 2, 0, 0, 0, 3, 0, 0, 0]"
62,27,73,23,1256,0,16,57,"[6, 7, 17, 19, 0, 6, 6, 9, 16, 1, 19, 15, 9, 12, 12, 0, 10, 16, 4, 3, 1, 3, 12, 14, 6, 13, 4, 0, 17]"
63,27,1,0,1207,0,0,1,"[0, 0, 0, 0, 0, 0, 0, 0, 0, 0, 0, 0, 0, 0, 0, 0, 0, 0, 0, 0, 0, 0, 0, 0, 0, 0, 0, 0, 0]"
64,27,26,12,1221,0,18,8,"[1, 2, 1, 2, 2, 2, 1, 1, 1, 0, 2, 2, 0, 0, 0, 1, 1, 0, 0, 1, 1, 2, 1, 2, 2, 2, 1, 0, 0]"
65,27,2,0,1223,0,2,0,"[0, 0, 0, 0, 0, 0, 0, 0, 0, 0, 0, 0, 0, 0, 0, 0, 0, 0, 0, 0, 0, 0, 0, 0, 0, 0, 0, 0, 0]"
66,27,84,68,1239,0,58,26,"[7, 6, 0, 8, 1, 0, 0, 3, 3, 8, 8, 5, 4, 0, 8, 7, 3, 0, 3, 3, 5, 2, 0, 5, 8, 2, 7, 0, 0]"
67,27,18,13,1244,0,14,4,"[1, 1, 1, 1, 0, 0, 1, 1, 0, 0, 1, 0, 0, 0, 0, 1, 0, 0, 0, 1, 1, 0, 1, 0, 1, 1, 0, 0, 1]"
68,27,78,54,1268,0,14,64,"[20, 19, 19, 21, 4, 9, 13, 13, 18, 15, 21, 21, 16, 2, 3, 11, 0, 1, 6, 17, 3, 4, 16, 16, 5, 13, 17, 0, 9]"
69,27,93,7,1354,0,45,48,"[2, 8, 8, 16, 1, 10, 3, 8, 6, 15, 16, 0, 15, 15, 10, 13, 1, 10, 3, 0, 10, 0, 6, 7, 0, 2, 16, 0, 12]"
70,27,77,6,1425,0,13,64,"[8, 14, 11, 21, 4, 3, 17, 5, 9, 12, 21, 3, 10, 21, 7, 3, 13, 0, 14, 2, 1, 6, 1, 21, 6, 10, 2, 0, 21]"
71,27,29,28,1426,0,5,24,"[8, 2, 3, 8, 4, 4, 2, 6, 3, 6, 8, 1, 5, 8, 6, 1, 4, 2, 5, 7, 4, 2, 5, 0, 8, 0, 5, 0, 7]"
72,27,2,1,1427,0,0,2,"[0, 0, 0, 0, 0, 0, 0, 0, 0, 0, 0, 0, 0, 0, 0, 0, 0, 0, 0, 0, 0, 0, 0, 0, 0, 0, 0, 0, 0]"
73,27,1,0,1427,0,0,1,"[0, 0, 0, 0, 0, 0, 0, 0, 0, 0, 0, 0, 0, 0, 0, 0, 0, 0, 0, 0, 0, 0, 0, 0, 0, 0, 0, 0, 0]"
74,27,80,40,1467,0,33,47,"[6, 10, 3, 15, 12, 1, 11, 4, 5, 2, 15, 10, 12, 15, 13, 4, 8, 1, 7, 12, 11, 1, 13, 11, 5, 1, 7, 0, 13]"
75,27,31,5,1493,0,15,16,"[0, 4, 1, 5, 1, 2, 5, 3, 4, 4, 5, 3, 3, 2, 5, 3, 4, 2, 2, 3, 4, 3, 0, 3, 4, 1, 0, 0, 3]"
76,27,81,77,1497,0,51,30,"[4, 8, 10, 10, 1, 4, 6, 8, 9, 1, 10, 4, 9, 7, 6, 2, 9, 7, 1, 2, 7, 8, 0, 5, 1, 10, 2, 0, 5]"
77,27,90,78,1509,0,87,3,"[0, 0, 1, 1, 1, 1, 1, 0, 1, 0, 1, 0, 1, 0, 1, 0, 0, 0, 0, 0, 0, 0, 0, 0, 1, 1, 1, 0, 0]"
78,27,21,4,1526,0,0,21,"[4, 6, 7, 7, 7, 0, 0, 5, 4, 1, 7, 2, 7, 3, 2, 2, 3, 5, 7, 4, 1, 1, 2, 0, 4, 0, 3, 0, 0]"
79,27,75,11,1590,0,9,66,"[5, 8, 14, 22, 5, 1, 14, 4, 19, 10, 22, 4, 8, 21, 18, 21, 17, 7, 6, 5, 19, 7, 9, 17, 7, 16, 9, 0, 18]"
80,27,55,43,1602,0,13,42,"[1, 2, 4, 14, 10, 10, 7, 6, 1, 12, 14, 10, 11, 7, 10, 14, 7, 10, 4, 8, 9, 7, 0, 0, 10, 3, 12, 0, 12]"
81,27,34,3,1633,0,3,31,"[0, 3, 10, 10, 4, 5, 2, 9, 6, 1, 10, 9, 0, 5, 5, 4, 3, 1, 5, 5, 7, 9, 5, 5, 8, 0, 7, 0, 10]"
82,27,55,39,1649,0,36,19,"[3, 2, 5, 6, 5, 6, 5, 3, 2, 1, 6, 5, 3, 1, 1, 6, 3, 1, 4, 6, 5, 5, 5, 3, 3, 3, 3, 0, 4]"
83,27,73,33,1689,0,33,40,"[7, 5, 11, 13, 13, 10, 9, 8, 5, 5, 13, 9, 2, 4, 12, 1, 10, 6, 12, 0, 9, 5, 11, 6, 5, 0, 11, 0, 7]"
84,27,27,12,1704,0,12,15,"[4, 1, 4, 5, 1, 5, 3, 1, 3, 2, 5, 4, 5, 4, 4, 2, 2, 4, 1, 4, 3, 1, 5, 3, 1, 5, 1, 0, 1]"
85,27,72,19,1757,0,34,38,"[1, 12, 4, 12, 1, 3, 6, 4, 11, 6, 12, 5, 11, 3, 3, 0, 1, 7, 0, 4, 5, 10, 6, 4, 0, 3, 0, 0, 9]"
86,27,46,40,1763,0,38,8,"[0, 0, 0, 2, 2, 0, 0, 0, 0, 1, 2, 1, 1, 2, 1, 0, 2, 2, 2, 2, 2, 1, 2, 2, 1, 2, 2, 0, 1]"
87,27,40,38,1765,0,37,3,"[1, 1, 0, 1, 1, 1, 1, 1, 0, 1, 1, 0, 0, 0, 1, 0, 1, 0, 0, 0, 0, 1, 0, 0, 1, 0, 0, 0, 1]"
88,27,1,0,1764,0,0,1,"[0, 0, 0, 0, 0, 0, 0, 0, 0, 0, 0, 0, 0, 0, 0, 0, 0, 0, 0, 0, 0, 0, 0, 0, 0, 0, 0, 0, 0]"
89,27,38,5,1797,0,27,11,"[0, 2, 0, 3, 3, 0, 0, 1, 3, 3, 3, 1, 0, 1, 3, 2, 1, 3, 0, 3, 1, 2, 0, 1, 2, 2, 2, 0, 2]"
90,27,97,87,1807,0,48,49,"[6, 13, 1, 16, 10, 7, 15, 13, 0, 8, 16, 3, 15, 11, 10, 8, 1, 8, 9, 11, 5, 4, 3, 3, 0, 10, 15, 0, 1]"
91,27,31,2,1836,0,1,30,"[8, 7, 10, 10, 9, 10, 8, 6, 0, 8, 10, 2, 2, 0, 6, 4, 4, 2, 1, 9, 5, 8, 5, 6, 0, 1, 9, 0, 3]"
92,27,49,7,1878,0,45,4,"[1, 1, 0, 1, 0, 0, 1, 1, 0, 1, 1, 0, 0, 1, 1, 1, 0, 1, 0, 1, 1, 0, 0, 0, 0, 1, 1, 0, 0]"
93,27,94,77,1895,0,67,27,"[4, 3, 5, 9, 7, 1, 0, 8, 8, 2, 9, 9, 6, 2, 4, 8, 3, 8, 5, 4, 6, 4, 3, 6, 7, 1, 5, 0, 9]"
94,27,91,31,1955,0,8,83,"[26, 4, 2, 27, 12, 1, 4, 7, 1, 22, 27, 15, 21, 18, 5, 4, 9, 2, 12, 16, 26, 20, 2, 12, 27, 6, 8, 0, 12]"
95,27,37,4,1988,0,3,34,"[0, 6, 4, 11, 5, 8, 2, 0, 1, 7, 11, 8, 10, 3, 9, 2, 0, 11, 6, 9, 4, 0, 2, 9, 0, 4, 5, 0, 9]"
96,27,27,6,2009,0,25,2,"[0, 0, 0, 0, 0, 0, 0, 0, 0, 0, 0, 0, 0, 0, 0, 0, 0, 0, 0, 0, 0, 0, 0, 0, 0, 0, 0, 0, 0]"
97,27,40,36,2013,0,1,39,"[4, 4, 2, 13, 9, 6, 7, 0, 5, 6, 13, 12, 9, 8, 4, 0, 10, 10, 9, 3, 5, 6, 2, 1, 0, 1, 4, 0, 1]"
98,27,93,29,2077,0,17,76,"[3, 16, 25, 25, 10, 17, 6, 24, 24, 21, 25, 25, 0, 10, 0, 16, 20, 5, 9, 2, 1, 21, 19, 21, 23, 1, 6, 0, 0]"
99,27,8,7,2078,0,4,4,"[0, 0, 1, 1, 1, 0, 1, 1, 1, 0, 1, 0, 1, 0, 0, 1, 1, 0, 0, 1, 1, 0, 0, 1, 1, 0, 1, 0, 0]"
100,27,74,21,2131,0,55,19,"[2, 2, 6, 6, 0, 6, 0, 4, 0, 6, 6, 2, 2, 5, 5, 2, 4, 5, 4, 3, 0, 3, 4, 6, 4, 2, 2, 0, 4]"
101,27,73,53,2151,0,57,16,"[4, 2, 5, 5, 2, 5, 2, 3, 2, 1, 5, 1, 2, 5, 1, 1, 1, 5, 4, 2, 5, 1, 0, 5, 4, 5, 0, 0, 1]"
102,27,78,37,2192,0,34,44,"[8, 4, 11, 14, 11, 7, 2, 4, 13, 14, 14, 14, 9, 8, 6, 13, 13, 11, 1, 10, 5, 9, 7, 14, 10, 13, 5, 0, 3]"
103,27,97,56,2233,0,72,25,"[3, 2, 5, 8, 6, 2, 1, 5, 1, 0, 8, 8, 8, 1, 6, 1, 1, 1, 2, 7, 3, 7, 0, 2, 8, 8, 8, 0, 2]"
104,27,79,31,2281,0,50,29,"[9, 9, 8, 9, 6, 7, 2, 0, 1, 2, 9, 8, 6, 0, 3, 2, 1, 3, 1, 3, 8, 4, 2, 3, 5, 9, 1, 0, 4]"
105,27,91,74,2298,0,9,82,"[6, 26, 15, 27, 15, 11, 9, 27, 12, 14, 27, 23, 3, 7, 6, 19, 8, 4, 4, 17, 14, 3, 25, 5, 1, 3, 23, 0, 14]"
106,27,99,89,2308,0,75,24,"[4, 2, 1, 8, 3, 1, 1, 6, 0, 4, 8, 3, 3, 0, 3, 8, 1, 2, 8, 2, 4, 0, 5, 8, 5, 3, 8, 0, 5]"
107,27,74,60,2322,0,2,72,"[18, 21, 19, 24, 1, 22, 16, 1, 4, 6, 24, 3, 18, 7, 2, 1, 9, 18, 9, 10, 6, 3, 12, 6, 6, 16, 1, 0, 2]"
108,27,83,22,2383,0,37,46,"[1, 3, 14, 15, 14, 5, 14, 15, 2, 2, 15, 12, 14, 6, 15, 8, 6, 7, 1, 8, 13, 15, 15, 10, 10, 4, 10, 0, 4]"
109,27,72,29,2426,0,49,23,"[5, 2, 5, 7, 0, 0, 4, 7, 2, 5, 7, 1, 2, 6, 7, 2, 5, 6, 4, 3, 4, 7, 0, 2, 2, 0, 1, 0, 6]"
110,27,62,21,2467,0,41,21,"[2, 3, 1, 7, 6, 0, 4, 2, 5, 5, 7, 1, 5, 4, 5, 6, 2, 1, 0, 3, 4, 4, 2, 7, 0, 6, 0, 0, 7]"
111,27,16,12,2471,0,0,16,"[0, 0, 3, 5, 5, 2, 3, 1, 2, 5, 5, 5, 0, 0, 0, 3, 1, 0, 3, 4, 2, 2, 4, 2, 2, 0, 5, 0, 5]"
112,27,0,0,2471,0,0,0,"[0, 0, 0, 0, 0, 0, 0, 0, 0, 0, 0, 0, 0, 0, 0, 0, 0, 0, 0, 0, 0, 0, 0, 0, 0, 0, 0, 0, 0]"
113,27,47,33,2485,0,43,4,"[0, 0, 1, 1, 1, 0, 0, 1, 0, 0, 1, 1, 1, 0, 1, 0, 0, 0, 1, 1, 0, 1, 0, 0, 1, 0, 1, 0, 1]"
114,27,90,54,2521,0,48,42,"[11, 11, 13, 14, 11, 10, 12, 11, 14, 2, 14, 13, 0, 13, 7, 7, 14, 2, 1, 3, 13, 8, 5, 1, 10, 5, 10, 0, 14]"
115,27,15,9,2527,0,4,11,"[0, 1, 0, 3, 0, 3, 2, 1, 2, 2, 3, 3, 0, 1, 1, 2, 2, 0, 1, 2, 1, 2, 1, 1, 2, 1, 0, 0, 2]"
116,27,75,55,2547,0,47,28,"[6, 6, 9, 9, 6, 0, 6, 9, 3, 6, 9, 0, 3, 6, 2, 5, 8, 9, 2, 7, 8, 5, 3, 3, 8, 0, 4, 0, 5]"
117,27,52,19,2580,0,12,40,"[5, 1, 13, 13, 0, 3, 7, 6, 9, 3, 13, 9, 4, 2, 6, 5, 12, 6, 1, 4, 2, 9, 7, 10, 0, 11, 9, 0, 12]"
118,27,12,1,2591,0,5,7,"[2, 2, 1, 2, 2, 2, 0, 0, 0, 2, 2, 1, 1, 0, 0, 0, 2, 0, 0, 2, 1, 2, 1, 2, 2, 0, 2, 0, 2]"
119,27,73,6,2658,0,47,26,"[0, 4, 5, 8, 1, 1, 2, 2, 7, 1, 8, 5, 3, 3, 4, 8, 6, 5, 0, 4, 2, 2, 5, 1, 3, 0, 0, 0, 0]"
0,28,3042,0,3042,0,1021,2021,"[352, 346, 541, 455, 136, 405, 220, 51, 413, 501, 416, 508, 673, 19, 483, 255, 25, 370, 606, 241, 618, 427, 96, 286, 652, 673, 116, 158, 0]"
1,28,3348,1505,4885,0,2115,1233,"[172, 93, 29, 28, 88, 170, 133, 335, 268, 282, 403, 248, 411, 221, 335, 406, 262, 132, 225, 228, 314, 326, 289, 187, 175, 411, 95, 229, 0]"
2,28,4122,790,8217,0,574,3548,"[386, 6, 63, 238, 712, 290, 914, 1047, 332, 371, 149, 801, 1182, 422, 365, 902, 690, 91, 922, 1169, 779, 1111, 834, 887, 767, 1182, 449, 761, 0]"
3,28,4162,5401,6978,0,1875,2287,"[447, 461, 704, 354, 689, 697, 490, 168, 321, 9, 437, 308, 762, 672, 458, 672, 391, 135, 751, 219, 652, 124, 647, 175, 420, 762, 461, 127, 0]"
4,28,4284,7127,4135,0,1969,2315,"[290, 284, 385, 131, 730, 331, 326, 769, 770, 754, 187, 628, 771, 210, 206, 107, 400, 672, 700, 162, 691, 290, 723, 768, 533, 771, 351, 377, 0]"
5,28,3378,3109,4404,0,3052,326,"[75, 37, 74, 66, 23, 65, 106, 49, 29, 106, 45, 105, 108, 2, 87, 24, 25, 107, 75, 78, 29, 92, 64, 99, 95, 108, 70, 22, 0]"
6,28,4443,1833,7014,0,553,3890,"[936, 881, 85, 687, 959, 952, 364, 430, 314, 839, 446, 175, 1296, 781, 637, 271, 528, 535, 257, 521, 716, 565, 891, 572, 879, 1296, 681, 33, 0]"
7,28,3407,2658,7763,0,3277,130,"[43, 36, 23, 9, 38, 15, 4, 4, 5, 13, 3, 26, 43, 2, 37, 22, 37, 17, 42, 38, 22, 27, 34, 29, 43, 43, 33, 14, 0]"
8,28,3429,5033,6159,0,3419,10,"[0, 3, 0, 3, 2, 3, 1, 1, 2, 2, 0, 3, 3, 2, 3, 0, 2, 2, 3, 3, 0, 0, 3, 0, 0, 3, 1, 1, 0]"
9,28,4360,79,10000,440,3244,1116,"[286, 275, 166, 275, 155, 83, 371, 331, 39, 371, 214, 61, 372, 256, 259, 8, 7, 233, 174, 318, 47, 71, 147, 370, 102, 372, 309, 55, 0]"
10,28,3480,5043,8437,0,1762,1718,"[96, 398, 514, 140, 259, 240, 19, 308, 310, 560, 276, 408, 572, 136, 446, 36, 460, 459, 240, 480, 446, 526, 210, 413, 263, 572, 442, 390, 0]"
11,28,4915,5660,7692,0,1150,3765,"[266, 224, 208, 791, 1066, 1104, 459, 1102, 1031, 914, 313, 637, 1255, 372, 65, 0, 64, 150, 460, 75, 135, 869, 62, 357, 777, 1255, 8, 741, 0]"
12,28,3937,5121,6508,0,3557,380,"[104, 87, 18, 41, 13, 125, 117, 70, 98, 17, 70, 46, 126, 46, 21, 57, 122, 7, 18, 48, 46, 66, 20, 68, 125, 126, 19, 16, 0]"
13,28,3349,1167,8690,0,249,3100,"[738, 1003, 304, 859, 805, 437, 841, 532, 279, 694, 974, 879, 1033, 273, 337, 532, 876, 358, 613, 97, 266, 484, 633, 469, 358, 1033, 969, 752, 0]"
14,28,4902,5735,7857,0,3535,1367,"[1, 72, 388, 47, 359, 205, 303, 168, 15, 302, 134, 127, 455, 252, 377, 242, 82, 204, 379, 429, 437, 282, 233, 54, 98, 455, 354, 247, 0]"
15,28,4749,5417,7189,0,1630,3119,"[166, 421, 680, 904, 788, 144, 141, 727, 770, 477, 1024, 706, 1039, 593, 717, 131, 101, 146, 991, 436, 242, 104, 477, 1024, 568, 1039, 1002, 102, 0]"
16,28,3900,5303,5786,0,2813,1087,"[69, 211, 174, 3, 247, 284, 326, 58, 9, 137, 302, 224, 362, 62, 91, 291, 266, 247, 67, 298, 224, 219, 111, 102, 232, 362, 179, 168, 0]"
17,28,3975,1367,8394,0,1145,2830,"[448, 475, 268, 898, 878, 434, 904, 351, 152, 649, 602, 33, 943, 413, 854, 42, 864, 388, 60, 623, 416, 709, 456, 85, 487, 943, 871, 209, 0]"
18,28,3828,6634,5588,0,1270,2558,"[332, 341, 199, 456, 222, 264, 272, 629, 170, 77, 211, 599, 852, 59, 615, 682, 757, 228, 655, 67, 818, 599, 213, 432, 602, 852, 733, 626, 0]"
19,28,4210,3253,6545,0,139,4071,"[1032, 1020, 234, 1035, 201, 154, 66, 1321, 236, 247, 823, 1226, 1357, 71, 417, 515, 1297, 1152, 1220, 361, 1160, 962, 737, 325, 1091, 1357, 616, 964, 0]"
20,28,3570,1370,8745,0,2213,1357,"[165, 380, 242, 216, 415, 271, 249, 216, 27, 292, 92, 247, 452, 437, 262, 332, 106, 224, 65, 264, 165, 431, 0, 435, 125, 452, 53, 130, 0]"
21,28,3360,6736,5369,0,812,2548,"[572, 273, 680, 527, 133, 496, 265, 128, 840, 844, 783, 461, 849, 490, 314, 564, 256, 425, 728, 678, 352, 599, 740, 36, 232, 849, 236, 242, 0]"
22,28,4426,2865,6930,0,3947,479,"[125, 129, 45, 72, 91, 57, 49, 53, 138, 45, 108, 77, 159, 40, 66, 28, 67, 13, 115, 98, 85, 82, 82, 97, 112, 159, 14, 6, 0]"
23,28,4795,7158,4567,0,2222,2573,"[85, 662, 590, 193, 382, 633, 848, 657, 413, 519, 398, 629, 857, 61, 642, 55, 839, 407, 404, 251, 139, 520, 449, 798, 486, 857, 193, 592, 0]"
24,28,3213,1337,6443,0,924,2289,"[216, 285, 443, 207, 141, 574, 129, 354, 733, 544, 253, 418, 763, 339, 538, 587, 74, 487, 731, 545, 327, 90, 473, 86, 242, 763, 476, 301, 0]"
25,28,4598,6791,4250,0,3172,1426,"[234, 203, 354, 235, 208, 103, 79, 41, 351, 81, 79, 273, 475, 6, 153, 160, 317, 429, 164, 118, 35, 95, 269, 102, 434, 475, 46, 323, 0]"
26,28,3431,1834,5847,0,2253,1178,"[57, 74, 192, 383, 320, 134, 283, 280, 252, 338, 62, 82, 392, 158, 153, 266, 364, 262, 38, 351, 90, 197, 156, 92, 146, 392, 209, 333, 0]"
27,28,4990,1846,8991,0,2697,2293,"[45, 655, 753, 447, 628, 431, 35, 545, 509, 442, 649, 340, 764, 461, 631, 81, 389, 280, 197, 225, 747, 363, 565, 130, 514, 764, 580, 738, 0]"
28,28,4829,7138,6682,0,3575,1254,"[400, 176, 88, 97, 416, 134, 358, 399, 348, 129, 416, 395, 418, 378, 409, 237, 333, 307, 4, 37, 336, 388, 246, 242, 217, 418, 20, 77, 0]"
29,28,4622,6654,4650,0,1632,2990,"[142, 974, 633, 323, 861, 174, 215, 11, 574, 785, 601, 517, 996, 563, 464, 496, 353, 504, 137, 626, 572, 91, 597, 758, 567, 996, 315, 252, 0]"
30,28,3257,2831,5076,0,1699,1558,"[207, 130, 124, 371, 403, 155, 194, 264, 136, 385, 395, 89, 519, 483, 388, 438, 415, 385, 56, 248, 497, 414, 176, 458, 213, 519, 45, 106, 0]"
31,28,3848,1931,6993,0,425,3423,"[323, 89, 258, 734, 708, 378, 97, 870, 847, 793, 635, 323, 1141, 1056, 149, 5, 1127, 811, 49, 730, 138, 373, 537, 791, 55, 1141, 195, 596, 0]"
32,28,4747,5155,6585,0,2438,2309,"[291, 445, 381, 421, 210, 534, 601, 271, 358, 251, 211, 490, 769, 575, 148, 263, 51, 695, 191, 135, 763, 55, 77, 657, 345, 769, 749, 523, 0]"
33,28,4518,6114,4989,0,1447,3071,"[837, 499, 823, 387, 783, 334, 290, 337, 180, 980, 271, 990, 1023, 391, 387, 955, 838, 460, 806, 646, 351, 509, 713, 680, 109, 1023, 740, 592, 0]"
34,28,3427,1873,6543,0,1443,1984,"[548, 647, 253, 40, 297, 455, 101, 136, 10, 516, 416, 424, 661, 33, 511, 345, 468, 179, 273, 95, 464, 151, 269, 228, 300, 661, 353, 580, 0]"
35,28,4265,4166,6642,0,32,4233,"[695, 816, 118, 352, 83, 450, 227, 804, 551, 837, 777, 1022, 1411, 707, 554, 582, 1353, 204, 287, 631, 172, 671, 1096, 225, 680, 1411, 1155, 1053, 0]"
36,28,4471,7117,3996,0,2449,2022,"[555, 212, 186, 138, 246, 319, 396, 211, 588, 243, 37, 219, 674, 541, 302, 467, 195, 431, 633, 98, 113, 191, 314, 261, 220, 674, 234, 651, 0]"
37,28,4733,3677,5052,0,4307,426,"[133, 87, 98, 62, 12, 4, 9, 64, 69, 126, 10, 66, 142, 50, 80, 79, 116, 129, 22, 21, 31, 99, 68, 23, 112, 142, 38, 98, 0]"
38,28,4105,588,8569,0,2251,1854,"[616, 451, 328, 389, 170, 203, 437, 604, 225, 395, 447, 375, 618, 442, 436, 389, 340, 488, 9, 383, 78, 121, 77, 248, 220, 618, 590, 460, 0]"
39,28,3260,6510,5319,0,1001,2259,"[167, 51, 106, 406, 46, 673, 293, 586, 581, 81, 267, 628, 753, 537, 44, 36, 201, 591, 458, 113, 188, 447, 568, 456, 155, 753, 506, 311, 0]"
40,28,4329,439,9209,0,1393,2936,"[403, 773, 705, 781, 772, 372, 960, 499, 683, 266, 845, 857, 978, 75, 17, 400, 754, 774, 138, 719, 558, 403, 563, 768, 820, 978, 138, 763, 0]"
41,28,4150,6174,7185,0,2932,1218,"[202, 363, 235, 94, 174, 76, 162, 234, 314, 250, 349, 118, 406, 252, 161, 175, 327, 140, 0, 88, 54, 17, 281, 25, 48, 406, 264, 288, 0]"
42,28,4809,5675,6319,0,1709,3100,"[969, 925, 634, 343, 366, 186, 681, 239, 38, 409, 478, 357, 1033, 741, 97, 648, 734, 136, 533, 769, 501, 115, 1011, 511, 139, 1033, 498, 882, 0]"
43,28,4171,1450,9040,0,37,4134,"[51, 956, 1137, 1249, 484, 87, 266, 525, 721, 361, 1076, 893, 1378, 170, 433, 896, 148, 7, 671, 1079, 1019, 1245, 38, 1131, 361, 1378, 437, 596, 0]"
44,28,3412,6654,5798,0,2820,592,"[18, 173, 155, 187, 23, 39, 181, 109, 194, 162, 45, 17, 197, 12, 146, 77, 196, 175, 165, 79, 5, 109, 10, 18, 3, 197, 5, 197, 0]"
45,28,3621,2506,6913,0,2593,1028,"[246, 140, 141, 336, 167, 42, 171, 159, 50, 236, 118, 152, 342, 17, 247, 76, 8, 259, 149, 130, 158, 81, 338, 99, 60, 342, 125, 270, 0]"
46,28,4931,6863,4981,0,2320,2611,"[842, 356, 58, 743, 598, 401, 388, 866, 235, 513, 305, 812, 870, 438, 589, 630, 613, 319, 864, 442, 638, 782, 699, 267, 526, 870, 553, 546, 0]"
47,28,3782,2635,6128,0,2252,1530,"[133, 456, 420, 24, 318, 99, 191, 227, 62, 461, 397, 429, 510, 163, 125, 232, 289, 169, 195, 322, 467, 150, 143, 125, 132, 510, 329, 417, 0]"
48,28,4324,2152,8300,0,837,3487,"[459, 448, 306, 105, 1146, 739, 917, 933, 416, 800, 399, 538, 1162, 540, 670, 183, 1008, 926, 836, 698, 625, 141, 940, 688, 497, 1162, 736, 951, 0]"
49,28,4052,6233,6119,0,2146,1906,"[597, 508, 484, 10, 15, 398, 28, 446, 561, 266, 100, 41, 635, 465, 574, 156, 402, 229, 54, 464, 169, 39, 260, 578, 425, 635, 343, 545, 0]"
50,28,3559,2547,7131,0,1896,1663,"[0, 444, 276, 237, 284, 26, 21, 227, 80, 474, 49, 428, 554, 152, 82, 488, 264, 410, 179, 346, 554, 486, 441, 173, 19, 554, 173, 136, 0]"
51,28,4182,5230,6083,0,4039,143,"[34, 31, 21, 22, 42, 16, 36, 18, 1, 27, 21, 33, 47, 6, 45, 18, 16, 24, 13, 24, 20, 17, 15, 21, 17, 47, 16, 6, 0]"
52,28,3846,1017,8912,0,2335,1511,"[156, 242, 201, 101, 394, 414, 65, 246, 56, 193, 339, 328, 503, 273, 65, 271, 500, 432, 238, 68, 275, 336, 361, 11, 62, 503, 481, 468, 0]"
53,28,3221,6050,6083,0,623,2598,"[96, 66, 700, 396, 456, 458, 629, 845, 350, 511, 217, 223, 866, 433, 214, 601, 77, 184, 812, 305, 826, 547, 264, 774, 379, 866, 492, 306, 0]"
54,28,3160,3070,6173,0,212,2948,"[779, 622, 941, 99, 862, 698, 503, 159, 250, 724, 369, 950, 982, 669, 981, 227, 533, 209, 196, 873, 955, 380, 376, 683, 114, 982, 768, 391, 0]"
55,28,4720,264,10000,629,3729,991,"[313, 18, 35, 280, 129, 164, 4, 227, 67, 68, 81, 289, 330, 124, 305, 182, 136, 221, 1, 97, 70, 45, 214, 300, 73, 330, 99, 83, 0]"
56,28,4679,6828,7851,0,4351,328,"[109, 22, 71, 5, 81, 17, 37, 10, 35, 100, 30, 67, 109, 56, 85, 24, 76, 25, 61, 32, 100, 102, 106, 37, 49, 109, 35, 75, 0]"
57,28,3078,2079,8850,0,1250,1828,"[535, 6, 290, 549, 347, 353, 14, 253, 294, 245, 594, 36, 609, 314, 49, 301, 312, 233, 233, 72, 411, 158, 445, 199, 297, 609, 461, 568, 0]"
58,28,3808,6216,6442,0,3337,471,"[97, 62, 133, 91, 33, 107, 100, 73, 46, 67, 60, 114, 157, 149, 151, 50, 104, 39, 64, 105, 119, 135, 149, 129, 28, 157, 3, 84, 0]"
59,28,4142,3834,6750,0,1785,2357,"[60, 602, 760, 697, 456, 311, 753, 365, 293, 488, 316, 222, 785, 650, 704, 732, 445, 621, 702, 700, 96, 368, 242, 578, 741, 785, 632, 238, 0]"
60,28,3826,3108,7468,0,423,3403,"[103, 774, 590, 90, 282, 446, 348, 85, 704, 862, 391, 988, 1134, 506, 29, 1038, 866, 110, 757, 372, 1011, 686, 129, 125, 160, 1134, 101, 586, 0]"
61,28,4825,5654,6639,0,1044,3781,"[1175, 477, 88, 805, 1110, 796, 365, 1055, 204, 650, 770, 84, 1260, 423, 998, 686, 95, 320, 1024, 1136, 1161, 101, 48, 204, 1196, 1260, 581, 386, 0]"
62,28,3242,1433,8448,0,2610,632,"[58, 114, 210, 106, 44, 113, 88, 140, 96, 82, 90, 74, 210, 142, 196, 63, 13, 81, 102, 73, 146, 187, 105, 8, 175, 210, 134, 104, 0]"
63,28,3593,6552,5489,0,353,3240,"[958, 10, 403, 887, 1057, 878, 522, 927, 761, 940, 233, 80, 1080, 1080, 914, 441, 973, 108, 135, 241, 191, 756, 911, 325, 854, 1080, 404, 782, 0]"
64,28,4366,2623,7232,0,2242,2124,"[696, 694, 425, 598, 100, 650, 432, 336, 520, 313, 351, 119, 708, 7, 17, 217, 476, 453, 186, 421, 411, 265, 157, 568, 389, 708, 273, 102, 0]"
65,28,3489,2427,8294,0,2144,1345,"[179, 390, 415, 211, 213, 243, 273, 46, 114, 98, 88, 30, 448, 188, 418, 379, 32, 5, 160, 191, 124, 157, 84, 151, 254, 448, 208, 69, 0]"
66,28,4835,6720,6409,0,2034,2801,"[327, 520, 71, 254, 439, 30, 320, 740, 715, 661, 848, 193, 933, 551, 658, 614, 820, 88, 614, 921, 79, 165, 331, 336, 853, 933, 794, 232, 0]"
67,28,4504,3232,7681,0,2942,1562,"[78, 496, 215, 98, 310, 118, 384, 364, 421, 131, 443, 515, 520, 279, 59, 347, 177, 277, 54, 498, 165, 67, 319, 272, 186, 520, 124, 69, 0]"
68,28,4297,5710,6268,0,1919,2378,"[89, 96, 158, 289, 622, 528, 737, 594, 258, 230, 700, 400, 792, 614, 473, 692, 257, 391, 276, 219, 571, 17, 134, 393, 201, 792, 242, 780, 0]"
69,28,3368,2740,6896,0,1358,2010,"[340, 387, 634, 366, 479, 110, 658, 134, 437, 481, 600, 497, 670, 346, 482, 402, 390, 245, 201, 271, 303, 247, 491, 119, 326, 670, 237, 128, 0]"
70,28,3420,2530,7786,0,443,2977,"[539, 348, 723, 850, 47, 750, 914, 484, 560, 185, 627, 60, 992, 582, 550, 421, 500, 644, 766, 383, 703, 731, 222, 855, 515, 992, 430, 838, 0]"
71,28,3008,1434,9360,0,1095,1913,"[34, 594, 224, 614, 482, 19, 446, 144, 382, 616, 148, 420, 637, 278, 179, 116, 34, 579, 508, 305, 508, 1, 423, 308, 80, 637, 64, 425, 0]"
72,28,3513,5128,7745,0,104,3409,"[671, 106, 749, 776, 686, 746, 350, 767, 947, 876, 1103, 990, 1136, 435, 926, 77, 175, 54, 762, 389, 225, 522, 439, 727, 975, 1136, 643, 480, 0]"
73,28,3215,2642,8318,0,56,3159,"[627, 867, 97, 1050, 416, 161, 242, 94, 433, 703, 334, 484, 1053, 75, 843, 12, 283, 257, 377, 650, 53, 662, 868, 153, 71, 1053, 35, 210, 0]"
74,28,3577,5751,6144,0,90,3487,"[1133, 890, 123, 973, 846, 705, 253, 725, 1151, 346, 97, 758, 1162, 823, 325, 384, 191, 287, 255, 24, 1038, 679, 959, 1025, 216, 1162, 1108, 714, 0]"
75,28,4548,2935,7757,0,304,4244,"[932, 995, 221, 894, 495, 1361, 634, 243, 1388, 28, 616, 64, 1414, 946, 1103, 708, 907, 1242, 1165, 1, 168, 1213, 873, 1149, 207, 1414, 1028, 1010, 0]"
76,28,4956,5819,6894,0,2853,2103,"[164, 548, 333, 198, 365, 140, 619, 118, 167, 290, 468, 572, 701, 418, 151, 125, 168, 463, 445, 118, 114, 567, 291, 199, 587, 701, 221, 394, 0]"
77,28,4832,6988,4738,0,1617,3215,"[747, 0, 1, 721, 772, 593, 333, 524, 477, 74, 803, 473, 1071, 117, 692, 124, 683, 600, 574, 131, 180, 1010, 957, 285, 961, 1071, 975, 360, 0]"
78,28,3612,530,7820,0,2480,1132,"[158, 119, 81, 241, 313, 226, 294, 338, 247, 372, 114, 147, 377, 334, 215, 27, 320, 330, 189, 201, 366, 374, 260, 327, 62, 377, 7, 360, 0]"
79,28,4808,6643,5985,0,3438,1370,"[425, 85, 446, 290, 178, 316, 306, 277, 456, 176, 96, 211, 456, 332, 286, 437, 254, 338, 356, 40, 445, 292, 2, 208, 164, 456, 139, 215, 0]"
80,28,3977,1383,8579,0,816,3161,"[749, 979, 976, 205, 221, 534, 383, 1008, 737, 964, 731, 382, 1053, 513, 413, 902, 318, 948, 991, 911, 995, 648, 587, 809, 835, 1053, 458, 641, 0]"
81,28,4742,7140,6181,0,1661,3081,"[262, 685, 919, 518, 126, 549, 900, 381, 802, 389, 426, 374, 1027, 654, 573, 929, 345, 280, 204, 163, 452, 223, 956, 86, 132, 1027, 1, 857, 0]"
82,28,4234,3889,6526,0,3098,1136,"[345, 276, 48, 287, 223, 297, 235, 27, 357, 257, 145, 20, 378, 131, 164, 52, 79, 138, 60, 157, 117, 241, 142, 286, 275, 378, 79, 253, 0]"
83,28,3989,74,10000,441,2955,1034,"[178, 25, 338, 95, 87, 159, 75, 30, 123, 255, 89, 183, 344, 270, 236, 157, 189, 270, 272, 228, 313, 24, 56, 140, 138, 344, 277, 169, 0]"
84,28,3857,7270,6587,0,2532,1325,"[17, 258, 11, 235, 90, 55, 392, 392, 368, 95, 267, 341, 441, 375, 127, 90, 96, 265, 62, 126, 405, 247, 221, 54, 202, 441, 70, 111, 0]"
85,28,4180,1246,9521,0,245,3935,"[514, 882, 910, 685, 13, 1059, 1245, 887, 634, 144, 1206, 1003, 1311, 50, 1128, 401, 807, 72, 749, 35, 813, 485, 402, 388, 1267, 1311, 741, 133, 0]"
86,28,4632,5438,8715,0,951,3681,"[90, 840, 1216, 321, 225, 807, 52, 1122, 440, 156, 60, 846, 1227, 877, 164, 540, 1175, 544, 346, 473, 54, 6, 210, 538, 353, 1227, 499, 254, 0]"
87,28,4864,5011,8568,0,917,3947,"[687, 914, 366, 407, 954, 41, 848, 1242, 265, 837, 63, 1140, 1315, 629, 73, 861, 51, 211, 1147, 266, 863, 797, 659, 540, 158, 1315, 854, 496, 0]"
88,28,4449,5146,7871,0,4212,237,"[44, 30, 47, 3, 62, 50, 23, 76, 15, 36, 74, 75, 79, 37, 55, 19, 38, 35, 36, 51, 55, 52, 48, 18, 62, 79, 1, 36, 0]"
89,28,3186,6942,4115,0,2126,1060,"[181, 81, 12, 295, 306, 276, 11, 53, 79, 254, 297, 141, 353, 112, 144, 132, 29, 315, 25, 188, 143, 42, 125, 83, 149, 353, 53, 166, 0]"
90,28,4798,1207,7706,0,767,4031,"[839, 295, 549, 650, 752, 182, 470, 918, 1029, 912, 1154, 160, 1343, 414, 417, 201, 328, 612, 854, 88, 699, 267, 1292, 1153, 1046, 1343, 402, 800, 0]"
91,28,3904,7174,4436,0,1832,2072,"[483, 77, 415, 571, 57, 404, 448, 557, 599, 415, 103, 222, 690, 101, 23, 549, 299, 282, 26, 343, 464, 252, 322, 59, 354, 690, 639, 143, 0]"
92,28,3457,2551,5342,0,2880,577,"[39, 112, 18, 104, 0, 143, 123, 181, 92, 143, 109, 66, 192, 18, 175, 131, 1, 106, 122, 43, 191, 154, 125, 75, 139, 192, 108, 38, 0]"
93,28,4318,765,8895,0,541,3777,"[915, 679, 1145, 1126, 1113, 878, 1045, 327, 846, 492, 86, 968, 1259, 1258, 1075, 175, 718, 1054, 632, 371, 762, 266, 1007, 688, 658, 1259, 158, 510, 0]"
94,28,3168,6697,5366,0,2854,314,"[44, 24, 37, 7, 99, 5, 11, 96, 63, 90, 14, 72, 104, 65, 72, 26, 79, 44, 77, 4, 100, 99, 24, 55, 73, 104, 35, 1, 0]"
95,28,4233,2652,6947,0,2711,1522,"[481, 272, 395, 262, 152, 408, 53, 502, 92, 200, 264, 316, 507, 15, 237, 448, 139, 231, 143, 490, 67, 69, 49, 2, 314, 507, 236, 14, 0]"
96,28,3954,3354,7547,0,855,3099,"[513, 679, 561, 748, 707, 450, 185, 418, 448, 180, 878, 688, 1033, 575, 858, 763, 609, 644, 1006, 797, 47, 97, 98, 666, 402, 1033, 120, 51, 0]"
97,28,4448,5411,6584,0,3356,1092,"[69, 150, 293, 148, 208, 83, 91, 122, 167, 292, 231, 64, 364, 204, 267, 149, 161, 221, 28, 227, 150, 56, 170, 234, 317, 364, 214, 364, 0]"
98,28,4367,3526,7425,0,2306,2061,"[378, 490, 393, 599, 360, 127, 514, 250, 59, 132, 675, 162, 687, 423, 495, 608, 232, 80, 140, 185, 296, 251, 427, 544, 267, 687, 19, 242, 0]"
99,28,3178,2809,7794,0,2964,214,"[32, 13, 45, 70, 1, 32, 47, 68, 23, 34, 20, 41, 71, 57, 24, 52, 43, 35, 41, 35, 44, 14, 52, 45, 64, 71, 51, 4, 0]"
100,28,4388,6630,5552,0,1574,2814,"[300, 4, 48, 303, 930, 784, 332, 100, 787, 723, 27, 788, 938, 362, 381, 671, 719, 25, 275, 761, 666, 759, 313, 562, 358, 938, 279, 224, 0]"
101,28,3194,335,8411,0,716,2478,"[188, 566, 143, 520, 424, 131, 395, 520, 300, 714, 98, 591, 826, 660, 424, 189, 534, 73, 249, 605, 778, 811, 789, 320, 283, 826, 215, 438, 0]"
102,28,4726,6114,7023,0,4604,122,"[20, 11, 14, 5, 27, 40, 19, 29, 18, 8, 20, 36, 40, 24, 7, 37, 10, 35, 33, 26, 12, 6, 12, 40, 14, 40, 10, 15, 0]"
103,28,4678,6305,5396,0,4675,3,"[0, 1, 1, 1, 1, 0, 1, 1, 1, 1, 1, 0, 1, 1, 1, 1, 0, 0, 1, 1, 1, 1, 0, 1, 0, 1, 1, 0, 0]"
104,28,3002,2432,5966,0,2234,768,"[133, 45, 19, 51, 215, 111, 45, 168, 6, 199, 163, 31, 256, 66, 162, 66, 170, 62, 143, 12, 46, 71, 162, 180, 20, 256, 122, 255, 0]"
105,28,3950,225,9691,0,3493,457,"[13, 33, 143, 61, 78, 75, 101, 37, 83, 85, 24, 134, 152, 8, 85, 18, 66, 117, 9, 96, 122, 73, 45, 28, 121, 152, 36, 31, 0]"
106,28,3627,5818,7500,0,1602,2025,"[605, 237, 477, 208, 633, 435, 275, 544, 424, 404, 309, 426, 675, 58, 372, 549, 578, 92, 210, 15, 215, 295, 372, 512, 395, 675, 578, 513, 0]"
107,28,4517,6325,5692,0,30,4487,"[958, 822, 426, 1245, 552, 447, 1452, 1010, 1146, 631, 322, 644, 1495, 1273, 709, 1125, 849, 145, 1385, 883, 1193, 1259, 1025, 158, 68, 1495, 288, 705, 0]"
108,28,4176,2153,7715,0,2175,2001,"[217, 224, 98, 187, 294, 204, 653, 654, 124, 418, 380, 181, 667, 91, 533, 618, 256, 414, 561, 108, 46, 287, 123, 577, 363, 667, 182, 70, 0]"
109,28,3225,1322,9618,0,247,2978,"[788, 828, 304, 60, 466, 656, 697, 575, 517, 462, 246, 300, 992, 793, 988, 211, 473, 677, 228, 32, 210, 851, 108, 628, 343, 992, 194, 706, 0]"
110,28,3639,6985,6272,0,2453,1186,"[247, 3, 386, 359, 355, 30, 255, 221, 117, 302, 143, 1, 395, 80, 153, 21, 40, 212, 305, 58, 149, 375, 119, 160, 259, 395, 186, 171, 0]"
111,28,3998,3620,6650,0,1145,2853,"[814, 607, 755, 184, 501, 858, 369, 763, 583, 32, 501, 27, 951, 627, 145, 530, 582, 355, 675, 931, 334, 583, 531, 398, 611, 951, 367, 838, 0]"
112,28,4467,5284,5833,0,3616,851,"[19, 236, 277, 68, 111, 50, 20, 226, 94, 54, 69, 178, 283, 268, 12, 197, 261, 202, 165, 69, 98, 115, 272, 224, 266, 283, 73, 253, 0]"
113,28,4319,1082,9070,0,3919,400,"[126, 59, 8, 39, 120, 7, 126, 97, 96, 60, 92, 102, 133, 99, 79, 39, 84, 48, 132, 120, 113, 58, 43, 57, 43, 133, 39, 114, 0]"
114,28,3497,7176,5391,0,1622,1875,"[351, 539, 361, 273, 437, 494, 351, 48, 469, 306, 442, 280, 625, 458, 284, 291, 344, 311, 141, 240, 624, 390, 574, 351, 77, 625, 419, 576, 0]"
115,28,4472,3846,6017,0,1161,3311,"[999, 185, 1071, 1032, 344, 759, 54, 575, 722, 622, 620, 624, 1103, 833, 1074, 332, 167, 443, 326, 734, 504, 342, 361, 315, 128, 1103, 415, 701, 0]"
116,28,4198,1577,8638,0,1725,2473,"[595, 802, 83, 147, 663, 194, 600, 407, 812, 397, 21, 608, 824, 448, 513, 122, 74, 344, 559, 243, 515, 670, 724, 799, 93, 824, 728, 253, 0]"
117,28,3310,6945,5003,0,1475,1835,"[153, 320, 366, 126, 554, 488, 580, 129, 56, 486, 109, 142, 611, 292, 353, 318, 545, 204, 99, 332, 341, 400, 504, 99, 523, 611, 146, 215, 0]"
118,28,3910,3508,5405,0,3005,905,"[126, 290, 193, 252, 125, 130, 71, 253, 74, 122, 11, 38, 301, 85, 110, 13, 267, 124, 53, 275, 48, 288, 260, 283, 155, 301, 131, 169, 0]"
119,28,4593,2576,7422,0,1667,2926,"[768, 85, 891, 360, 287, 32, 779, 105, 912, 630, 201, 899, 975, 874, 224, 214, 135, 654, 699, 897, 644, 365, 820, 859, 11, 975, 709, 65, 0]"
