timestamp,node_id,incoming_tx,outgoing_tx,remaining_tx,missing_tx,tx_from_client,tx_from_node,tx_from_node_detail
0,0,3061,0,3061,0,632,2429,"[0, 724, 706, 577, 304, 87, 347, 19, 79, 510, 354, 547, 794, 516, 725, 180, 787, 573, 638, 322, 491, 274, 537, 655, 696, 117, 459]"
1,0,4426,2241,5246,0,3752,674,"[0, 191, 64, 137, 27, 154, 62, 104, 185, 25, 121, 58, 99, 35, 131, 99, 81, 175, 147, 131, 35, 188, 171, 71, 208, 122, 162]"
2,0,3671,2103,6814,0,1169,2502,"[0, 7, 52, 241, 557, 465, 753, 264, 70, 530, 442, 821, 321, 574, 387, 328, 92, 206, 283, 348, 355, 275, 585, 10, 9, 666, 476]"
3,0,3726,1680,8860,0,2539,1187,"[0, 350, 281, 168, 158, 318, 307, 290, 202, 306, 68, 330, 12, 343, 360, 176, 88, 299, 77, 32, 184, 132, 264, 180, 8, 295, 355]"
4,0,4407,6773,6494,0,220,4187,"[0, 1004, 351, 154, 865, 710, 592, 1267, 587, 1161, 892, 352, 264, 649, 1188, 576, 1234, 1172, 877, 1122, 127, 1303, 1337, 1122, 1389, 723, 289]"
5,0,4069,557,10000,6,1610,2459,"[0, 801, 773, 66, 114, 434, 634, 41, 25, 137, 599, 128, 413, 308, 328, 216, 774, 765, 172, 189, 647, 721, 99, 337, 223, 662, 767]"
6,0,3021,6645,6376,0,47,2974,"[0, 876, 898, 249, 62, 896, 308, 199, 390, 498, 536, 738, 802, 627, 270, 460, 586, 295, 867, 719, 533, 910, 764, 150, 353, 3, 111]"
7,0,4478,4214,6640,0,3163,1315,"[0, 124, 192, 360, 185, 71, 45, 213, 168, 152, 30, 330, 139, 122, 208, 213, 430, 178, 217, 58, 305, 310, 106, 318, 166, 150, 302]"
8,0,4249,2981,7908,0,3794,455,"[0, 70, 18, 102, 89, 36, 91, 32, 135, 108, 134, 93, 6, 108, 6, 133, 101, 52, 50, 141, 121, 147, 139, 148, 46, 77, 45]"
9,0,4283,6567,5624,0,3915,368,"[0, 82, 2, 19, 98, 51, 28, 95, 52, 30, 62, 113, 47, 47, 2, 112, 121, 59, 121, 11, 36, 10, 103, 81, 121, 114, 60]"
10,0,3119,21,8722,0,1889,1230,"[0, 62, 318, 210, 180, 350, 315, 229, 24, 32, 247, 139, 259, 292, 67, 402, 159, 106, 107, 231, 124, 35, 336, 311, 165, 165, 204]"
11,0,4328,6401,6649,0,502,3826,"[0, 713, 700, 176, 269, 202, 167, 634, 1242, 104, 602, 524, 666, 982, 344, 788, 888, 45, 992, 4, 1217, 522, 415, 621, 834, 857, 565]"
12,0,4475,7150,3974,0,2219,2256,"[0, 335, 440, 181, 402, 185, 662, 534, 706, 381, 275, 606, 537, 269, 688, 248, 78, 78, 650, 648, 136, 328, 271, 118, 352, 688, 642]"
13,0,3078,643,6409,0,838,2240,"[0, 335, 473, 283, 299, 678, 423, 746, 394, 80, 230, 593, 522, 218, 706, 350, 190, 278, 268, 240, 508, 430, 266, 618, 347, 587, 96]"
14,0,3719,3066,7062,0,632,3087,"[0, 959, 546, 939, 902, 489, 817, 10, 2, 840, 296, 154, 816, 921, 376, 1017, 18, 342, 656, 113, 615, 862, 370, 374, 746, 423, 791]"
15,0,4949,7425,4586,0,3164,1785,"[0, 145, 226, 369, 209, 517, 140, 558, 110, 285, 73, 92, 424, 116, 446, 466, 16, 1, 280, 511, 198, 429, 59, 587, 135, 420, 153]"
16,0,3964,3723,4827,0,1206,2758,"[0, 307, 731, 254, 163, 239, 342, 601, 41, 57, 857, 35, 345, 638, 0, 466, 232, 890, 430, 624, 205, 404, 366, 828, 744, 620, 642]"
17,0,3948,1196,7579,0,146,3802,"[0, 804, 1062, 1056, 365, 135, 148, 274, 256, 501, 977, 595, 796, 898, 158, 1101, 1235, 1069, 1161, 117, 70, 1073, 547, 424, 320, 319, 973]"
18,0,3382,1325,9636,0,508,2874,"[0, 442, 261, 730, 792, 109, 844, 292, 181, 39, 852, 116, 23, 365, 450, 412, 794, 773, 250, 793, 593, 198, 262, 307, 138, 113, 131]"
19,0,4433,7177,6892,0,3702,731,"[0, 22, 122, 182, 235, 114, 103, 209, 33, 116, 0, 74, 169, 112, 238, 143, 19, 220, 84, 218, 19, 180, 150, 177, 29, 107, 22]"
20,0,3222,28,10000,86,14,3208,"[0, 845, 431, 769, 604, 243, 566, 658, 793, 876, 1009, 835, 506, 102, 800, 405, 228, 898, 690, 727, 250, 253, 423, 368, 177, 48, 245]"
21,0,4486,5286,9200,0,3875,611,"[0, 41, 71, 141, 170, 93, 14, 189, 193, 93, 34, 38, 185, 68, 121, 78, 179, 30, 169, 100, 178, 184, 85, 182, 37, 170, 125]"
22,0,3665,5557,7308,0,2236,1429,"[0, 446, 261, 449, 283, 114, 346, 281, 314, 96, 51, 68, 361, 427, 216, 441, 230, 452, 197, 136, 422, 236, 223, 8, 50, 445, 159]"
23,0,3315,706,9917,0,301,3014,"[0, 37, 277, 211, 786, 684, 977, 656, 291, 388, 589, 636, 485, 17, 880, 302, 732, 163, 225, 849, 499, 367, 100, 314, 571, 728, 204]"
24,0,3000,7047,5870,0,1564,1436,"[0, 331, 385, 444, 259, 30, 19, 217, 431, 79, 233, 246, 402, 55, 42, 186, 50, 9, 228, 93, 365, 370, 26, 243, 325, 442, 343]"
25,0,4446,309,10000,7,2952,1494,"[0, 289, 352, 44, 316, 465, 130, 106, 110, 196, 245, 325, 231, 195, 121, 474, 284, 129, 482, 104, 167, 29, 64, 433, 36, 31, 213]"
26,0,4657,6451,8206,0,1568,3089,"[0, 996, 840, 51, 726, 972, 963, 265, 935, 451, 163, 318, 675, 685, 245, 944, 513, 685, 737, 10, 23, 732, 927, 902, 305, 353, 807]"
27,0,3733,5032,6907,0,2663,1070,"[0, 146, 260, 109, 218, 244, 88, 221, 119, 100, 241, 32, 83, 58, 114, 226, 198, 161, 60, 232, 264, 269, 250, 258, 156, 291, 52]"
28,0,4864,6697,5074,0,3322,1542,"[0, 288, 141, 54, 224, 189, 343, 217, 492, 397, 166, 199, 503, 216, 95, 424, 281, 185, 64, 476, 398, 331, 122, 290, 56, 307, 349]"
29,0,4946,3437,6583,0,741,4205,"[0, 661, 1095, 405, 1224, 1226, 1117, 957, 836, 1019, 129, 689, 1102, 692, 569, 243, 866, 1327, 654, 1316, 354, 61, 1155, 509, 406, 272, 606]"
30,0,3191,478,9296,0,935,2256,"[0, 388, 258, 74, 651, 597, 60, 252, 599, 690, 341, 61, 305, 271, 596, 251, 156, 476, 372, 201, 153, 282, 162, 646, 494, 710, 449]"
31,0,3359,6718,5937,0,2075,1284,"[0, 222, 202, 191, 143, 34, 325, 121, 345, 383, 345, 317, 81, 351, 204, 167, 52, 317, 368, 68, 57, 112, 356, 346, 3, 60, 47]"
32,0,4710,3096,7551,0,4460,250,"[0, 25, 56, 15, 24, 47, 62, 70, 37, 39, 16, 64, 45, 76, 19, 41, 83, 76, 65, 26, 14, 26, 36, 78, 9, 25, 48]"
33,0,4248,7349,4450,0,1547,2701,"[0, 430, 495, 310, 736, 232, 522, 270, 740, 501, 99, 237, 708, 571, 464, 195, 649, 857, 243, 272, 67, 336, 594, 611, 287, 669, 775]"
34,0,4703,1382,7771,0,395,4308,"[0, 1155, 281, 857, 580, 1292, 507, 93, 127, 932, 1250, 1247, 620, 946, 917, 556, 1108, 606, 343, 637, 698, 1339, 280, 27, 280, 1199, 996]"
35,0,3235,5926,5080,0,2419,816,"[0, 69, 86, 139, 172, 104, 90, 225, 54, 33, 90, 247, 197, 160, 200, 70, 228, 165, 270, 51, 250, 204, 15, 88, 47, 237, 161]"
36,0,3636,1463,7253,0,3353,283,"[0, 20, 81, 91, 7, 32, 71, 71, 8, 42, 58, 20, 56, 6, 8, 8, 28, 6, 20, 52, 35, 10, 3, 52, 88, 79, 37]"
37,0,4332,7050,4535,0,1842,2490,"[0, 652, 513, 122, 725, 77, 225, 143, 647, 569, 127, 781, 308, 597, 643, 700, 17, 313, 43, 225, 79, 657, 289, 65, 382, 783, 48]"
38,0,3145,1200,6480,0,2055,1090,"[0, 264, 162, 335, 66, 236, 140, 78, 92, 91, 52, 194, 130, 229, 127, 155, 355, 209, 34, 355, 273, 141, 67, 104, 39, 109, 223]"
39,0,3745,3540,6685,0,150,3595,"[0, 343, 726, 415, 270, 199, 1193, 984, 1048, 180, 63, 491, 1154, 314, 364, 854, 994, 1123, 304, 1192, 729, 932, 257, 530, 1030, 928, 282]"
40,0,4904,6161,5428,0,3103,1801,"[0, 358, 166, 229, 436, 67, 246, 25, 222, 269, 583, 144, 495, 50, 304, 195, 578, 144, 599, 340, 116, 94, 195, 223, 513, 270, 262]"
41,0,3229,2931,5726,0,1519,1710,"[0, 234, 480, 558, 478, 547, 194, 384, 511, 445, 169, 508, 287, 478, 73, 215, 539, 466, 248, 445, 529, 201, 136, 70, 196, 285, 40]"
42,0,3907,3051,6582,0,1578,2329,"[0, 30, 292, 609, 680, 755, 403, 763, 569, 180, 659, 338, 61, 418, 94, 17, 70, 371, 472, 630, 122, 724, 32, 110, 185, 0, 744]"
43,0,4242,2551,8273,0,506,3736,"[0, 385, 246, 1047, 794, 1066, 676, 814, 677, 941, 803, 423, 497, 438, 1058, 513, 38, 680, 554, 714, 1030, 963, 503, 943, 623, 1133, 627]"
44,0,4943,5223,7993,0,4236,707,"[0, 41, 107, 44, 111, 49, 48, 5, 25, 21, 20, 169, 25, 91, 63, 224, 128, 57, 7, 83, 69, 187, 32, 225, 83, 102, 14]"
45,0,4419,6345,6067,0,2938,1481,"[0, 94, 387, 255, 249, 249, 405, 40, 240, 487, 260, 159, 370, 223, 3, 3, 20, 358, 18, 397, 273, 324, 88, 433, 63, 23, 22]"
46,0,4044,3810,6301,0,3140,904,"[0, 10, 292, 142, 288, 18, 285, 156, 227, 22, 164, 234, 198, 142, 170, 236, 23, 26, 231, 16, 225, 223, 140, 289, 168, 176, 161]"
47,0,3666,1174,8793,0,832,2834,"[0, 734, 190, 346, 374, 456, 844, 82, 363, 258, 617, 435, 689, 221, 25, 891, 458, 761, 763, 261, 509, 592, 383, 363, 335, 840, 546]"
48,0,4725,6950,6568,0,3008,1717,"[0, 281, 1, 189, 50, 441, 61, 490, 559, 465, 516, 178, 307, 248, 240, 372, 99, 168, 15, 254, 255, 156, 40, 542, 230, 225, 59]"
49,0,4443,7331,3680,0,437,4006,"[0, 533, 116, 766, 257, 1186, 1035, 355, 360, 852, 301, 904, 979, 1166, 1035, 836, 1111, 512, 584, 1229, 1211, 441, 133, 686, 1169, 806, 848]"
50,0,3691,2431,4940,0,3481,210,"[0, 7, 64, 47, 46, 70, 42, 60, 38, 31, 58, 61, 6, 62, 22, 23, 33, 39, 66, 52, 13, 50, 22, 13, 31, 21, 26]"
51,0,4035,535,8440,0,1169,2866,"[0, 645, 84, 860, 163, 799, 177, 25, 272, 312, 786, 711, 398, 951, 117, 696, 607, 174, 127, 158, 11, 706, 884, 581, 660, 417, 639]"
52,0,4846,7439,5847,0,1949,2897,"[0, 513, 900, 529, 101, 395, 788, 445, 59, 539, 472, 339, 926, 649, 642, 832, 965, 921, 875, 869, 638, 173, 958, 708, 500, 640, 543]"
53,0,3238,975,8110,0,1192,2046,"[0, 415, 528, 381, 369, 667, 571, 654, 249, 129, 137, 313, 467, 58, 414, 389, 236, 673, 145, 206, 74, 625, 398, 40, 417, 244, 26]"
54,0,4489,6178,6421,0,3744,745,"[0, 32, 106, 223, 130, 44, 189, 239, 6, 24, 196, 54, 73, 30, 52, 160, 106, 202, 61, 162, 170, 171, 224, 54, 121, 248, 52]"
55,0,4566,3057,7930,0,2535,2031,"[0, 247, 510, 199, 378, 64, 328, 160, 85, 94, 113, 184, 434, 287, 482, 158, 335, 665, 296, 32, 458, 505, 484, 589, 245, 396, 152]"
56,0,3987,7173,4744,0,3879,108,"[0, 31, 0, 10, 26, 21, 24, 28, 5, 2, 17, 25, 19, 30, 18, 6, 27, 23, 6, 16, 29, 14, 4, 18, 15, 16, 24]"
57,0,3125,2082,5787,0,1757,1368,"[0, 329, 90, 353, 271, 49, 315, 382, 47, 133, 291, 456, 168, 80, 164, 359, 449, 85, 261, 129, 279, 171, 296, 168, 341, 70, 314]"
58,0,4706,3036,7457,0,1570,3136,"[0, 782, 640, 633, 840, 502, 871, 841, 47, 866, 744, 848, 242, 285, 725, 331, 768, 106, 801, 965, 803, 660, 592, 296, 641, 650, 381]"
59,0,3051,1994,8514,0,1994,1057,"[0, 75, 245, 290, 101, 249, 271, 276, 136, 121, 322, 307, 318, 143, 252, 173, 221, 301, 0, 306, 161, 205, 175, 83, 214, 187, 41]"
60,0,3928,7392,5050,0,1600,2328,"[0, 263, 295, 713, 272, 501, 299, 552, 319, 80, 352, 659, 710, 467, 221, 412, 686, 118, 120, 241, 23, 184, 699, 752, 768, 445, 161]"
61,0,3730,203,8577,0,2818,912,"[0, 270, 55, 251, 142, 286, 224, 147, 87, 141, 2, 223, 39, 190, 120, 179, 227, 132, 217, 45, 213, 239, 254, 147, 173, 281, 141]"
62,0,3373,5522,6428,0,1938,1435,"[0, 160, 146, 338, 394, 408, 469, 6, 338, 234, 244, 368, 73, 450, 347, 377, 281, 470, 211, 26, 6, 156, 23, 37, 396, 332, 362]"
63,0,4821,6853,4396,0,2548,2273,"[0, 668, 202, 199, 551, 544, 102, 560, 615, 242, 749, 450, 346, 643, 586, 290, 49, 493, 738, 200, 37, 162, 587, 752, 353, 503, 134]"
64,0,3122,2703,4815,0,1930,1192,"[0, 136, 136, 100, 49, 391, 65, 133, 130, 215, 229, 165, 4, 59, 337, 75, 128, 224, 175, 178, 153, 123, 100, 297, 335, 310, 39]"
65,0,4011,2339,6487,0,416,3595,"[0, 732, 973, 949, 1142, 1117, 721, 1033, 805, 415, 1033, 477, 1176, 363, 568, 1, 1113, 835, 293, 24, 992, 414, 755, 276, 1182, 38, 419]"
66,0,3433,2484,7436,0,2679,754,"[0, 57, 100, 160, 58, 212, 185, 3, 200, 116, 229, 124, 201, 123, 202, 243, 6, 187, 53, 88, 196, 246, 30, 46, 25, 199, 209]"
67,0,4342,6025,5753,0,704,3638,"[0, 544, 757, 707, 614, 32, 898, 562, 440, 615, 492, 251, 709, 354, 343, 6, 67, 299, 481, 494, 738, 1155, 944, 858, 1097, 175, 774]"
68,0,3428,759,8422,0,1836,1592,"[0, 207, 339, 475, 391, 67, 466, 253, 317, 240, 178, 127, 181, 514, 426, 195, 367, 41, 523, 175, 109, 400, 73, 218, 393, 503, 124]"
69,0,4949,7207,6164,0,3053,1896,"[0, 542, 238, 108, 488, 526, 146, 14, 288, 202, 379, 209, 111, 217, 364, 94, 456, 163, 87, 77, 329, 430, 66, 58, 371, 608, 206]"
70,0,4759,3820,7103,0,2295,2464,"[0, 362, 333, 512, 774, 799, 257, 372, 273, 785, 766, 549, 786, 645, 528, 122, 164, 572, 11, 722, 819, 759, 343, 530, 104, 621, 6]"
71,0,3997,6065,5035,0,471,3526,"[0, 599, 590, 627, 495, 153, 687, 41, 661, 838, 89, 429, 524, 270, 688, 239, 68, 819, 653, 721, 946, 175, 541, 454, 961, 840, 1003]"
72,0,4968,2866,7137,0,3219,1749,"[0, 9, 332, 47, 236, 563, 421, 579, 459, 420, 125, 232, 217, 394, 68, 291, 310, 46, 192, 149, 549, 426, 498, 14, 294, 82, 213]"
73,0,4164,5754,5547,0,3509,655,"[0, 121, 119, 181, 87, 14, 52, 56, 181, 82, 103, 61, 144, 158, 137, 107, 129, 33, 165, 67, 21, 86, 177, 167, 166, 182, 105]"
74,0,3110,3075,5582,0,2870,240,"[0, 3, 3, 68, 70, 17, 65, 73, 34, 33, 28, 49, 9, 72, 65, 73, 58, 30, 23, 21, 13, 61, 66, 73, 50, 53, 71]"
75,0,3113,1723,6972,0,2325,788,"[0, 39, 94, 7, 178, 21, 144, 31, 201, 99, 47, 97, 69, 99, 56, 2, 24, 85, 155, 21, 24, 182, 251, 125, 103, 121, 239]"
76,0,3948,129,10000,791,2503,1445,"[0, 382, 338, 262, 468, 283, 3, 177, 371, 195, 451, 241, 17, 182, 400, 67, 340, 57, 16, 146, 210, 235, 273, 329, 437, 76, 345]"
77,0,3148,6798,6350,0,765,2383,"[0, 330, 272, 686, 64, 737, 763, 706, 111, 125, 92, 299, 120, 487, 473, 207, 343, 505, 575, 179, 593, 746, 22, 283, 104, 279, 270]"
78,0,4051,594,9807,0,537,3514,"[0, 16, 834, 983, 1033, 365, 721, 881, 877, 87, 518, 436, 696, 803, 288, 452, 1104, 653, 1068, 771, 1158, 1002, 1022, 639, 865, 1094, 619]"
79,0,3015,7002,5820,0,2566,449,"[0, 42, 98, 134, 126, 52, 77, 48, 122, 111, 26, 68, 138, 39, 74, 51, 64, 88, 142, 102, 93, 46, 115, 60, 43, 68, 22]"
80,0,4114,3517,6417,0,474,3640,"[0, 305, 1002, 665, 1065, 15, 833, 713, 952, 1142, 372, 1096, 403, 1182, 1136, 401, 1016, 437, 849, 673, 587, 1080, 110, 464, 600, 691, 385]"
81,0,3999,1855,8561,0,53,3946,"[0, 307, 392, 741, 705, 109, 622, 600, 137, 1058, 542, 304, 1080, 616, 1118, 331, 701, 656, 328, 179, 3, 63, 591, 1309, 130, 938, 250]"
82,0,4748,6588,6721,0,1769,2979,"[0, 512, 513, 467, 431, 578, 702, 773, 718, 820, 753, 79, 368, 921, 785, 427, 935, 482, 869, 428, 794, 889, 448, 676, 268, 843, 757]"
83,0,4453,5263,5911,0,1388,3065,"[0, 217, 238, 497, 245, 860, 125, 519, 250, 756, 391, 118, 51, 304, 238, 807, 89, 22, 98, 459, 847, 389, 326, 112, 342, 560, 697]"
84,0,4738,1056,9593,0,249,4489,"[0, 1247, 1107, 397, 995, 459, 472, 910, 569, 1027, 1182, 1130, 778, 1347, 110, 1234, 1356, 851, 1353, 1063, 306, 1274, 82, 1143, 848, 286, 905]"
85,0,3852,6873,6572,0,2058,1794,"[0, 505, 462, 105, 319, 285, 300, 576, 518, 463, 227, 223, 81, 298, 216, 365, 258, 13, 90, 118, 204, 39, 147, 562, 409, 304, 281]"
86,0,3144,2767,6949,0,1548,1596,"[0, 337, 57, 498, 272, 269, 315, 516, 226, 180, 146, 53, 279, 302, 424, 3, 84, 8, 89, 315, 316, 531, 313, 447, 132, 309, 308]"
87,0,3959,3401,7507,0,1437,2522,"[0, 481, 189, 22, 539, 50, 813, 816, 391, 798, 52, 361, 685, 440, 162, 639, 217, 687, 641, 578, 71, 250, 509, 483, 164, 395, 637]"
88,0,3006,1978,8535,0,2243,763,"[0, 204, 110, 138, 133, 16, 60, 241, 221, 206, 159, 2, 212, 235, 118, 197, 67, 157, 134, 246, 249, 237, 98, 77, 78, 149, 79]"
89,0,4124,5558,7101,0,2109,2015,"[0, 379, 129, 65, 647, 553, 6, 234, 344, 134, 121, 306, 180, 178, 246, 644, 42, 92, 587, 134, 124, 176, 584, 436, 584, 196, 581]"
90,0,4983,5398,6686,0,3321,1662,"[0, 226, 488, 498, 30, 78, 522, 251, 367, 173, 165, 377, 366, 345, 170, 287, 294, 15, 339, 186, 495, 538, 343, 475, 109, 293, 517]"
91,0,4862,6929,4619,0,2468,2394,"[0, 467, 305, 670, 549, 229, 97, 543, 645, 270, 450, 72, 2, 258, 520, 141, 441, 218, 570, 425, 565, 758, 151, 88, 702, 287, 505]"
92,0,3911,1545,6985,0,3571,340,"[0, 23, 61, 92, 43, 12, 93, 53, 102, 32, 69, 59, 95, 79, 100, 16, 8, 99, 15, 68, 100, 109, 55, 51, 74, 83, 29]"
93,0,3016,2362,7639,0,2931,85,"[0, 14, 19, 27, 18, 22, 19, 18, 7, 28, 2, 17, 13, 11, 13, 0, 21, 26, 17, 6, 3, 28, 10, 17, 4, 23, 17]"
94,0,4453,5774,6318,0,2357,2096,"[0, 427, 16, 261, 229, 624, 581, 596, 697, 155, 337, 322, 358, 565, 603, 87, 258, 649, 195, 584, 38, 168, 366, 294, 71, 109, 69]"
95,0,3347,3091,6574,0,1397,1950,"[0, 498, 240, 52, 428, 306, 629, 50, 501, 271, 636, 90, 291, 409, 537, 214, 87, 540, 298, 154, 499, 10, 27, 66, 616, 603, 131]"
96,0,4616,7008,4182,0,4564,52,"[0, 8, 6, 13, 7, 11, 13, 7, 8, 6, 9, 12, 6, 16, 3, 3, 8, 12, 16, 14, 17, 7, 12, 5, 16, 5, 15]"
97,0,3578,1103,6657,0,2851,727,"[0, 180, 164, 114, 66, 231, 66, 41, 233, 118, 173, 28, 184, 113, 152, 237, 136, 232, 196, 53, 164, 138, 29, 40, 185, 41, 187]"
98,0,3585,2883,7359,0,2312,1273,"[0, 48, 63, 288, 183, 70, 273, 205, 231, 165, 164, 206, 223, 219, 338, 107, 334, 229, 200, 406, 18, 399, 59, 136, 218, 186, 371]"
99,0,3935,5341,5953,0,3023,912,"[0, 289, 186, 193, 146, 258, 251, 41, 59, 182, 3, 288, 200, 134, 62, 126, 189, 64, 282, 179, 2, 33, 190, 24, 151, 61, 141]"
100,0,3736,153,9536,0,3402,334,"[0, 45, 0, 98, 100, 32, 87, 91, 12, 8, 78, 85, 22, 75, 71, 19, 26, 92, 41, 89, 97, 78, 34, 0, 64, 90, 42]"
101,0,4893,5594,8835,0,1016,3877,"[0, 617, 922, 915, 908, 1163, 53, 215, 404, 1063, 940, 1270, 969, 877, 303, 477, 483, 585, 388, 733, 753, 546, 91, 169, 869, 869, 1273]"
102,0,4821,6789,6867,0,4517,304,"[0, 38, 29, 28, 48, 35, 96, 25, 36, 76, 88, 37, 3, 69, 24, 29, 60, 34, 1, 51, 2, 89, 46, 90, 59, 101, 9]"
103,0,3645,1750,8762,0,865,2780,"[0, 320, 304, 379, 170, 324, 407, 391, 883, 509, 208, 701, 306, 611, 369, 699, 468, 707, 361, 883, 603, 662, 633, 797, 85, 42, 88]"
104,0,4020,7136,5646,0,147,3873,"[0, 678, 1211, 819, 547, 439, 753, 1172, 1056, 810, 754, 155, 342, 1131, 85, 376, 749, 826, 685, 383, 771, 152, 647, 602, 919, 583, 1113]"
105,0,4008,2827,6827,0,1830,2178,"[0, 399, 640, 276, 332, 334, 434, 723, 112, 464, 626, 476, 80, 5, 198, 122, 593, 448, 394, 98, 183, 77, 492, 306, 209, 353, 336]"
106,0,4458,5375,5910,0,1216,3242,"[0, 404, 847, 956, 802, 724, 745, 230, 835, 177, 229, 888, 934, 328, 823, 1045, 979, 722, 1039, 459, 1012, 561, 211, 244, 758, 659, 752]"
107,0,4359,3193,7076,0,771,3588,"[0, 542, 1190, 571, 943, 246, 908, 1011, 216, 823, 436, 184, 992, 812, 870, 1075, 803, 703, 581, 1106, 1154, 318, 97, 1022, 641, 876, 873]"
108,0,3517,2740,7853,0,2125,1392,"[0, 290, 253, 456, 250, 398, 183, 376, 161, 235, 282, 378, 438, 120, 407, 362, 70, 185, 111, 23, 29, 189, 235, 425, 249, 250, 403]"
109,0,3695,5652,5896,0,1063,2632,"[0, 128, 180, 716, 630, 316, 785, 349, 27, 850, 689, 494, 44, 819, 406, 834, 479, 442, 540, 410, 776, 621, 707, 42, 399, 28, 669]"
110,0,3393,198,9091,0,208,3185,"[0, 942, 567, 637, 1059, 115, 262, 335, 13, 848, 987, 670, 205, 547, 97, 773, 1036, 919, 85, 306, 707, 388, 10, 286, 926, 56, 869]"
111,0,3903,5889,7105,0,28,3875,"[0, 1140, 673, 992, 669, 372, 409, 1063, 451, 310, 868, 882, 231, 257, 77, 1063, 791, 629, 452, 815, 1232, 899, 37, 865, 1130, 588, 574]"
112,0,4989,5983,6111,0,2844,2145,"[0, 208, 350, 381, 55, 99, 221, 541, 178, 645, 447, 530, 80, 55, 354, 93, 382, 195, 680, 119, 597, 149, 34, 12, 259, 206, 497]"
113,0,3892,2386,7617,0,1631,2261,"[0, 658, 257, 697, 150, 339, 267, 236, 500, 711, 257, 449, 499, 3, 679, 657, 92, 147, 599, 573, 58, 749, 425, 462, 568, 203, 570]"
114,0,4962,7057,5522,0,4845,117,"[0, 11, 36, 32, 17, 39, 11, 19, 7, 5, 9, 28, 24, 15, 0, 6, 5, 23, 2, 13, 19, 36, 2, 34, 26, 38, 6]"
115,0,4005,936,8591,0,2711,1294,"[0, 68, 303, 366, 70, 58, 160, 216, 258, 123, 424, 231, 431, 144, 143, 38, 79, 118, 89, 349, 303, 217, 192, 403, 198, 35, 125]"
116,0,3751,6070,6272,0,2604,1147,"[0, 19, 269, 237, 126, 35, 309, 326, 244, 353, 341, 131, 270, 214, 278, 269, 172, 123, 63, 227, 73, 339, 140, 328, 306, 307, 84]"
117,0,4792,5513,5551,0,2107,2685,"[0, 633, 332, 767, 874, 304, 417, 541, 330, 519, 222, 756, 196, 370, 590, 558, 463, 821, 616, 734, 334, 625, 783, 560, 69, 584, 161]"
118,0,3961,2111,7401,0,166,3795,"[0, 599, 906, 1185, 836, 20, 166, 966, 47, 379, 1203, 7, 871, 888, 388, 61, 94, 1203, 17, 1064, 167, 274, 505, 289, 1056, 196, 445]"
119,0,4270,5139,6532,0,2675,1595,"[0, 408, 281, 341, 328, 198, 3, 243, 71, 31, 189, 472, 60, 55, 276, 349, 27, 493, 383, 506, 0, 423, 354, 217, 67, 181, 47]"
120,0,4593,5696,5429,0,888,3705,"[0, 290, 406, 159, 145, 515, 836, 1026, 1010, 829, 586, 598, 841, 1151, 79, 462, 598, 365, 722, 714, 1233, 966, 1034, 36, 562, 373, 258]"
121,0,4319,1740,8008,0,2342,1977,"[0, 544, 236, 140, 646, 293, 5, 641, 7, 473, 464, 353, 594, 387, 395, 261, 458, 259, 507, 188, 375, 333, 626, 603, 83, 104, 563]"
122,0,4223,5515,6716,0,905,3318,"[0, 94, 828, 477, 935, 495, 322, 1049, 135, 851, 509, 614, 340, 979, 851, 582, 621, 278, 12, 475, 272, 340, 683, 575, 426, 756, 235]"
123,0,4071,74,10000,713,502,3569,"[0, 906, 278, 669, 680, 834, 221, 826, 165, 228, 376, 497, 131, 509, 838, 273, 44, 278, 1189, 616, 294, 520, 993, 119, 361, 254, 170]"
124,0,3015,5274,7741,0,2724,291,"[0, 41, 5, 8, 28, 24, 65, 7, 82, 53, 79, 71, 51, 95, 35, 58, 96, 81, 65, 36, 54, 48, 52, 95, 22, 30, 37]"
125,0,3771,6399,5113,0,1618,2153,"[0, 635, 654, 32, 701, 307, 25, 359, 713, 569, 72, 715, 438, 24, 257, 105, 636, 505, 216, 238, 102, 424, 189, 488, 479, 16, 674]"
126,0,4685,3621,6177,0,2948,1737,"[0, 29, 28, 387, 478, 496, 469, 565, 234, 540, 111, 85, 369, 404, 370, 162, 22, 200, 573, 73, 423, 568, 76, 257, 497, 11, 196]"
127,0,4662,2663,8176,0,3661,1001,"[0, 162, 197, 38, 274, 161, 251, 272, 53, 261, 163, 247, 43, 153, 180, 313, 238, 306, 17, 60, 224, 245, 6, 217, 297, 235, 309]"
128,0,3100,6810,4466,0,153,2947,"[0, 528, 729, 481, 953, 432, 130, 850, 416, 703, 312, 620, 795, 958, 703, 563, 519, 666, 246, 793, 106, 411, 770, 981, 916, 518, 977]"
129,0,4756,1747,7475,0,3184,1572,"[0, 484, 221, 458, 72, 393, 286, 93, 520, 468, 510, 467, 173, 149, 341, 49, 171, 353, 356, 305, 407, 33, 195, 348, 438, 522, 126]"
130,0,3168,2172,8471,0,2616,552,"[0, 181, 12, 61, 154, 155, 85, 3, 67, 90, 44, 160, 62, 128, 114, 22, 72, 115, 121, 1, 42, 37, 84, 88, 106, 68, 49]"
131,0,4774,6542,6703,0,3275,1499,"[0, 294, 80, 153, 181, 336, 37, 471, 75, 170, 268, 187, 185, 4, 221, 56, 304, 68, 113, 383, 230, 287, 186, 259, 468, 374, 476]"
132,0,3294,2677,7320,0,2676,618,"[0, 40, 77, 79, 18, 52, 183, 138, 37, 4, 135, 194, 170, 105, 124, 105, 34, 80, 117, 64, 125, 125, 25, 109, 167, 98, 107]"
133,0,3127,1601,8846,0,2471,656,"[0, 11, 141, 118, 38, 67, 44, 211, 200, 138, 96, 55, 28, 100, 132, 45, 142, 107, 164, 15, 35, 151, 136, 56, 141, 125, 164]"
134,0,4966,6118,7694,0,955,4011,"[0, 1146, 329, 1297, 1152, 944, 157, 111, 435, 711, 577, 1187, 927, 1107, 1118, 976, 1121, 320, 614, 749, 1212, 1120, 521, 925, 633, 897, 80]"
135,0,3463,5427,5730,0,706,2757,"[0, 50, 294, 238, 908, 420, 223, 145, 114, 36, 72, 105, 48, 425, 335, 601, 529, 286, 307, 522, 123, 577, 721, 199, 320, 738, 818]"
136,0,4348,3904,6174,0,4161,187,"[0, 40, 6, 13, 4, 58, 36, 27, 7, 36, 33, 60, 45, 36, 20, 46, 28, 52, 3, 61, 29, 33, 38, 13, 42, 27, 32]"
137,0,3389,1522,8041,0,2035,1354,"[0, 146, 23, 52, 348, 412, 186, 159, 234, 18, 55, 58, 50, 181, 107, 109, 58, 384, 150, 347, 423, 303, 411, 127, 324, 254, 22]"
138,0,4436,7014,5463,0,1880,2556,"[0, 799, 564, 11, 383, 362, 837, 697, 497, 213, 797, 205, 232, 589, 848, 483, 474, 365, 593, 717, 210, 541, 323, 754, 781, 360, 454]"
139,0,4470,1017,8916,0,4304,166,"[0, 44, 3, 26, 5, 46, 6, 47, 37, 49, 35, 43, 11, 53, 52, 8, 40, 3, 49, 17, 29, 41, 50, 41, 41, 17, 43]"
140,0,4078,5129,7865,0,3203,875,"[0, 11, 215, 121, 100, 279, 63, 238, 138, 152, 51, 100, 21, 63, 17, 37, 140, 227, 271, 273, 55, 238, 214, 38, 48, 210, 209]"
141,0,3218,5861,5222,0,694,2524,"[0, 788, 50, 432, 462, 632, 638, 246, 814, 326, 119, 150, 670, 158, 364, 806, 263, 324, 28, 566, 354, 104, 304, 179, 783, 250, 302]"
142,0,3005,2631,5596,0,2169,836,"[0, 116, 260, 219, 57, 222, 272, 195, 37, 229, 216, 14, 195, 123, 31, 214, 223, 133, 134, 207, 61, 66, 209, 209, 187, 188, 187]"
143,0,3705,3364,5937,0,2656,1049,"[0, 36, 176, 61, 261, 276, 51, 172, 349, 43, 67, 330, 141, 234, 19, 87, 25, 339, 67, 10, 145, 340, 169, 80, 220, 44, 70]"
144,0,4973,791,10000,119,1880,3093,"[0, 1028, 670, 935, 960, 234, 5, 707, 773, 31, 755, 727, 859, 488, 885, 230, 980, 418, 797, 454, 951, 38, 531, 553, 903, 1011, 172]"
145,0,3359,6171,7188,0,2312,1047,"[0, 152, 283, 0, 51, 298, 122, 279, 202, 163, 346, 265, 338, 26, 120, 148, 274, 345, 183, 185, 262, 195, 87, 154, 155, 28, 82]"
146,0,4158,5583,5763,0,3126,1032,"[0, 343, 159, 173, 144, 200, 306, 127, 280, 94, 148, 340, 27, 17, 204, 153, 118, 182, 150, 166, 42, 240, 196, 43, 39, 149, 332]"
147,0,4928,128,10000,563,1238,3690,"[0, 961, 722, 992, 1021, 890, 612, 300, 963, 589, 1147, 362, 98, 566, 1077, 1221, 1079, 596, 293, 449, 798, 963, 528, 778, 928, 792, 750]"
148,0,3309,5527,7782,0,387,2922,"[0, 70, 192, 893, 822, 706, 518, 781, 369, 814, 779, 255, 517, 901, 881, 543, 685, 385, 706, 636, 337, 147, 815, 158, 438, 73, 752]"
149,0,4213,7091,4904,0,1632,2581,"[0, 540, 688, 342, 807, 13, 13, 337, 251, 544, 532, 243, 32, 134, 267, 376, 536, 15, 370, 706, 128, 521, 840, 723, 169, 801, 286]"
150,0,3054,1707,6251,0,3040,14,"[0, 3, 1, 1, 3, 3, 0, 1, 0, 0, 2, 3, 0, 2, 3, 2, 4, 1, 1, 0, 2, 0, 3, 0, 0, 2, 0]"
151,0,4985,6690,4546,0,3863,1122,"[0, 154, 103, 6, 356, 30, 19, 245, 241, 314, 160, 129, 163, 83, 243, 181, 118, 157, 206, 67, 118, 150, 366, 87, 218, 321, 190]"
152,0,3661,234,7973,0,2524,1137,"[0, 343, 32, 369, 65, 237, 336, 80, 308, 277, 341, 285, 177, 83, 65, 246, 47, 258, 158, 43, 82, 48, 102, 356, 145, 38, 270]"
153,0,3121,5412,5682,0,925,2196,"[0, 704, 423, 377, 119, 725, 586, 502, 563, 392, 419, 100, 636, 126, 126, 732, 207, 342, 470, 700, 662, 175, 344, 531, 254, 236, 446]"
154,0,4653,3179,7156,0,1226,3427,"[0, 1050, 344, 644, 904, 1121, 888, 821, 644, 939, 151, 967, 1107, 479, 271, 97, 141, 753, 19, 413, 101, 25, 461, 1117, 232, 552, 303]"
155,0,3591,137,10000,610,3280,311,"[0, 43, 45, 1, 1, 90, 12, 75, 101, 71, 30, 26, 98, 64, 92, 38, 96, 41, 12, 56, 86, 13, 56, 93, 97, 97, 43]"
156,0,3987,5786,8201,0,3380,607,"[0, 169, 19, 66, 161, 68, 197, 49, 159, 191, 97, 20, 176, 191, 99, 43, 47, 18, 152, 16, 198, 23, 181, 102, 80, 145, 110]"
157,0,3688,6784,5105,0,3651,37,"[0, 8, 9, 8, 10, 8, 6, 0, 2, 5, 6, 5, 6, 5, 9, 2, 6, 0, 9, 11, 1, 2, 6, 0, 8, 4, 9]"
158,0,4158,3441,5822,0,4079,79,"[0, 26, 7, 6, 8, 3, 13, 22, 3, 19, 9, 11, 3, 21, 21, 5, 18, 26, 19, 1, 11, 16, 22, 12, 9, 15, 2]"
159,0,3969,3281,6510,0,266,3703,"[0, 220, 376, 998, 944, 264, 202, 111, 931, 332, 876, 702, 1199, 907, 179, 222, 573, 48, 53, 910, 911, 1176, 532, 807, 251, 456, 65]"
160,0,3642,2626,7526,0,415,3227,"[0, 337, 351, 166, 1062, 777, 925, 50, 142, 256, 777, 1065, 969, 851, 109, 744, 880, 823, 483, 711, 658, 746, 621, 431, 995, 463, 73]"
161,0,3729,6769,4486,0,2475,1254,"[0, 129, 271, 318, 6, 399, 11, 411, 80, 188, 187, 364, 245, 378, 231, 6, 217, 314, 18, 169, 238, 110, 396, 113, 262, 244, 10]"
162,0,4884,4,9366,0,128,4756,"[0, 79, 3, 184, 541, 231, 652, 664, 634, 511, 1127, 620, 761, 879, 394, 1577, 852, 5, 1090, 1135, 619, 1180, 1242, 537, 480, 146, 1448]"
163,0,3090,5894,6562,0,2877,213,"[0, 25, 62, 54, 5, 38, 71, 64, 40, 64, 45, 43, 39, 35, 70, 21, 70, 56, 61, 25, 18, 57, 7, 0, 60, 47, 17]"
164,0,3997,3932,6627,0,2504,1493,"[0, 193, 443, 121, 359, 187, 223, 106, 229, 239, 40, 121, 217, 329, 450, 235, 267, 209, 173, 172, 84, 160, 148, 173, 377, 102, 492]"
165,0,4935,5904,5658,0,2618,2317,"[0, 333, 181, 361, 269, 208, 284, 481, 621, 24, 709, 307, 453, 541, 627, 593, 312, 108, 515, 216, 690, 552, 472, 526, 419, 453, 110]"
166,0,3449,706,8401,0,2749,700,"[0, 200, 27, 125, 214, 176, 123, 186, 178, 9, 72, 57, 147, 151, 17, 76, 81, 151, 47, 19, 217, 195, 4, 64, 210, 148, 191]"
167,0,4769,6954,6216,0,3964,805,"[0, 71, 47, 211, 150, 26, 214, 88, 55, 140, 74, 265, 66, 119, 190, 134, 134, 249, 264, 196, 28, 171, 117, 21, 143, 27, 113]"
168,0,4226,3768,6674,0,4116,110,"[0, 6, 13, 6, 31, 5, 30, 9, 35, 27, 29, 36, 21, 2, 13, 32, 7, 24, 0, 11, 1, 29, 1, 27, 10, 19, 0]"
169,0,4118,3798,6994,0,2587,1531,"[0, 384, 249, 286, 239, 87, 315, 237, 468, 111, 476, 81, 472, 450, 208, 276, 237, 494, 420, 480, 232, 443, 240, 232, 31, 265, 130]"
170,0,3296,2070,8220,0,1586,1710,"[0, 411, 255, 179, 532, 228, 376, 367, 484, 392, 316, 513, 225, 85, 420, 116, 517, 264, 80, 417, 509, 217, 211, 404, 356, 237, 516]"
171,0,3767,6636,5351,0,3080,687,"[0, 30, 54, 50, 146, 202, 199, 147, 205, 52, 108, 61, 226, 66, 14, 98, 227, 111, 103, 23, 99, 127, 95, 121, 179, 21, 115]"
172,0,4616,1521,8446,0,3747,869,"[0, 92, 184, 105, 235, 143, 27, 174, 62, 226, 139, 266, 85, 207, 264, 141, 174, 127, 289, 1, 52, 236, 237, 251, 243, 27, 85]"
173,0,4960,6924,6482,0,1296,3664,"[0, 950, 518, 809, 888, 182, 15, 232, 1072, 1136, 405, 1193, 203, 93, 1029, 1125, 1183, 587, 396, 318, 849, 979, 548, 112, 529, 69, 930]"
174,0,4134,1784,8832,0,2274,1860,"[0, 617, 420, 472, 233, 296, 376, 185, 0, 298, 307, 368, 571, 56, 274, 244, 410, 219, 263, 585, 31, 117, 301, 321, 296, 9, 327]"
175,0,4893,5370,8355,0,1207,3686,"[0, 147, 390, 395, 1063, 612, 1221, 689, 1224, 1211, 325, 500, 64, 402, 776, 217, 222, 410, 475, 580, 790, 791, 1129, 1021, 465, 321, 445]"
176,0,3504,6379,5480,0,550,2954,"[0, 106, 825, 550, 472, 456, 139, 737, 655, 727, 540, 893, 109, 681, 420, 590, 16, 897, 454, 129, 448, 819, 560, 222, 798, 218, 261]"
177,0,3372,1243,7609,0,2369,1003,"[0, 231, 301, 185, 306, 314, 277, 314, 177, 46, 158, 177, 262, 203, 98, 57, 236, 84, 251, 330, 15, 272, 282, 107, 0, 31, 40]"
178,0,3286,3008,7887,0,2243,1043,"[0, 274, 346, 23, 260, 175, 108, 295, 310, 312, 296, 175, 97, 132, 255, 15, 3, 300, 334, 33, 95, 58, 25, 20, 211, 73, 307]"
179,0,3533,5865,5555,0,1070,2463,"[0, 304, 265, 706, 436, 697, 151, 53, 102, 329, 797, 504, 791, 471, 723, 435, 771, 83, 684, 369, 357, 810, 619, 288, 437, 788, 521]"
180,0,4046,780,8821,0,3906,140,"[0, 11, 32, 21, 16, 11, 43, 34, 32, 44, 32, 23, 15, 21, 31, 30, 46, 23, 27, 2, 43, 28, 34, 19, 45, 9, 32]"
181,0,4566,5171,8216,0,2202,2364,"[0, 230, 779, 521, 2, 687, 275, 184, 230, 231, 411, 733, 28, 132, 497, 615, 782, 473, 84, 593, 665, 238, 199, 59, 481, 97, 295]"
182,0,4706,7491,5431,0,3084,1622,"[0, 248, 170, 235, 267, 540, 382, 424, 496, 313, 121, 447, 538, 159, 285, 140, 46, 480, 319, 434, 239, 226, 441, 435, 415, 367, 184]"
183,0,4674,3044,7061,0,558,4116,"[0, 997, 1033, 1264, 608, 485, 294, 732, 1305, 1168, 1118, 178, 807, 992, 196, 1130, 574, 1009, 148, 349, 349, 629, 152, 1366, 988, 550, 1219]"
184,0,4503,5850,5714,0,3338,1165,"[0, 51, 50, 244, 231, 40, 67, 38, 197, 290, 229, 136, 155, 131, 260, 19, 41, 265, 80, 131, 95, 36, 170, 384, 216, 385, 50]"
185,0,4845,4335,6224,0,3171,1674,"[0, 101, 385, 215, 133, 343, 394, 390, 379, 431, 443, 265, 316, 135, 160, 269, 20, 456, 43, 102, 190, 26, 328, 130, 75, 231, 106]"
186,0,3547,1306,8465,0,3096,451,"[0, 58, 23, 150, 65, 31, 80, 102, 72, 116, 132, 79, 120, 36, 20, 121, 31, 8, 109, 43, 72, 53, 111, 93, 19, 23, 95]"
187,0,4838,5432,7871,0,4476,362,"[0, 2, 0, 104, 52, 71, 22, 69, 99, 68, 103, 94, 83, 118, 50, 105, 116, 119, 72, 10, 87, 96, 54, 57, 65, 95, 3]"
188,0,4255,6036,6090,0,3955,300,"[0, 16, 12, 66, 31, 30, 4, 22, 17, 39, 80, 3, 24, 100, 81, 39, 36, 41, 4, 18, 68, 70, 98, 57, 73, 94, 67]"
189,0,3375,1174,8291,0,2452,923,"[0, 179, 288, 67, 147, 249, 172, 50, 301, 203, 280, 158, 12, 165, 146, 244, 270, 5, 234, 168, 295, 207, 80, 57, 228, 30, 141]"
190,0,3668,5913,6046,0,1828,1840,"[0, 436, 371, 50, 388, 389, 203, 380, 357, 579, 590, 400, 272, 182, 141, 485, 333, 237, 533, 363, 9, 167, 58, 224, 81, 342, 131]"
191,0,4341,1212,9175,0,1122,3219,"[0, 293, 582, 91, 516, 704, 589, 550, 17, 614, 976, 335, 950, 298, 562, 330, 519, 489, 675, 486, 772, 415, 249, 838, 272, 328, 598]"
192,0,4286,6534,6927,0,1740,2546,"[0, 214, 66, 657, 814, 568, 638, 233, 557, 653, 661, 182, 454, 260, 537, 440, 549, 558, 841, 699, 190, 56, 21, 136, 124, 426, 353]"
193,0,4787,7134,4580,0,3033,1754,"[0, 492, 108, 311, 354, 521, 266, 544, 447, 390, 568, 325, 426, 43, 228, 211, 299, 155, 263, 519, 136, 296, 520, 350, 386, 369, 377]"
194,0,4445,1664,7361,0,272,4173,"[0, 186, 451, 1021, 835, 1210, 487, 1139, 31, 839, 676, 571, 202, 1185, 795, 202, 936, 85, 1169, 439, 65, 112, 303, 869, 395, 63, 1307]"
195,0,3277,313,10000,325,990,2287,"[0, 247, 367, 629, 32, 262, 751, 520, 755, 235, 724, 289, 94, 77, 413, 388, 501, 142, 726, 294, 45, 290, 343, 546, 385, 158, 503]"
196,0,4319,5925,8394,0,1980,2339,"[0, 287, 177, 662, 615, 727, 317, 114, 606, 687, 575, 625, 53, 13, 686, 128, 720, 531, 266, 35, 406, 553, 139, 223, 135, 318, 698]"
197,0,3199,6371,5222,0,2112,1087,"[0, 360, 287, 320, 211, 250, 11, 141, 39, 208, 15, 356, 32, 356, 131, 226, 196, 41, 76, 303, 71, 266, 67, 28, 149, 91, 1]"
198,0,3860,2560,6522,0,1805,2055,"[0, 666, 650, 9, 235, 566, 104, 0, 159, 4, 84, 243, 527, 223, 648, 279, 617, 278, 370, 43, 127, 178, 431, 213, 526, 400, 5]"
199,0,4427,69,10000,880,3837,590,"[0, 167, 187, 51, 1, 20, 41, 179, 58, 183, 9, 30, 123, 166, 60, 49, 26, 192, 130, 61, 95, 37, 17, 67, 162, 170, 130]"
200,0,4676,6218,8458,0,4358,318,"[0, 52, 24, 67, 44, 3, 44, 73, 9, 10, 22, 61, 81, 66, 33, 45, 15, 46, 40, 14, 101, 19, 61, 42, 1, 93, 84]"
201,0,3383,6181,5660,0,3130,253,"[0, 21, 22, 57, 39, 10, 78, 6, 17, 27, 35, 25, 22, 55, 63, 2, 74, 64, 16, 27, 4, 5, 5, 56, 35, 17, 27]"
202,0,4939,2585,8014,0,3299,1640,"[0, 374, 39, 496, 110, 251, 127, 461, 539, 259, 477, 50, 129, 8, 206, 224, 250, 400, 383, 533, 301, 88, 251, 185, 67, 361, 248]"
203,0,3530,6072,5472,0,663,2867,"[0, 675, 326, 940, 69, 675, 816, 116, 367, 831, 502, 499, 836, 94, 811, 691, 786, 628, 891, 739, 77, 457, 900, 814, 663, 147, 347]"
204,0,3160,464,8168,0,1882,1278,"[0, 52, 368, 358, 53, 63, 383, 334, 250, 336, 121, 253, 293, 317, 408, 227, 306, 118, 142, 24, 66, 306, 39, 361, 151, 191, 78]"
205,0,4904,6611,6461,0,4600,304,"[0, 49, 42, 44, 54, 73, 94, 95, 53, 50, 83, 55, 90, 9, 83, 29, 33, 44, 63, 91, 77, 47, 39, 101, 97, 27, 43]"
206,0,4764,6766,4459,0,864,3900,"[0, 1077, 565, 106, 177, 799, 415, 463, 525, 563, 1011, 543, 1249, 730, 1156, 620, 1073, 933, 711, 259, 578, 817, 306, 87, 474, 134, 819]"
207,0,3976,1022,7413,0,3227,749,"[0, 105, 1, 82, 127, 55, 53, 164, 195, 64, 99, 181, 123, 184, 32, 172, 221, 86, 119, 41, 192, 192, 74, 159, 19, 112, 148]"
208,0,4618,6672,5359,0,1797,2821,"[0, 237, 478, 796, 670, 21, 492, 426, 172, 559, 259, 818, 183, 621, 497, 721, 853, 869, 568, 939, 55, 766, 470, 451, 295, 308, 472]"
209,0,4820,4324,5855,0,1164,3656,"[0, 780, 929, 677, 1211, 309, 1118, 291, 891, 59, 970, 475, 1213, 1174, 58, 347, 884, 1056, 786, 293, 513, 95, 987, 387, 799, 979, 850]"
210,0,3526,2742,6639,0,3009,517,"[0, 130, 111, 29, 7, 128, 143, 165, 123, 45, 136, 34, 26, 8, 44, 55, 93, 55, 138, 39, 66, 53, 138, 4, 16, 99, 5]"
211,0,4740,5889,5490,0,2472,2268,"[0, 49, 73, 371, 75, 355, 648, 440, 664, 619, 2, 327, 122, 265, 433, 650, 402, 282, 540, 163, 576, 5, 495, 240, 40, 392, 332]"
212,0,4991,2644,7837,0,3136,1855,"[0, 495, 607, 279, 299, 44, 279, 579, 518, 409, 281, 50, 470, 355, 131, 95, 463, 166, 101, 371, 432, 26, 407, 618, 306, 401, 374]"
213,0,4003,6900,4940,0,93,3910,"[0, 731, 322, 732, 1018, 158, 1003, 973, 502, 1067, 1263, 728, 992, 286, 1033, 23, 954, 711, 527, 82, 1228, 137, 503, 1025, 488, 763, 1263]"
214,0,3993,2912,6021,0,2200,1793,"[0, 7, 26, 417, 178, 460, 293, 299, 271, 2, 105, 378, 129, 158, 210, 374, 34, 440, 217, 564, 561, 511, 340, 34, 470, 534, 295]"
215,0,4330,3731,6620,0,1905,2425,"[0, 586, 303, 124, 566, 803, 521, 760, 407, 82, 67, 428, 49, 284, 284, 473, 681, 114, 111, 587, 87, 724, 326, 133, 695, 588, 375]"
216,0,4476,6766,4330,0,3751,725,"[0, 126, 74, 206, 158, 206, 157, 75, 33, 1, 181, 107, 222, 241, 225, 151, 21, 29, 13, 163, 143, 92, 224, 105, 93, 99, 58]"
217,0,4262,2752,5840,0,1792,2470,"[0, 635, 563, 789, 772, 583, 417, 323, 474, 194, 486, 367, 770, 414, 176, 97, 599, 287, 423, 143, 98, 733, 313, 12, 559, 155, 125]"
218,0,4089,1531,8398,0,893,3196,"[0, 358, 1040, 683, 536, 363, 780, 773, 366, 850, 98, 1020, 389, 612, 866, 931, 912, 471, 647, 244, 719, 187, 551, 877, 317, 292, 399]"
219,0,3295,5596,6097,0,1382,1913,"[0, 436, 200, 486, 231, 501, 428, 470, 293, 157, 91, 259, 591, 169, 53, 364, 149, 68, 95, 627, 632, 26, 206, 224, 451, 421, 574]"
220,0,4813,12,10000,898,2445,2368,"[0, 391, 372, 333, 33, 557, 403, 425, 110, 623, 488, 197, 222, 784, 274, 182, 648, 228, 594, 361, 303, 478, 757, 476, 425, 603, 338]"
221,0,4565,6081,8484,0,1779,2786,"[0, 504, 266, 151, 616, 156, 115, 570, 889, 927, 797, 743, 568, 826, 877, 495, 29, 663, 873, 600, 380, 588, 857, 705, 488, 914, 205]"
222,0,3989,6902,5571,0,3232,757,"[0, 218, 176, 58, 81, 8, 67, 176, 218, 79, 28, 132, 58, 188, 72, 16, 201, 237, 31, 138, 251, 228, 142, 63, 34, 252, 172]"
223,0,3550,2938,6183,0,679,2871,"[0, 150, 497, 146, 551, 148, 924, 241, 82, 414, 809, 473, 496, 44, 2, 798, 432, 732, 14, 167, 346, 745, 433, 410, 891, 460, 869]"
224,0,4167,958,9392,0,3385,782,"[0, 106, 76, 180, 175, 188, 80, 60, 244, 130, 62, 19, 194, 88, 117, 243, 183, 75, 219, 160, 202, 235, 57, 170, 17, 244, 54]"
225,0,4194,5084,8502,0,2900,1294,"[0, 295, 341, 371, 122, 93, 388, 150, 84, 6, 339, 233, 388, 99, 228, 221, 337, 135, 263, 403, 317, 371, 192, 24, 424, 224, 179]"
226,0,4787,6051,7238,0,4024,763,"[0, 128, 86, 198, 168, 127, 65, 27, 236, 48, 166, 183, 104, 128, 216, 6, 254, 46, 227, 138, 26, 121, 248, 111, 150, 7, 81]"
227,0,4516,6705,5049,0,339,4177,"[0, 843, 752, 486, 1367, 23, 1359, 662, 0, 1047, 1173, 1355, 320, 1068, 955, 317, 178, 879, 407, 1347, 698, 639, 273, 798, 606, 678, 612]"
228,0,3940,2497,6492,0,2833,1107,"[0, 58, 358, 86, 152, 48, 112, 138, 139, 0, 64, 104, 87, 12, 16, 343, 247, 364, 295, 224, 263, 264, 111, 54, 193, 287, 299]"
229,0,4558,7495,3555,0,2870,1688,"[0, 116, 110, 272, 450, 341, 325, 268, 169, 275, 422, 32, 280, 523, 345, 210, 246, 262, 124, 382, 522, 187, 548, 180, 429, 476, 287]"
230,0,3505,185,6875,0,1956,1549,"[0, 89, 149, 317, 145, 27, 247, 396, 249, 480, 301, 129, 331, 209, 332, 175, 272, 233, 498, 67, 126, 378, 105, 136, 151, 66, 330]"
231,0,4462,6253,5084,0,516,3946,"[0, 1202, 858, 1223, 335, 637, 14, 7, 529, 1247, 974, 1075, 510, 729, 455, 186, 1104, 159, 844, 266, 311, 163, 164, 359, 275, 224, 446]"
232,0,4538,456,9166,0,4075,463,"[0, 89, 67, 100, 23, 55, 126, 92, 102, 118, 37, 125, 17, 47, 98, 59, 15, 18, 144, 9, 17, 146, 78, 100, 117, 119, 46]"
233,0,3802,6890,6078,0,2120,1682,"[0, 360, 364, 298, 164, 515, 304, 374, 206, 473, 121, 71, 281, 329, 463, 249, 406, 529, 342, 54, 47, 9, 188, 150, 486, 423, 233]"
234,0,3419,3226,6271,0,3029,390,"[0, 98, 33, 50, 50, 101, 33, 38, 24, 72, 9, 64, 32, 39, 28, 110, 32, 113, 47, 130, 117, 45, 115, 41, 29, 112, 115]"
235,0,3416,2946,6741,0,13,3403,"[0, 404, 793, 259, 750, 1012, 344, 735, 580, 723, 854, 1053, 965, 811, 831, 504, 626, 838, 254, 854, 22, 1050, 600, 723, 587, 9, 674]"
236,0,3611,1731,8621,0,1743,1868,"[0, 555, 118, 19, 113, 403, 304, 304, 259, 598, 508, 148, 613, 115, 249, 519, 251, 604, 381, 554, 128, 371, 590, 261, 296, 516, 136]"
237,0,3368,6917,5072,0,1424,1944,"[0, 137, 306, 267, 556, 337, 234, 133, 34, 584, 263, 144, 137, 29, 128, 451, 337, 43, 65, 513, 423, 489, 296, 416, 572, 60, 566]"
238,0,4610,1386,8296,0,1155,3455,"[0, 85, 1110, 238, 427, 1008, 91, 114, 1055, 459, 826, 701, 243, 42, 1098, 1008, 256, 192, 8, 935, 517, 293, 984, 84, 34, 563, 237]"
239,0,4915,6903,6308,0,4192,723,"[0, 69, 123, 101, 103, 195, 96, 104, 111, 164, 48, 130, 217, 94, 202, 68, 140, 24, 102, 74, 126, 98, 13, 201, 53, 39, 232]"
240,0,4311,2231,8388,0,2581,1730,"[0, 513, 474, 568, 359, 93, 121, 233, 341, 483, 61, 521, 101, 35, 160, 30, 278, 255, 541, 140, 147, 279, 566, 210, 247, 530, 239]"
241,0,3045,6331,5102,0,557,2488,"[0, 502, 811, 549, 7, 432, 8, 654, 566, 725, 264, 67, 315, 351, 822, 555, 640, 158, 633, 811, 154, 765, 505, 759, 735, 106, 34]"
242,0,4728,4597,5233,0,3390,1338,"[0, 195, 54, 308, 430, 28, 104, 191, 84, 358, 398, 183, 446, 336, 272, 158, 105, 75, 138, 35, 73, 299, 435, 428, 388, 67, 88]"
243,0,3474,1607,7100,0,552,2922,"[0, 328, 90, 144, 805, 591, 117, 445, 335, 656, 708, 303, 868, 165, 497, 540, 648, 436, 53, 397, 407, 584, 162, 72, 276, 971, 672]"
244,0,4248,6927,4421,0,4134,114,"[0, 10, 28, 11, 22, 35, 23, 25, 6, 3, 13, 28, 13, 14, 1, 5, 1, 22, 23, 10, 38, 4, 9, 12, 16, 35, 0]"
245,0,3819,1273,6967,0,576,3243,"[0, 106, 812, 304, 1045, 586, 554, 277, 168, 255, 832, 236, 605, 913, 710, 712, 134, 459, 825, 935, 261, 589, 471, 30, 633, 1015, 205]"
246,0,4449,5753,5663,0,1470,2979,"[0, 186, 408, 574, 818, 333, 618, 284, 747, 603, 502, 44, 493, 434, 7, 582, 409, 698, 901, 430, 857, 749, 894, 982, 444, 155, 769]"
247,0,4489,2879,7273,0,46,4443,"[0, 561, 569, 362, 368, 1450, 1249, 161, 1073, 1204, 1407, 1296, 1261, 957, 567, 1270, 143, 65, 250, 149, 945, 1290, 1083, 407, 1277, 1359, 1283]"
248,0,4647,6054,5866,0,956,3691,"[0, 749, 951, 591, 1165, 753, 402, 1205, 1033, 183, 470, 540, 825, 1103, 320, 54, 765, 789, 1216, 1193, 64, 1026, 488, 1047, 394, 202, 302]"
249,0,4010,3245,6631,0,1452,2558,"[0, 566, 336, 139, 469, 232, 550, 189, 431, 721, 291, 774, 473, 609, 720, 163, 71, 474, 608, 573, 634, 282, 736, 597, 583, 825, 190]"
250,0,4497,5675,5453,0,377,4120,"[0, 1040, 533, 1362, 702, 1202, 389, 830, 603, 512, 1283, 675, 1244, 693, 1312, 713, 1049, 1239, 1162, 170, 409, 1143, 367, 187, 403, 708, 633]"
251,0,4233,775,8911,0,2753,1480,"[0, 133, 183, 183, 209, 157, 459, 491, 424, 397, 411, 166, 433, 201, 173, 67, 14, 134, 399, 231, 69, 298, 135, 95, 345, 131, 115]"
252,0,4600,6140,7371,0,1496,3104,"[0, 123, 994, 538, 83, 913, 624, 268, 367, 846, 850, 984, 641, 453, 1004, 618, 638, 484, 347, 178, 570, 668, 538, 518, 301, 309, 252]"
253,0,3631,6512,4490,0,268,3363,"[0, 95, 1081, 280, 474, 865, 847, 425, 483, 84, 110, 618, 117, 1032, 218, 647, 170, 281, 347, 553, 335, 868, 756, 509, 401, 917, 643]"
254,0,4892,2869,6513,0,1788,3104,"[0, 440, 113, 207, 928, 264, 785, 195, 619, 916, 982, 390, 241, 140, 119, 452, 1019, 584, 461, 381, 423, 94, 714, 655, 737, 857, 569]"
255,0,4677,6217,4973,0,4140,537,"[0, 156, 151, 106, 170, 28, 103, 55, 156, 80, 138, 141, 153, 70, 78, 119, 58, 19, 57, 40, 28, 99, 67, 49, 43, 155, 111]"
256,0,3192,2776,5389,0,841,2351,"[0, 437, 131, 502, 401, 509, 682, 279, 383, 742, 312, 214, 440, 91, 186, 147, 363, 759, 355, 277, 472, 258, 161, 222, 629, 269, 286]"
257,0,3722,3459,5652,0,647,3075,"[0, 520, 610, 285, 875, 788, 396, 84, 311, 471, 801, 821, 408, 389, 702, 104, 840, 399, 715, 828, 10, 145, 324, 147, 691, 765, 223]"
258,0,3947,1359,8240,0,3430,517,"[0, 149, 126, 127, 81, 102, 13, 35, 100, 97, 119, 155, 163, 147, 55, 106, 107, 46, 16, 65, 6, 66, 34, 128, 59, 127, 111]"
259,0,4021,6462,5799,0,379,3642,"[0, 115, 545, 1077, 719, 409, 727, 265, 688, 688, 669, 1143, 104, 346, 290, 397, 794, 445, 77, 712, 456, 1077, 979, 1023, 1065, 973, 163]"
260,0,4138,1224,8713,0,597,3541,"[0, 278, 111, 405, 420, 746, 55, 669, 573, 1080, 4, 185, 327, 431, 414, 1142, 684, 585, 1044, 841, 939, 681, 180, 875, 390, 413, 1175]"
261,0,3105,7163,4655,0,1297,1808,"[0, 73, 537, 507, 182, 232, 392, 161, 417, 422, 87, 503, 451, 554, 146, 266, 464, 391, 373, 267, 167, 337, 19, 452, 595, 460, 563]"
262,0,3711,2065,6301,0,1567,2144,"[0, 555, 442, 596, 177, 445, 346, 680, 549, 290, 606, 152, 115, 141, 503, 318, 380, 660, 279, 311, 453, 567, 22, 399, 32, 278, 714]"
263,0,4070,483,9888,0,2745,1325,"[0, 293, 15, 39, 422, 187, 250, 380, 110, 307, 297, 358, 338, 266, 188, 386, 270, 285, 319, 290, 37, 307, 229, 61, 7, 140, 106]"
264,0,3149,7098,5939,0,894,2255,"[0, 509, 675, 362, 701, 319, 74, 527, 534, 121, 421, 573, 500, 53, 714, 357, 401, 435, 695, 301, 512, 602, 419, 739, 102, 278, 319]"
265,0,3164,1968,7135,0,3019,145,"[0, 6, 20, 36, 9, 18, 2, 48, 29, 24, 37, 14, 10, 28, 47, 9, 19, 23, 29, 8, 4, 45, 40, 11, 15, 4, 38]"
266,0,4845,6235,5745,0,1977,2868,"[0, 893, 136, 189, 851, 614, 639, 348, 289, 743, 852, 624, 819, 28, 534, 862, 727, 604, 915, 625, 209, 333, 650, 381, 718, 896, 634]"
267,0,3956,3678,6023,0,2424,1532,"[0, 288, 106, 239, 332, 328, 39, 88, 94, 160, 186, 505, 196, 237, 223, 338, 418, 5, 180, 247, 153, 163, 108, 368, 57, 343, 256]"
268,0,3355,3267,6111,0,2466,889,"[0, 253, 248, 185, 165, 105, 172, 29, 270, 201, 210, 119, 118, 287, 32, 81, 96, 186, 95, 122, 210, 77, 100, 58, 168, 163, 199]"
269,0,4802,87,10000,826,855,3947,"[0, 926, 5, 1082, 1149, 809, 1183, 741, 310, 842, 911, 1300, 1251, 725, 593, 620, 291, 225, 1022, 606, 881, 399, 1079, 690, 724, 524, 800]"
270,0,3097,5363,7734,0,823,2274,"[0, 709, 323, 387, 264, 46, 709, 693, 129, 154, 54, 51, 600, 581, 265, 266, 572, 22, 730, 468, 114, 235, 206, 538, 561, 721, 686]"
271,0,3672,7197,4209,0,2876,796,"[0, 198, 38, 47, 198, 88, 216, 227, 173, 56, 119, 58, 193, 264, 60, 247, 47, 10, 90, 173, 45, 162, 84, 160, 49, 138, 22]"
272,0,3006,1156,6059,0,2098,908,"[0, 97, 111, 69, 211, 75, 291, 23, 188, 143, 215, 44, 203, 181, 253, 215, 269, 276, 276, 165, 155, 9, 63, 49, 119, 58, 11]"
273,0,3228,2816,6471,0,797,2431,"[0, 267, 727, 476, 490, 375, 756, 567, 390, 199, 768, 84, 277, 147, 198, 564, 638, 391, 474, 60, 365, 57, 588, 329, 27, 382, 554]"
274,0,3790,1774,8487,0,2789,1001,"[0, 316, 146, 263, 228, 184, 188, 121, 143, 49, 30, 22, 100, 121, 305, 38, 329, 152, 148, 130, 80, 65, 67, 104, 18, 200, 171]"
275,0,3165,6517,5135,0,2085,1080,"[0, 5, 226, 274, 338, 241, 347, 280, 323, 227, 292, 337, 255, 108, 141, 275, 197, 275, 247, 279, 32, 99, 166, 204, 28, 324, 336]"
276,0,4546,188,9493,0,2234,2312,"[0, 607, 738, 201, 182, 609, 188, 243, 489, 57, 709, 716, 659, 495, 395, 215, 139, 124, 651, 689, 743, 662, 743, 167, 174, 472, 132]"
277,0,4199,6313,7379,0,3792,407,"[0, 123, 11, 121, 93, 72, 85, 69, 22, 64, 47, 67, 3, 135, 60, 1, 126, 58, 88, 50, 36, 8, 49, 9, 28, 122, 13]"
278,0,4439,6123,5695,0,4334,105,"[0, 10, 25, 5, 9, 2, 35, 29, 3, 20, 13, 4, 6, 7, 0, 35, 21, 4, 15, 7, 19, 5, 35, 8, 4, 30, 31]"
279,0,3216,2774,6137,0,1386,1830,"[0, 401, 575, 382, 557, 21, 354, 436, 106, 586, 139, 10, 55, 97, 439, 504, 195, 126, 599, 61, 507, 133, 467, 495, 563, 339, 28]"
280,0,3324,668,8793,0,686,2638,"[0, 329, 468, 215, 251, 765, 781, 441, 128, 198, 568, 9, 839, 868, 517, 688, 244, 746, 38, 48, 229, 167, 547, 457, 444, 178, 309]"
281,0,3332,5834,6291,0,1239,2093,"[0, 84, 205, 663, 122, 536, 592, 325, 494, 652, 196, 508, 563, 692, 7, 662, 61, 91, 239, 296, 158, 258, 112, 178, 400, 89, 540]"
282,0,3813,3200,6904,0,610,3203,"[0, 648, 681, 1015, 741, 859, 815, 319, 269, 107, 544, 566, 970, 11, 350, 73, 167, 502, 634, 363, 661, 542, 315, 1063, 546, 674, 911]"
283,0,4867,6994,4777,0,975,3892,"[0, 800, 8, 1295, 877, 1264, 249, 424, 1042, 565, 659, 230, 678, 1153, 296, 351, 285, 831, 590, 788, 236, 289, 673, 646, 668, 465, 888]"
284,0,4052,445,8384,0,1283,2769,"[0, 163, 155, 443, 174, 37, 758, 168, 712, 439, 503, 563, 587, 882, 361, 484, 319, 133, 759, 410, 247, 309, 308, 634, 253, 497, 753]"
285,0,3623,6543,5464,0,1415,2208,"[0, 355, 517, 522, 77, 701, 605, 528, 610, 260, 583, 469, 676, 507, 605, 7, 105, 198, 487, 660, 633, 293, 539, 341, 104, 496, 462]"
286,0,4943,3704,6703,0,4262,681,"[0, 199, 141, 155, 30, 113, 4, 217, 139, 163, 168, 12, 79, 128, 202, 115, 12, 98, 194, 48, 175, 178, 227, 0, 119, 100, 169]"
287,0,4183,554,10000,332,3848,335,"[0, 93, 39, 39, 74, 30, 37, 69, 2, 28, 67, 91, 83, 12, 66, 30, 48, 21, 52, 50, 59, 19, 71, 70, 92, 97, 74]"
288,0,3395,5877,7518,0,2837,558,"[0, 176, 23, 129, 9, 90, 107, 91, 161, 167, 42, 119, 138, 15, 184, 75, 155, 141, 178, 146, 118, 51, 29, 172, 56, 115, 110]"
289,0,3166,3041,7643,0,1545,1621,"[0, 146, 117, 145, 255, 85, 113, 146, 163, 39, 290, 66, 101, 208, 376, 11, 107, 126, 515, 114, 432, 295, 39, 333, 422, 114, 212]"
290,0,3469,7258,3854,0,3151,318,"[0, 81, 75, 87, 104, 64, 42, 65, 49, 68, 36, 42, 9, 29, 39, 71, 17, 55, 58, 83, 47, 59, 88, 21, 46, 64, 61]"
291,0,4985,1889,6950,0,1937,3048,"[0, 597, 746, 418, 648, 487, 98, 45, 841, 996, 120, 648, 663, 57, 815, 909, 258, 530, 1000, 551, 653, 793, 528, 810, 671, 516, 791]"
292,0,3425,2852,7523,0,564,2861,"[0, 296, 741, 112, 808, 316, 384, 579, 447, 311, 627, 885, 860, 702, 458, 539, 856, 588, 887, 719, 740, 753, 658, 627, 776, 51, 583]"
293,0,4660,6125,6058,0,3956,704,"[0, 18, 64, 195, 46, 211, 102, 209, 225, 210, 45, 185, 156, 203, 215, 29, 197, 118, 226, 101, 16, 98, 44, 168, 136, 149, 187]"
294,0,3598,2661,6995,0,2444,1154,"[0, 262, 267, 270, 335, 210, 158, 242, 240, 148, 145, 112, 56, 138, 180, 8, 249, 30, 368, 108, 149, 222, 60, 339, 331, 126, 372]"
295,0,3592,2748,7839,0,3351,241,"[0, 46, 21, 46, 23, 27, 27, 58, 30, 67, 27, 42, 37, 36, 14, 77, 67, 30, 50, 50, 5, 12, 72, 8, 8, 21, 71]"
296,0,4326,7353,4812,0,990,3336,"[0, 21, 777, 437, 978, 908, 123, 346, 857, 687, 631, 401, 456, 95, 405, 865, 22, 412, 979, 644, 377, 158, 963, 570, 471, 477, 140]"
297,0,4755,3329,6238,0,916,3839,"[0, 938, 576, 1152, 81, 1221, 608, 49, 464, 294, 997, 423, 657, 315, 1013, 367, 775, 714, 934, 918, 84, 554, 75, 919, 790, 1100, 36]"
298,0,4524,844,9918,0,2815,1709,"[0, 424, 247, 289, 482, 4, 149, 280, 492, 375, 98, 287, 524, 100, 400, 442, 93, 409, 336, 117, 485, 70, 419, 183, 246, 533, 117]"
299,0,3080,6238,6760,0,1857,1223,"[0, 125, 357, 215, 77, 334, 392, 0, 277, 82, 230, 306, 375, 17, 86, 167, 42, 122, 179, 240, 160, 169, 39, 321, 361, 252, 172]"
0,1,1662,0,1662,0,950,712,"[106, 0, 207, 60, 138, 76, 66, 65, 204, 175, 104, 192, 232, 22, 6, 173, 220, 58, 1, 130, 117, 142, 177, 126, 32, 231, 19]"
1,1,2325,677,3310,0,2325,0,"[0, 0, 0, 0, 0, 0, 0, 0, 0, 0, 0, 0, 0, 0, 0, 0, 0, 0, 0, 0, 0, 0, 0, 0, 0, 0, 0]"
2,1,1838,1128,4020,0,40,1798,"[315, 0, 518, 279, 30, 292, 339, 229, 425, 60, 5, 247, 367, 137, 445, 325, 409, 424, 329, 203, 313, 242, 174, 3, 211, 92, 524]"
3,1,2489,532,5977,0,342,2147,"[411, 0, 195, 581, 122, 356, 205, 359, 641, 557, 640, 248, 177, 492, 102, 278, 371, 421, 441, 460, 228, 559, 565, 112, 342, 162, 270]"
4,1,2995,2804,6168,0,249,2746,"[197, 0, 409, 475, 175, 770, 350, 146, 584, 322, 228, 554, 429, 653, 294, 657, 73, 414, 572, 717, 784, 467, 757, 170, 309, 832, 726]"
5,1,1368,1026,6510,0,1038,330,"[17, 0, 86, 21, 9, 14, 100, 81, 25, 89, 108, 49, 105, 101, 17, 102, 93, 83, 49, 65, 100, 93, 41, 69, 25, 0, 97]"
6,1,2883,2221,7172,0,257,2626,"[677, 0, 838, 512, 390, 657, 177, 859, 185, 66, 477, 528, 698, 508, 442, 358, 179, 206, 662, 360, 453, 614, 272, 35, 636, 758, 402]"
7,1,2940,1055,9057,0,476,2464,"[692, 0, 498, 155, 788, 739, 578, 711, 207, 435, 296, 788, 548, 28, 743, 688, 613, 491, 807, 100, 675, 786, 546, 292, 18, 115, 129]"
8,1,2977,7084,4950,0,184,2793,"[164, 0, 16, 385, 554, 290, 360, 294, 495, 572, 736, 840, 429, 640, 410, 121, 512, 95, 151, 142, 733, 577, 760, 879, 167, 319, 801]"
9,1,1318,300,5968,0,491,827,"[96, 0, 61, 210, 50, 253, 23, 83, 62, 79, 111, 89, 256, 31, 84, 24, 171, 162, 170, 249, 163, 133, 117, 112, 145, 102, 35]"
10,1,1651,904,6715,0,1536,115,"[9, 0, 35, 37, 16, 37, 35, 32, 36, 10, 2, 37, 38, 34, 18, 27, 2, 8, 4, 38, 13, 21, 12, 31, 38, 11, 9]"
11,1,2366,549,8532,0,78,2288,"[639, 0, 65, 320, 23, 653, 443, 181, 84, 626, 588, 35, 434, 621, 25, 671, 163, 400, 221, 523, 92, 238, 664, 293, 263, 255, 239]"
12,1,1367,107,9792,0,463,904,"[68, 0, 120, 223, 148, 277, 71, 12, 78, 28, 167, 44, 26, 285, 3, 135, 252, 198, 4, 9, 233, 76, 279, 98, 155, 254, 241]"
13,1,1692,5001,6483,0,23,1669,"[507, 0, 2, 554, 152, 66, 539, 66, 245, 26, 459, 111, 384, 472, 399, 306, 227, 178, 533, 137, 0, 254, 533, 217, 140, 142, 200]"
14,1,2137,274,8346,0,524,1613,"[101, 0, 70, 84, 65, 273, 401, 14, 121, 349, 153, 377, 427, 69, 189, 204, 263, 281, 161, 229, 39, 374, 443, 320, 316, 3, 515]"
15,1,1569,1160,8755,0,520,1049,"[164, 0, 162, 125, 195, 96, 92, 293, 160, 22, 33, 268, 104, 136, 92, 143, 53, 295, 219, 87, 6, 187, 199, 156, 267, 64, 246]"
16,1,2057,391,10000,421,1317,740,"[71, 0, 64, 113, 204, 26, 112, 169, 166, 126, 190, 21, 54, 16, 189, 9, 93, 219, 53, 177, 111, 114, 106, 171, 183, 232, 238]"
17,1,2487,5821,6666,0,45,2442,"[276, 0, 8, 799, 462, 42, 523, 439, 648, 431, 7, 104, 613, 57, 401, 281, 741, 771, 493, 783, 415, 126, 258, 671, 697, 735, 589]"
18,1,1898,261,8303,0,1189,709,"[232, 0, 67, 234, 80, 23, 53, 115, 16, 226, 67, 71, 28, 21, 196, 207, 37, 231, 16, 60, 145, 128, 51, 210, 31, 233, 224]"
19,1,1392,1260,8435,0,641,751,"[211, 0, 213, 12, 227, 93, 215, 132, 141, 10, 41, 49, 66, 4, 36, 176, 15, 42, 137, 179, 185, 200, 61, 166, 234, 157, 203]"
20,1,2352,1598,9189,0,0,2352,"[318, 0, 752, 203, 707, 646, 153, 280, 425, 756, 17, 658, 370, 170, 378, 358, 5, 134, 491, 679, 755, 57, 212, 46, 148, 416, 159]"
21,1,2146,7313,4022,0,1086,1060,"[38, 0, 139, 11, 38, 322, 31, 106, 71, 260, 65, 162, 314, 332, 245, 155, 287, 94, 146, 275, 196, 328, 100, 169, 11, 208, 79]"
22,1,2564,502,6084,0,472,2092,"[159, 0, 81, 444, 11, 278, 67, 635, 565, 625, 11, 359, 518, 467, 629, 372, 347, 376, 276, 464, 540, 382, 403, 36, 336, 71, 51]"
23,1,2207,1089,7202,0,1101,1106,"[294, 0, 97, 352, 41, 355, 2, 43, 366, 319, 147, 39, 325, 65, 310, 9, 199, 261, 168, 26, 309, 331, 30, 176, 105, 326, 345]"
24,1,2779,291,9690,0,302,2477,"[26, 0, 191, 139, 412, 179, 107, 165, 543, 170, 298, 751, 390, 77, 198, 680, 487, 692, 109, 191, 319, 648, 85, 590, 598, 339, 530]"
25,1,1560,6130,5120,0,82,1478,"[98, 0, 206, 73, 265, 321, 245, 440, 362, 326, 269, 290, 158, 185, 0, 194, 20, 233, 119, 297, 310, 163, 458, 249, 176, 70, 120]"
26,1,2004,1530,5594,0,700,1304,"[27, 0, 354, 404, 416, 5, 164, 411, 55, 220, 186, 293, 250, 174, 234, 215, 247, 205, 239, 294, 125, 172, 405, 385, 199, 125, 340]"
27,1,1104,247,6451,0,937,167,"[29, 0, 52, 12, 29, 29, 49, 42, 45, 22, 49, 9, 30, 9, 20, 18, 12, 35, 22, 3, 2, 31, 45, 46, 26, 25, 21]"
28,1,2118,1342,7227,0,1766,352,"[63, 0, 69, 10, 40, 30, 59, 49, 69, 16, 68, 103, 18, 42, 6, 20, 59, 32, 3, 12, 111, 57, 29, 77, 16, 84, 41]"
29,1,2231,1201,8257,0,1654,577,"[177, 0, 42, 88, 153, 106, 79, 4, 82, 142, 86, 48, 138, 182, 130, 117, 0, 70, 179, 123, 157, 125, 15, 189, 119, 153, 31]"
30,1,2597,1961,8893,0,1864,733,"[122, 0, 50, 92, 113, 68, 87, 12, 65, 183, 140, 51, 90, 197, 123, 114, 73, 158, 144, 229, 181, 40, 4, 41, 131, 70, 37]"
31,1,2841,5055,6679,0,988,1853,"[10, 0, 25, 477, 574, 483, 100, 325, 318, 361, 473, 77, 408, 537, 404, 266, 237, 79, 104, 202, 248, 217, 12, 251, 319, 51, 400]"
32,1,1915,482,8112,0,988,927,"[122, 0, 248, 8, 17, 101, 70, 233, 120, 230, 82, 20, 41, 242, 263, 102, 166, 268, 281, 18, 194, 10, 76, 68, 176, 199, 28]"
33,1,1490,800,8802,0,1009,481,"[84, 0, 78, 53, 116, 132, 117, 79, 13, 15, 57, 95, 38, 134, 146, 157, 117, 76, 9, 158, 117, 44, 35, 93, 12, 25, 79]"
34,1,2818,7273,4347,0,2797,21,"[0, 0, 4, 2, 7, 0, 7, 0, 5, 0, 3, 6, 4, 7, 6, 1, 6, 3, 2, 3, 3, 6, 0, 3, 7, 4, 0]"
35,1,1633,851,5129,0,121,1512,"[220, 0, 34, 206, 340, 378, 191, 64, 442, 244, 88, 149, 386, 34, 222, 135, 43, 279, 159, 487, 450, 142, 179, 89, 400, 139, 362]"
36,1,2350,1869,5610,0,828,1522,"[258, 0, 267, 55, 452, 12, 154, 341, 91, 45, 278, 128, 69, 266, 254, 91, 263, 210, 441, 108, 208, 157, 451, 251, 443, 378, 314]"
37,1,1783,1609,5784,0,1316,467,"[84, 0, 128, 31, 91, 56, 146, 66, 92, 122, 82, 146, 117, 121, 17, 103, 36, 105, 92, 93, 90, 155, 140, 75, 76, 75, 88]"
38,1,2603,118,8269,0,871,1732,"[267, 0, 437, 446, 280, 32, 472, 82, 156, 66, 404, 51, 328, 359, 386, 242, 457, 147, 76, 130, 363, 377, 55, 408, 560, 77, 312]"
39,1,1993,1881,8381,0,1815,178,"[23, 0, 22, 26, 37, 49, 43, 37, 4, 46, 26, 8, 41, 17, 10, 31, 23, 41, 33, 27, 18, 38, 2, 2, 18, 59, 54]"
40,1,1390,742,9029,0,522,868,"[279, 0, 236, 159, 27, 66, 270, 121, 212, 156, 40, 80, 287, 200, 4, 81, 253, 44, 264, 104, 87, 88, 127, 15, 247, 268, 149]"
41,1,1178,1047,9160,0,855,323,"[46, 0, 5, 8, 85, 17, 10, 15, 19, 53, 61, 69, 66, 97, 7, 57, 33, 54, 39, 12, 3, 80, 7, 35, 52, 12, 70]"
42,1,1635,1489,9306,0,376,1259,"[10, 0, 130, 209, 363, 35, 283, 299, 310, 142, 34, 15, 280, 279, 27, 224, 37, 227, 43, 395, 35, 251, 380, 15, 101, 103, 0]"
43,1,1221,206,10000,321,835,386,"[73, 0, 93, 70, 9, 16, 113, 104, 96, 99, 10, 40, 103, 96, 41, 110, 61, 81, 44, 12, 111, 8, 117, 33, 79, 17, 30]"
44,1,1377,5184,6193,0,860,517,"[122, 0, 99, 27, 88, 28, 154, 128, 34, 8, 53, 76, 161, 45, 23, 162, 43, 51, 67, 119, 58, 27, 133, 72, 64, 128, 147]"
45,1,2158,18,8333,0,540,1618,"[231, 0, 175, 273, 175, 481, 198, 421, 31, 276, 444, 388, 109, 30, 102, 431, 344, 501, 397, 172, 183, 241, 363, 372, 336, 65, 459]"
46,1,2292,1450,9175,0,440,1852,"[239, 0, 609, 447, 223, 100, 19, 335, 227, 4, 444, 507, 299, 476, 455, 466, 411, 312, 289, 356, 152, 357, 92, 480, 366, 456, 26]"
47,1,2317,6831,4661,0,1833,484,"[81, 0, 58, 59, 67, 61, 145, 145, 75, 88, 59, 14, 125, 96, 151, 76, 9, 53, 113, 115, 35, 54, 119, 106, 107, 54, 64]"
48,1,2857,1597,5921,0,2844,13,"[0, 0, 3, 3, 0, 0, 2, 3, 0, 0, 4, 1, 3, 4, 1, 2, 3, 3, 2, 1, 4, 0, 1, 1, 3, 4, 2]"
49,1,2629,1903,6647,0,409,2220,"[483, 0, 557, 68, 423, 639, 297, 469, 370, 722, 67, 504, 256, 460, 182, 490, 733, 75, 374, 344, 732, 389, 524, 193, 553, 294, 410]"
50,1,1478,145,7980,0,949,529,"[77, 0, 174, 132, 29, 50, 71, 150, 151, 5, 175, 125, 133, 96, 120, 121, 91, 23, 20, 57, 116, 47, 170, 15, 67, 156, 171]"
51,1,2847,525,10000,302,1935,912,"[55, 0, 146, 194, 74, 164, 39, 16, 163, 275, 120, 206, 68, 6, 128, 44, 292, 8, 177, 62, 86, 299, 227, 149, 78, 248, 179]"
52,1,2773,6158,6615,0,1550,1223,"[244, 0, 286, 16, 163, 377, 154, 78, 177, 393, 185, 337, 345, 406, 22, 249, 380, 323, 29, 76, 1, 313, 357, 344, 174, 28, 170]"
53,1,1255,651,7219,0,1029,226,"[2, 0, 62, 46, 55, 52, 28, 57, 70, 38, 48, 28, 73, 68, 13, 44, 62, 48, 19, 32, 0, 68, 51, 20, 70, 50, 10]"
54,1,2748,1333,8634,0,2665,83,"[7, 0, 3, 10, 15, 22, 1, 23, 13, 19, 10, 21, 11, 16, 5, 3, 23, 19, 21, 19, 23, 0, 2, 27, 21, 7, 24]"
55,1,1794,1269,9159,0,614,1180,"[223, 0, 20, 196, 126, 131, 10, 188, 101, 228, 171, 55, 235, 312, 167, 201, 369, 177, 319, 292, 136, 33, 358, 217, 310, 23, 376]"
56,1,2139,6061,5237,0,1567,572,"[45, 0, 66, 131, 112, 4, 148, 62, 150, 41, 97, 70, 62, 183, 10, 107, 27, 24, 97, 95, 132, 32, 176, 156, 64, 27, 153]"
57,1,1490,1092,5635,0,162,1328,"[416, 0, 307, 282, 400, 344, 223, 43, 87, 117, 31, 183, 178, 141, 90, 361, 295, 316, 288, 413, 6, 152, 48, 187, 174, 282, 384]"
58,1,2197,71,7761,0,268,1929,"[517, 0, 96, 111, 199, 454, 132, 54, 21, 379, 448, 519, 297, 358, 202, 469, 533, 261, 426, 215, 477, 150, 593, 293, 5, 279, 40]"
59,1,2085,1307,8539,0,1317,768,"[162, 0, 137, 54, 181, 45, 233, 50, 225, 27, 87, 122, 155, 185, 231, 216, 17, 185, 229, 203, 8, 226, 73, 99, 32, 54, 116]"
60,1,1011,771,8779,0,613,398,"[8, 0, 14, 99, 11, 40, 68, 81, 33, 132, 29, 54, 104, 102, 119, 39, 89, 10, 32, 51, 40, 125, 76, 126, 49, 90, 44]"
61,1,1090,764,9105,0,968,122,"[15, 0, 6, 40, 26, 11, 12, 23, 18, 12, 15, 24, 37, 25, 27, 19, 1, 28, 34, 30, 9, 5, 12, 1, 19, 13, 13]"
62,1,2008,5243,5870,0,576,1432,"[68, 0, 265, 343, 316, 228, 425, 211, 287, 275, 9, 79, 79, 384, 203, 148, 6, 419, 75, 149, 191, 123, 338, 219, 336, 315, 445]"
63,1,1473,1115,6228,0,1293,180,"[51, 0, 48, 46, 8, 31, 9, 56, 14, 57, 7, 36, 8, 40, 36, 10, 17, 20, 26, 11, 7, 31, 53, 19, 59, 26, 22]"
64,1,1999,971,7256,0,215,1784,"[172, 0, 582, 516, 41, 94, 144, 136, 414, 205, 20, 594, 468, 29, 88, 207, 221, 450, 368, 430, 336, 162, 287, 386, 477, 213, 227]"
65,1,1221,234,8243,0,355,866,"[155, 0, 224, 39, 77, 277, 224, 64, 119, 13, 69, 252, 89, 248, 245, 71, 78, 181, 220, 83, 282, 15, 134, 26, 137, 60, 194]"
66,1,1147,370,9020,0,444,703,"[33, 0, 128, 217, 1, 46, 135, 210, 152, 218, 65, 122, 68, 142, 164, 28, 61, 22, 202, 54, 135, 54, 132, 39, 138, 52, 82]"
67,1,1533,436,10000,117,391,1142,"[90, 0, 53, 331, 293, 300, 212, 21, 96, 332, 59, 87, 150, 344, 141, 172, 246, 107, 154, 308, 112, 105, 225, 228, 80, 305, 120]"
68,1,1898,5805,6093,0,524,1374,"[57, 0, 258, 85, 207, 356, 76, 378, 4, 376, 391, 298, 16, 269, 323, 374, 86, 407, 156, 179, 150, 192, 137, 430, 69, 293, 40]"
69,1,1728,1420,6401,0,192,1536,"[161, 0, 189, 27, 225, 379, 349, 259, 325, 236, 367, 361, 417, 225, 95, 118, 326, 350, 122, 64, 191, 294, 92, 164, 253, 57, 502]"
70,1,1338,1002,6737,0,782,556,"[114, 0, 168, 41, 185, 90, 55, 87, 109, 110, 102, 63, 123, 124, 28, 173, 2, 97, 137, 157, 10, 140, 30, 83, 183, 158, 87]"
71,1,1639,1347,7029,0,799,840,"[166, 0, 216, 211, 257, 32, 65, 229, 228, 126, 160, 217, 94, 28, 243, 53, 173, 223, 110, 126, 234, 176, 130, 223, 151, 91, 79]"
72,1,1542,1177,7394,0,1056,486,"[33, 0, 60, 65, 108, 69, 135, 105, 29, 72, 84, 76, 138, 56, 123, 69, 114, 2, 87, 147, 117, 143, 102, 56, 42, 113, 60]"
73,1,1014,530,7878,0,645,369,"[19, 0, 16, 102, 17, 28, 13, 123, 56, 63, 36, 41, 107, 81, 36, 22, 23, 101, 1, 92, 25, 91, 35, 3, 13, 18, 70]"
74,1,1235,590,8523,0,42,1193,"[274, 0, 134, 283, 312, 358, 51, 161, 282, 78, 391, 231, 95, 257, 101, 391, 268, 10, 200, 118, 171, 195, 145, 198, 34, 222, 169]"
75,1,1355,573,9305,0,1188,167,"[6, 0, 50, 19, 32, 10, 18, 14, 8, 53, 20, 14, 21, 44, 50, 15, 43, 55, 47, 31, 38, 19, 21, 21, 43, 38, 40]"
76,1,2489,6225,5569,0,2231,258,"[70, 0, 13, 7, 46, 5, 71, 12, 48, 31, 62, 50, 79, 38, 60, 81, 2, 28, 30, 9, 76, 35, 14, 38, 24, 83, 61]"
77,1,1165,931,5803,0,469,696,"[134, 0, 9, 83, 25, 26, 232, 58, 104, 74, 52, 58, 148, 230, 189, 21, 166, 138, 29, 147, 0, 231, 71, 6, 94, 128, 76]"
78,1,2625,143,8285,0,27,2598,"[171, 0, 363, 106, 299, 363, 217, 692, 229, 175, 676, 488, 159, 411, 749, 827, 138, 535, 316, 564, 690, 405, 2, 265, 326, 681, 747]"
79,1,2413,1265,9433,0,1164,1249,"[374, 0, 192, 346, 213, 369, 272, 226, 292, 406, 364, 324, 267, 70, 399, 176, 153, 17, 70, 90, 342, 288, 63, 101, 380, 168, 279]"
80,1,1953,6044,5342,0,815,1138,"[85, 0, 57, 215, 29, 54, 162, 6, 143, 162, 69, 277, 318, 196, 165, 140, 236, 195, 140, 105, 136, 300, 310, 227, 36, 228, 310]"
81,1,2091,30,7403,0,1267,824,"[5, 0, 188, 1, 196, 243, 137, 49, 268, 13, 22, 170, 253, 195, 261, 23, 230, 2, 116, 150, 261, 50, 243, 202, 0, 193, 148]"
82,1,1272,996,7679,0,894,378,"[63, 0, 88, 41, 123, 109, 72, 87, 48, 16, 63, 91, 108, 78, 5, 106, 63, 90, 83, 11, 64, 59, 39, 1, 47, 98, 86]"
83,1,2447,2139,7987,0,612,1835,"[126, 0, 332, 525, 384, 130, 586, 531, 499, 498, 590, 323, 214, 484, 213, 184, 221, 81, 163, 512, 486, 517, 69, 441, 174, 121, 558]"
84,1,2304,653,9638,0,766,1538,"[150, 0, 356, 271, 433, 269, 270, 135, 191, 227, 237, 510, 303, 31, 41, 192, 241, 484, 120, 3, 308, 465, 359, 147, 52, 104, 110]"
85,1,2855,5486,7007,0,277,2578,"[395, 0, 119, 656, 663, 263, 21, 813, 472, 303, 130, 69, 619, 202, 615, 223, 551, 617, 645, 269, 676, 582, 28, 318, 457, 253, 666]"
86,1,1120,208,7919,0,1078,42,"[8, 0, 6, 5, 1, 14, 7, 4, 2, 6, 3, 14, 8, 2, 7, 9, 2, 7, 3, 7, 2, 3, 12, 1, 11, 11, 2]"
87,1,2775,1395,9299,0,1096,1679,"[559, 0, 506, 504, 457, 376, 134, 82, 276, 411, 161, 245, 34, 461, 472, 318, 322, 39, 40, 103, 439, 58, 524, 441, 296, 193, 531]"
88,1,2175,5969,5505,0,1307,868,"[195, 0, 151, 18, 55, 69, 57, 84, 242, 108, 149, 197, 93, 113, 143, 199, 154, 145, 156, 29, 235, 78, 131, 159, 49, 79, 199]"
89,1,2555,623,7437,0,401,2154,"[288, 0, 175, 558, 136, 660, 315, 328, 249, 335, 442, 611, 394, 390, 483, 148, 159, 253, 243, 670, 290, 96, 434, 104, 607, 548, 101]"
90,1,2741,2139,8039,0,1000,1741,"[59, 0, 118, 238, 91, 76, 429, 217, 15, 14, 480, 471, 225, 116, 261, 69, 189, 245, 135, 11, 356, 180, 438, 412, 56, 14, 478]"
91,1,3000,5612,5427,0,814,2186,"[482, 0, 435, 432, 215, 172, 484, 446, 61, 575, 492, 492, 646, 72, 164, 190, 525, 77, 173, 180, 658, 78, 432, 47, 496, 262, 492]"
92,1,2291,291,7427,0,36,2255,"[413, 0, 442, 0, 596, 724, 574, 634, 263, 228, 469, 615, 516, 533, 103, 503, 643, 344, 326, 572, 176, 478, 661, 583, 737, 614, 208]"
93,1,1311,1000,7738,0,988,323,"[101, 0, 30, 14, 13, 60, 13, 43, 51, 29, 86, 103, 82, 30, 73, 24, 49, 59, 50, 32, 56, 83, 44, 90, 39, 25, 98]"
94,1,2044,1116,8666,0,1390,654,"[45, 0, 47, 43, 104, 62, 84, 107, 118, 38, 12, 174, 56, 198, 22, 166, 27, 212, 23, 181, 205, 17, 0, 104, 167, 202, 187]"
95,1,2604,7431,3839,0,625,1979,"[570, 0, 537, 579, 624, 395, 410, 16, 445, 329, 520, 578, 307, 395, 400, 481, 381, 92, 647, 129, 111, 635, 209, 262, 311, 644, 239]"
96,1,2357,573,5623,0,1265,1092,"[55, 0, 352, 334, 88, 4, 146, 308, 99, 92, 308, 22, 270, 124, 121, 236, 214, 189, 312, 318, 44, 137, 205, 275, 293, 330, 18]"
97,1,1747,120,7250,0,73,1674,"[426, 0, 210, 552, 433, 237, 38, 405, 68, 447, 303, 197, 319, 187, 295, 470, 209, 459, 84, 100, 400, 13, 13, 356, 230, 208, 411]"
98,1,1642,398,8494,0,1642,0,"[0, 0, 0, 0, 0, 0, 0, 0, 0, 0, 0, 0, 0, 0, 0, 0, 0, 0, 0, 0, 0, 0, 0, 0, 0, 0, 0]"
99,1,1552,1090,8956,0,251,1301,"[362, 0, 414, 208, 385, 245, 309, 287, 389, 73, 377, 324, 431, 31, 410, 394, 116, 343, 19, 383, 77, 411, 77, 411, 128, 419, 360]"
100,1,2152,5889,5219,0,38,2114,"[386, 0, 502, 514, 602, 545, 380, 341, 313, 355, 641, 593, 427, 654, 306, 524, 479, 651, 185, 30, 358, 95, 690, 11, 309, 428, 377]"
101,1,2060,1405,5874,0,838,1222,"[251, 0, 264, 355, 357, 127, 116, 155, 280, 113, 248, 185, 233, 328, 49, 111, 157, 156, 345, 288, 319, 61, 354, 47, 324, 198, 330]"
102,1,1007,674,6207,0,549,458,"[58, 0, 143, 36, 82, 94, 108, 64, 26, 86, 23, 95, 40, 148, 41, 35, 100, 0, 108, 139, 87, 53, 91, 127, 87, 9, 35]"
103,1,2191,1538,6860,0,2098,93,"[25, 0, 27, 10, 19, 10, 22, 12, 4, 20, 7, 7, 6, 24, 13, 15, 12, 27, 23, 22, 1, 7, 3, 25, 22, 18, 11]"
104,1,2837,1086,8611,0,182,2655,"[376, 0, 842, 507, 55, 767, 38, 345, 499, 196, 285, 477, 113, 248, 403, 299, 443, 633, 870, 445, 382, 538, 272, 61, 581, 84, 796]"
105,1,2308,1110,9809,0,568,1740,"[434, 0, 80, 494, 16, 542, 504, 397, 152, 444, 250, 420, 24, 383, 513, 193, 23, 338, 64, 84, 47, 211, 526, 339, 253, 113, 489]"
106,1,1393,6237,4965,0,459,934,"[182, 0, 102, 193, 186, 223, 88, 65, 135, 8, 256, 31, 304, 121, 216, 208, 136, 238, 237, 268, 208, 94, 56, 305, 284, 241, 165]"
107,1,2608,1764,5809,0,1019,1589,"[267, 0, 335, 413, 274, 469, 300, 438, 215, 312, 39, 325, 423, 156, 425, 370, 305, 454, 78, 46, 510, 110, 486, 242, 453, 260, 388]"
108,1,1525,807,6527,0,221,1304,"[140, 0, 434, 147, 128, 392, 51, 332, 174, 54, 205, 344, 288, 140, 204, 58, 344, 417, 433, 352, 395, 419, 216, 24, 254, 287, 283]"
109,1,1749,1440,6836,0,1216,533,"[90, 0, 168, 139, 77, 33, 140, 150, 4, 14, 47, 143, 38, 136, 3, 41, 10, 152, 112, 52, 51, 30, 42, 18, 144, 107, 169]"
110,1,1905,1635,7106,0,472,1433,"[314, 0, 15, 442, 456, 191, 129, 37, 256, 138, 325, 171, 367, 121, 12, 28, 291, 430, 370, 454, 182, 57, 227, 315, 89, 168, 452]"
111,1,1050,810,7346,0,26,1024,"[311, 0, 109, 100, 251, 105, 340, 41, 50, 301, 241, 95, 334, 38, 134, 40, 178, 295, 34, 331, 80, 278, 221, 277, 104, 244, 25]"
112,1,1081,646,7781,0,417,664,"[212, 0, 67, 13, 116, 78, 36, 124, 55, 10, 163, 146, 142, 86, 42, 180, 51, 153, 6, 133, 10, 8, 148, 85, 221, 193, 62]"
113,1,2571,1885,8467,0,2214,357,"[56, 0, 28, 26, 67, 4, 116, 92, 106, 20, 79, 88, 69, 35, 87, 27, 88, 60, 23, 80, 48, 109, 58, 70, 96, 108, 113]"
114,1,2053,811,9709,0,525,1528,"[245, 0, 452, 283, 220, 27, 162, 29, 268, 218, 399, 76, 300, 145, 289, 95, 358, 287, 73, 214, 62, 344, 180, 99, 225, 108, 359]"
115,1,2060,6541,5228,0,1523,537,"[171, 0, 137, 156, 43, 145, 142, 67, 87, 165, 163, 140, 32, 95, 51, 106, 140, 151, 15, 165, 130, 172, 14, 152, 72, 141, 146]"
116,1,2346,1173,6401,0,954,1392,"[177, 0, 375, 381, 335, 93, 378, 383, 325, 396, 392, 86, 65, 20, 172, 149, 32, 146, 16, 88, 288, 172, 446, 180, 79, 341, 199]"
117,1,1441,1205,6637,0,1073,368,"[57, 0, 102, 22, 105, 33, 92, 96, 15, 29, 69, 31, 2, 15, 36, 22, 45, 65, 89, 69, 1, 31, 33, 101, 118, 97, 67]"
118,1,2738,681,8694,0,966,1772,"[180, 0, 511, 3, 232, 342, 505, 68, 31, 413, 37, 330, 452, 512, 364, 17, 450, 513, 300, 186, 112, 437, 16, 529, 327, 397, 453]"
119,1,2705,6171,5228,0,300,2405,"[488, 0, 456, 755, 450, 684, 50, 318, 474, 57, 753, 746, 557, 505, 142, 371, 87, 136, 345, 369, 344, 763, 58, 314, 233, 556, 88]"
120,1,1831,49,7010,0,1485,346,"[99, 0, 21, 69, 38, 12, 9, 61, 78, 72, 5, 88, 15, 26, 65, 28, 37, 46, 5, 77, 83, 57, 5, 91, 16, 21, 64]"
121,1,1896,1003,7903,0,322,1574,"[18, 0, 279, 235, 407, 366, 19, 46, 376, 438, 427, 404, 90, 306, 83, 378, 206, 472, 126, 445, 156, 495, 307, 124, 135, 32, 155]"
122,1,2976,2022,8857,0,2617,359,"[0, 0, 35, 13, 113, 4, 55, 18, 5, 48, 68, 114, 97, 96, 7, 112, 92, 52, 4, 62, 28, 101, 45, 54, 116, 42, 95]"
123,1,2403,5820,5440,0,62,2341,"[531, 0, 189, 747, 115, 489, 507, 22, 516, 773, 62, 655, 662, 143, 575, 656, 358, 743, 758, 599, 282, 190, 388, 325, 142, 745, 293]"
124,1,2448,2116,5772,0,770,1678,"[537, 0, 147, 316, 471, 28, 448, 429, 299, 559, 119, 411, 405, 504, 146, 366, 481, 181, 409, 408, 253, 521, 19, 393, 20, 453, 7]"
125,1,1369,684,6457,0,532,837,"[1, 0, 149, 200, 106, 179, 210, 212, 210, 14, 128, 228, 92, 2, 263, 17, 139, 231, 193, 125, 206, 125, 107, 76, 46, 123, 153]"
126,1,2609,1102,7964,0,985,1624,"[292, 0, 54, 58, 205, 215, 326, 176, 51, 505, 209, 477, 427, 207, 377, 8, 253, 193, 278, 231, 141, 297, 228, 392, 302, 447, 365]"
127,1,2260,1040,9184,0,2113,147,"[3, 0, 17, 23, 27, 31, 22, 30, 24, 26, 29, 42, 31, 37, 25, 29, 2, 24, 26, 47, 25, 32, 45, 22, 42, 12, 11]"
128,1,2273,5371,6086,0,1833,440,"[50, 0, 110, 142, 7, 64, 12, 146, 136, 19, 25, 24, 15, 129, 124, 122, 113, 80, 108, 73, 80, 75, 104, 141, 60, 73, 138]"
129,1,1318,86,7318,0,992,326,"[60, 0, 49, 9, 84, 94, 85, 22, 100, 10, 62, 86, 80, 7, 101, 1, 76, 54, 91, 14, 51, 57, 105, 71, 65, 88, 101]"
130,1,1179,745,7752,0,1129,50,"[7, 0, 9, 14, 10, 11, 9, 16, 5, 15, 11, 16, 15, 16, 14, 1, 6, 0, 7, 5, 15, 6, 10, 9, 10, 4, 3]"
131,1,1981,800,8933,0,557,1424,"[84, 0, 57, 351, 348, 228, 290, 277, 27, 36, 228, 253, 72, 79, 380, 120, 315, 404, 136, 117, 173, 115, 134, 308, 266, 173, 447]"
132,1,2866,5520,6279,0,2000,866,"[7, 0, 154, 166, 20, 14, 12, 115, 259, 88, 178, 21, 177, 54, 167, 154, 54, 220, 8, 263, 1, 267, 27, 145, 16, 16, 126]"
133,1,2229,2018,6490,0,649,1580,"[242, 0, 21, 258, 346, 323, 430, 181, 126, 295, 219, 517, 266, 270, 6, 264, 308, 173, 159, 208, 237, 337, 22, 53, 389, 387, 437]"
134,1,2253,1168,7575,0,617,1636,"[478, 0, 499, 106, 95, 267, 64, 243, 528, 508, 318, 45, 394, 92, 193, 88, 311, 146, 54, 48, 253, 242, 199, 417, 354, 194, 86]"
135,1,2441,1902,8114,0,1762,679,"[17, 0, 10, 67, 67, 29, 41, 138, 106, 71, 5, 30, 70, 122, 89, 147, 198, 7, 224, 68, 83, 7, 144, 168, 31, 103, 195]"
136,1,2516,870,9760,0,330,2186,"[509, 0, 6, 585, 229, 551, 319, 724, 214, 560, 190, 508, 251, 696, 140, 682, 325, 596, 13, 422, 368, 622, 436, 394, 391, 544, 199]"
137,1,2600,6786,5574,0,1374,1226,"[401, 0, 171, 150, 199, 16, 255, 199, 343, 7, 306, 204, 158, 280, 368, 344, 376, 44, 58, 70, 297, 360, 398, 2, 311, 260, 51]"
138,1,2522,703,7393,0,1683,839,"[92, 0, 30, 50, 24, 191, 120, 28, 195, 161, 186, 57, 194, 143, 214, 172, 21, 168, 92, 202, 149, 195, 26, 166, 255, 99, 217]"
139,1,2027,1011,8409,0,145,1882,"[347, 0, 212, 609, 267, 590, 592, 214, 111, 224, 364, 187, 384, 397, 22, 576, 354, 353, 517, 627, 8, 256, 261, 17, 106, 345, 398]"
140,1,1755,1436,8728,0,515,1240,"[144, 0, 183, 252, 337, 72, 281, 341, 103, 227, 318, 290, 133, 324, 81, 12, 212, 302, 152, 182, 198, 171, 322, 166, 360, 52, 219]"
141,1,2098,1662,9164,0,1525,573,"[31, 0, 11, 80, 76, 173, 128, 85, 27, 59, 188, 1, 191, 143, 154, 188, 27, 107, 15, 19, 10, 127, 76, 151, 36, 3, 113]"
142,1,1681,843,10000,2,339,1342,"[157, 0, 236, 136, 379, 64, 314, 169, 322, 47, 393, 82, 85, 255, 38, 329, 255, 359, 266, 106, 291, 167, 1, 47, 439, 160, 253]"
143,1,1838,7491,4347,0,783,1055,"[99, 0, 59, 111, 57, 192, 3, 200, 340, 109, 173, 269, 64, 164, 311, 169, 335, 148, 305, 173, 196, 32, 250, 22, 89, 205, 316]"
144,1,1570,696,5221,0,714,856,"[30, 0, 209, 97, 138, 196, 201, 31, 7, 134, 178, 6, 79, 244, 195, 278, 81, 269, 188, 191, 279, 281, 215, 269, 207, 121, 281]"
145,1,2728,1396,6553,0,706,2022,"[592, 0, 79, 67, 273, 18, 216, 551, 566, 529, 481, 57, 160, 408, 27, 465, 520, 247, 96, 602, 415, 484, 129, 226, 138, 143, 257]"
146,1,2482,1748,7287,0,580,1902,"[497, 0, 104, 590, 11, 524, 87, 360, 532, 149, 515, 154, 385, 579, 615, 17, 370, 341, 552, 488, 590, 26, 59, 391, 211, 210, 527]"
147,1,1536,1453,7370,0,283,1253,"[317, 0, 207, 59, 137, 13, 216, 171, 319, 167, 398, 82, 364, 233, 289, 385, 81, 240, 261, 124, 393, 322, 142, 244, 363, 299, 409]"
148,1,2450,2291,7529,0,1468,982,"[200, 0, 106, 80, 74, 103, 64, 131, 12, 84, 5, 308, 279, 68, 243, 159, 278, 150, 107, 155, 199, 27, 93, 196, 23, 152, 51]"
149,1,1364,1094,7799,0,479,885,"[258, 0, 255, 252, 103, 79, 41, 43, 272, 103, 72, 115, 109, 290, 242, 13, 32, 174, 4, 66, 214, 19, 7, 142, 35, 4, 210]"
150,1,1885,1371,8313,0,1377,508,"[16, 0, 92, 123, 22, 72, 90, 148, 105, 18, 118, 123, 118, 39, 72, 152, 92, 155, 79, 112, 35, 129, 124, 156, 4, 87, 75]"
151,1,1233,432,9114,0,1232,1,"[0, 0, 0, 0, 0, 0, 0, 0, 0, 0, 0, 0, 0, 0, 0, 0, 0, 0, 0, 0, 0, 0, 0, 0, 0, 0, 0]"
152,1,1848,1732,9230,0,924,924,"[53, 0, 122, 164, 291, 254, 73, 8, 234, 202, 1, 24, 89, 36, 48, 263, 291, 89, 270, 282, 108, 256, 80, 106, 198, 15, 55]"
153,1,1930,5986,5174,0,1636,294,"[42, 0, 55, 47, 68, 70, 61, 6, 95, 91, 74, 10, 8, 70, 76, 35, 26, 77, 44, 45, 2, 91, 49, 68, 6, 93, 98]"
154,1,1634,416,6392,0,1551,83,"[10, 0, 26, 21, 9, 11, 18, 23, 10, 6, 17, 13, 26, 22, 1, 27, 19, 4, 17, 0, 21, 2, 9, 10, 17, 16, 12]"
155,1,2915,2134,7173,0,897,2018,"[217, 0, 406, 572, 22, 590, 292, 486, 427, 409, 240, 158, 296, 279, 507, 444, 104, 649, 191, 248, 353, 522, 607, 638, 508, 21, 597]"
156,1,2395,1933,7635,0,1437,958,"[8, 0, 308, 10, 14, 85, 232, 106, 197, 187, 228, 68, 12, 230, 152, 266, 180, 300, 51, 248, 244, 186, 136, 145, 247, 3, 235]"
157,1,1807,112,9330,0,269,1538,"[138, 0, 354, 340, 454, 444, 325, 276, 460, 10, 286, 78, 488, 65, 22, 379, 511, 167, 111, 0, 16, 386, 175, 306, 213, 107, 119]"
158,1,1316,969,9677,0,424,892,"[240, 0, 73, 18, 137, 38, 22, 260, 135, 223, 98, 164, 33, 114, 169, 180, 284, 149, 186, 292, 151, 153, 244, 45, 26, 152, 155]"
159,1,2316,6729,5264,0,2135,181,"[13, 0, 9, 58, 29, 47, 46, 5, 47, 10, 59, 52, 29, 9, 17, 31, 16, 48, 27, 5, 60, 28, 33, 19, 26, 6, 9]"
160,1,2863,1040,7087,0,48,2815,"[439, 0, 638, 937, 500, 669, 749, 30, 41, 172, 921, 154, 542, 768, 43, 339, 54, 245, 144, 48, 261, 584, 101, 661, 52, 541, 645]"
161,1,2399,283,9203,0,562,1837,"[18, 0, 157, 396, 605, 45, 224, 542, 100, 52, 380, 581, 484, 173, 107, 173, 65, 34, 234, 45, 455, 274, 473, 69, 451, 89, 28]"
162,1,2883,5845,6241,0,539,2344,"[218, 0, 441, 339, 238, 424, 202, 658, 305, 18, 507, 263, 576, 407, 238, 686, 555, 351, 457, 636, 672, 657, 664, 625, 98, 490, 112]"
163,1,1290,120,7411,0,64,1226,"[210, 0, 5, 229, 127, 107, 95, 45, 55, 34, 342, 246, 161, 230, 314, 171, 105, 221, 293, 137, 241, 325, 365, 267, 126, 115, 192]"
164,1,2695,2646,7460,0,2144,551,"[110, 0, 114, 15, 42, 133, 123, 177, 177, 164, 135, 180, 172, 128, 169, 42, 41, 81, 152, 145, 166, 150, 62, 164, 113, 57, 31]"
165,1,2149,1305,8304,0,72,2077,"[266, 0, 499, 48, 577, 589, 475, 136, 154, 284, 78, 651, 322, 616, 373, 385, 489, 618, 629, 553, 496, 100, 668, 600, 673, 193, 515]"
166,1,2447,56,10000,695,551,1896,"[514, 0, 463, 529, 550, 18, 225, 257, 508, 513, 398, 80, 336, 247, 364, 319, 229, 222, 81, 460, 620, 591, 317, 302, 105, 143, 345]"
167,1,2215,5742,6473,0,2108,107,"[24, 0, 21, 8, 10, 4, 23, 6, 35, 26, 5, 11, 21, 34, 34, 29, 23, 8, 16, 23, 7, 17, 26, 29, 28, 28, 34]"
168,1,2655,1713,7415,0,1492,1163,"[48, 0, 110, 18, 385, 381, 246, 47, 360, 87, 350, 207, 320, 198, 85, 62, 269, 293, 179, 188, 133, 226, 108, 200, 144, 15, 51]"
169,1,2558,2060,7913,0,2090,468,"[59, 0, 153, 107, 52, 21, 16, 76, 137, 49, 86, 79, 155, 114, 73, 59, 88, 142, 42, 92, 145, 152, 22, 67, 137, 118, 45]"
170,1,2778,299,10000,392,791,1987,"[107, 0, 303, 341, 128, 98, 132, 507, 360, 482, 418, 540, 557, 40, 202, 625, 648, 264, 77, 578, 579, 641, 397, 472, 209, 78, 592]"
171,1,2866,6657,6209,0,491,2375,"[204, 0, 167, 715, 458, 297, 392, 178, 426, 494, 584, 678, 371, 254, 398, 133, 19, 327, 743, 527, 699, 691, 783, 687, 327, 519, 732]"
172,1,1773,1455,6527,0,1123,650,"[56, 0, 117, 64, 129, 119, 81, 8, 4, 195, 143, 80, 117, 95, 154, 213, 155, 22, 118, 211, 178, 67, 174, 54, 19, 59, 161]"
173,1,2543,2276,6794,0,1768,775,"[135, 0, 205, 216, 209, 238, 198, 258, 178, 164, 121, 197, 120, 139, 186, 112, 177, 194, 112, 167, 18, 6, 87, 222, 174, 19, 37]"
174,1,2819,2302,7311,0,1325,1494,"[449, 0, 374, 401, 290, 319, 215, 92, 126, 179, 255, 344, 242, 468, 159, 133, 102, 10, 168, 164, 14, 84, 2, 207, 291, 289, 55]"
175,1,1343,1077,7577,0,1324,19,"[2, 0, 1, 4, 1, 0, 0, 4, 0, 0, 0, 5, 3, 2, 0, 3, 3, 5, 5, 5, 3, 2, 0, 3, 3, 6, 4]"
176,1,2529,1587,8519,0,171,2358,"[115, 0, 759, 726, 187, 725, 541, 329, 664, 336, 592, 153, 292, 19, 488, 395, 522, 150, 71, 398, 538, 338, 48, 29, 293, 536, 288]"
177,1,2908,7276,4151,0,2006,902,"[279, 0, 276, 220, 144, 45, 233, 126, 205, 179, 95, 242, 229, 106, 150, 147, 67, 252, 70, 5, 18, 227, 57, 244, 296, 169, 255]"
178,1,2306,560,5897,0,208,2098,"[56, 0, 473, 83, 469, 87, 126, 283, 73, 439, 150, 270, 254, 315, 29, 198, 418, 435, 93, 240, 109, 573, 628, 186, 494, 97, 489]"
179,1,2709,375,8231,0,2344,365,"[77, 0, 97, 10, 76, 13, 85, 40, 88, 35, 43, 66, 72, 32, 113, 26, 46, 68, 88, 109, 74, 43, 51, 42, 87, 9, 41]"
180,1,2520,849,9902,0,1206,1314,"[371, 0, 185, 211, 240, 90, 185, 338, 340, 321, 212, 34, 31, 136, 51, 345, 89, 373, 205, 329, 368, 239, 373, 399, 243, 145, 390]"
181,1,2500,7164,5238,0,641,1859,"[399, 0, 311, 82, 29, 11, 9, 591, 196, 170, 298, 507, 99, 251, 575, 249, 196, 473, 434, 281, 306, 573, 556, 54, 153, 388, 175]"
182,1,1767,132,6873,0,1659,108,"[25, 0, 25, 8, 4, 10, 9, 13, 11, 6, 36, 21, 14, 26, 18, 33, 33, 0, 4, 31, 6, 3, 17, 36, 8, 21, 11]"
183,1,1645,559,7959,0,465,1180,"[158, 0, 362, 222, 215, 141, 370, 255, 205, 295, 360, 311, 78, 346, 5, 297, 330, 263, 0, 6, 189, 359, 205, 50, 37, 291, 202]"
184,1,2502,1169,9292,0,575,1927,"[175, 0, 313, 290, 485, 422, 153, 242, 269, 530, 590, 33, 39, 128, 487, 70, 562, 3, 274, 89, 456, 130, 593, 138, 523, 66, 622]"
185,1,1296,1124,9464,0,850,446,"[15, 0, 81, 101, 146, 46, 65, 112, 73, 133, 43, 73, 112, 142, 118, 147, 51, 32, 81, 134, 20, 141, 87, 73, 33, 146, 147]"
186,1,2838,6806,5496,0,1377,1461,"[226, 0, 200, 345, 450, 330, 466, 83, 457, 420, 341, 79, 344, 441, 222, 265, 336, 305, 236, 355, 115, 229, 109, 220, 176, 272, 275]"
187,1,2214,2140,5570,0,1150,1064,"[194, 0, 341, 80, 292, 293, 283, 2, 44, 345, 65, 161, 53, 272, 333, 43, 272, 157, 316, 144, 97, 47, 103, 280, 116, 223, 261]"
188,1,2263,1710,6123,0,2200,63,"[16, 0, 5, 11, 3, 19, 6, 20, 3, 21, 5, 12, 0, 5, 9, 18, 6, 7, 17, 12, 21, 4, 20, 13, 5, 4, 19]"
189,1,2999,1169,7953,0,78,2921,"[241, 0, 594, 473, 298, 708, 959, 230, 136, 420, 415, 499, 956, 3, 865, 395, 800, 930, 377, 936, 562, 86, 438, 15, 681, 871, 280]"
190,1,2690,1025,9618,0,1024,1666,"[159, 0, 510, 153, 333, 118, 510, 181, 17, 253, 376, 31, 198, 162, 249, 309, 15, 447, 377, 553, 541, 344, 26, 97, 103, 125, 338]"
191,1,2035,5497,6156,0,759,1276,"[315, 0, 395, 47, 113, 206, 101, 364, 243, 91, 110, 424, 245, 277, 301, 25, 203, 268, 316, 377, 110, 69, 229, 356, 270, 267, 235]"
192,1,1894,1231,6819,0,102,1792,"[578, 0, 287, 572, 77, 302, 333, 550, 432, 362, 340, 23, 289, 170, 481, 202, 25, 98, 72, 25, 269, 559, 340, 154, 272, 353, 274]"
193,1,1170,917,7072,0,569,601,"[98, 0, 82, 93, 11, 71, 112, 85, 180, 196, 182, 158, 19, 92, 68, 53, 128, 178, 54, 195, 129, 84, 38, 193, 124, 186, 199]"
194,1,2014,763,8323,0,1855,159,"[37, 0, 40, 42, 42, 33, 30, 43, 32, 48, 46, 12, 27, 23, 30, 22, 32, 13, 17, 18, 38, 4, 40, 22, 14, 45, 6]"
195,1,1319,901,8741,0,1053,266,"[49, 0, 62, 69, 33, 84, 71, 25, 60, 73, 62, 16, 46, 14, 63, 6, 66, 19, 39, 2, 80, 80, 67, 32, 80, 11, 0]"
196,1,2200,75,10000,866,256,1944,"[204, 0, 458, 131, 268, 321, 598, 25, 70, 73, 467, 27, 366, 382, 546, 625, 304, 53, 164, 536, 8, 0, 441, 540, 98, 523, 176]"
197,1,1272,7133,4139,0,1024,248,"[0, 0, 35, 20, 81, 20, 7, 64, 7, 13, 61, 76, 15, 67, 76, 15, 19, 49, 2, 29, 6, 64, 23, 80, 51, 63, 68]"
198,1,1737,897,4979,0,479,1258,"[398, 0, 357, 7, 3, 320, 210, 77, 102, 189, 395, 140, 171, 140, 412, 224, 283, 418, 65, 222, 200, 118, 209, 265, 292, 114, 377]"
199,1,1898,196,6681,0,966,932,"[78, 0, 121, 162, 222, 299, 26, 296, 6, 146, 86, 180, 134, 50, 123, 34, 160, 310, 275, 112, 230, 90, 295, 29, 205, 247, 218]"
200,1,1729,1056,7354,0,1313,416,"[21, 0, 6, 48, 16, 7, 87, 71, 32, 29, 56, 81, 56, 59, 103, 32, 132, 53, 12, 77, 49, 81, 55, 127, 137, 131, 131]"
201,1,2770,1544,8580,0,956,1814,"[532, 0, 2, 506, 266, 484, 105, 137, 538, 118, 456, 253, 421, 200, 242, 206, 204, 414, 241, 327, 41, 274, 67, 96, 204, 217, 17]"
202,1,2866,5084,6362,0,1800,1066,"[119, 0, 331, 337, 350, 167, 99, 326, 255, 126, 117, 158, 245, 83, 26, 178, 56, 211, 64, 185, 154, 151, 189, 64, 231, 84, 158]"
203,1,2849,1621,7590,0,2060,789,"[118, 0, 34, 18, 230, 84, 206, 130, 157, 172, 237, 234, 240, 263, 57, 174, 77, 99, 166, 254, 237, 145, 207, 169, 45, 52, 124]"
204,1,2999,2868,7721,0,1690,1309,"[408, 0, 263, 329, 253, 217, 28, 246, 349, 327, 326, 371, 328, 377, 136, 323, 35, 38, 342, 356, 100, 355, 160, 44, 264, 373, 220]"
205,1,2354,27,10000,48,1939,415,"[107, 0, 41, 132, 40, 39, 40, 66, 7, 19, 13, 77, 114, 128, 91, 14, 91, 35, 118, 90, 60, 50, 102, 101, 88, 22, 86]"
206,1,1941,5697,6244,0,181,1760,"[370, 0, 400, 463, 371, 451, 287, 451, 237, 419, 428, 117, 360, 203, 330, 328, 56, 87, 415, 158, 239, 193, 444, 422, 280, 119, 375]"
207,1,2894,1741,7397,0,1970,924,"[146, 0, 129, 23, 173, 308, 193, 294, 202, 182, 3, 158, 31, 123, 282, 29, 115, 19, 161, 60, 190, 1, 180, 31, 228, 209, 131]"
208,1,1852,1325,7924,0,1776,76,"[16, 0, 20, 20, 21, 23, 0, 15, 3, 13, 21, 8, 15, 5, 24, 19, 3, 18, 15, 21, 25, 15, 19, 18, 6, 5, 21]"
209,1,1855,1491,8288,0,826,1029,"[105, 0, 294, 178, 52, 47, 237, 3, 343, 317, 169, 276, 93, 105, 119, 60, 312, 126, 229, 212, 125, 86, 86, 307, 245, 295, 302]"
210,1,2408,410,10000,286,1146,1262,"[112, 0, 180, 373, 343, 220, 228, 106, 1, 68, 172, 278, 415, 5, 52, 349, 189, 22, 66, 42, 162, 122, 242, 96, 405, 133, 389]"
211,1,1804,6827,4977,0,1247,557,"[152, 0, 153, 55, 150, 174, 107, 157, 12, 4, 28, 38, 65, 56, 174, 81, 93, 136, 91, 70, 172, 12, 112, 161, 3, 109, 83]"
212,1,1889,1518,5348,0,1085,804,"[227, 0, 230, 74, 76, 138, 186, 153, 31, 237, 27, 21, 13, 131, 89, 39, 239, 82, 15, 217, 243, 179, 129, 264, 41, 8, 86]"
213,1,2658,1142,6864,0,1830,828,"[131, 0, 48, 119, 217, 234, 175, 182, 163, 2, 234, 106, 180, 93, 58, 121, 73, 192, 254, 135, 101, 128, 13, 97, 188, 126, 109]"
214,1,2898,1283,8479,0,1085,1813,"[441, 0, 207, 420, 473, 567, 230, 363, 140, 543, 582, 519, 505, 557, 419, 133, 517, 580, 192, 320, 392, 563, 25, 155, 349, 402, 494]"
215,1,1002,511,8970,0,211,791,"[144, 0, 136, 259, 213, 24, 250, 107, 60, 180, 101, 104, 37, 16, 82, 252, 48, 62, 113, 233, 221, 7, 148, 252, 155, 124, 207]"
216,1,1280,481,9769,0,786,494,"[121, 0, 112, 15, 14, 32, 76, 37, 32, 144, 10, 125, 68, 127, 92, 103, 33, 128, 50, 23, 70, 90, 147, 60, 0, 57, 136]"
217,1,1799,6445,5123,0,532,1267,"[172, 0, 239, 230, 193, 59, 176, 207, 162, 395, 380, 333, 166, 9, 329, 416, 51, 332, 357, 108, 346, 390, 48, 177, 169, 50, 162]"
218,1,2743,1604,6262,0,614,2129,"[316, 0, 137, 687, 317, 598, 403, 554, 397, 584, 533, 214, 224, 436, 144, 520, 47, 150, 359, 570, 571, 8, 429, 89, 546, 585, 490]"
219,1,2124,548,7838,0,1185,939,"[133, 0, 177, 252, 297, 50, 185, 130, 125, 120, 85, 278, 303, 134, 84, 217, 239, 138, 171, 117, 57, 49, 82, 116, 155, 313, 293]"
220,1,1641,19,9460,0,1599,42,"[9, 0, 2, 13, 11, 14, 0, 5, 12, 13, 1, 7, 12, 5, 14, 3, 1, 8, 5, 1, 3, 14, 1, 7, 6, 4, 2]"
221,1,1537,1114,9883,0,958,579,"[173, 0, 188, 41, 39, 94, 11, 167, 142, 158, 81, 81, 58, 117, 157, 77, 166, 181, 131, 177, 135, 98, 120, 35, 158, 4, 152]"
222,1,1769,5606,6046,0,956,813,"[238, 0, 117, 121, 195, 56, 221, 65, 82, 13, 198, 71, 188, 88, 15, 219, 216, 117, 181, 6, 201, 191, 3, 95, 214, 210, 211]"
223,1,2659,1781,6924,0,2020,639,"[105, 0, 28, 123, 89, 31, 190, 31, 118, 193, 129, 147, 134, 11, 106, 102, 95, 128, 65, 133, 169, 97, 2, 40, 143, 130, 8]"
224,1,1098,327,7695,0,731,367,"[40, 0, 34, 59, 75, 70, 97, 96, 119, 51, 22, 62, 97, 80, 95, 52, 83, 107, 103, 68, 34, 36, 105, 59, 9, 86, 10]"
225,1,1189,966,7918,0,512,677,"[123, 0, 74, 19, 192, 108, 15, 95, 89, 109, 109, 4, 32, 144, 51, 159, 120, 136, 220, 214, 85, 202, 85, 156, 179, 187, 217]"
226,1,1632,969,8581,0,1275,357,"[43, 0, 36, 68, 2, 98, 57, 22, 90, 55, 66, 53, 29, 16, 63, 57, 91, 38, 94, 52, 91, 74, 84, 9, 74, 119, 5]"
227,1,2411,2027,8965,0,523,1888,"[185, 0, 275, 572, 465, 189, 70, 464, 147, 226, 10, 130, 52, 481, 75, 475, 611, 146, 239, 467, 282, 44, 388, 469, 301, 259, 617]"
228,1,2069,7391,3643,0,1072,997,"[83, 0, 258, 245, 72, 296, 319, 30, 1, 144, 308, 135, 54, 14, 119, 116, 89, 184, 196, 94, 81, 22, 15, 164, 118, 20, 234]"
229,1,1403,466,4580,0,398,1005,"[5, 0, 181, 116, 15, 271, 144, 112, 308, 318, 267, 230, 75, 160, 240, 157, 3, 315, 246, 83, 192, 45, 287, 321, 94, 155, 33]"
230,1,2238,1159,5659,0,441,1797,"[162, 0, 456, 589, 144, 49, 412, 188, 418, 291, 510, 115, 189, 213, 138, 29, 266, 336, 456, 73, 59, 507, 232, 62, 377, 137, 467]"
231,1,2360,471,7548,0,1894,466,"[41, 0, 47, 50, 16, 2, 145, 46, 115, 24, 73, 53, 67, 19, 1, 48, 20, 87, 74, 47, 32, 129, 52, 13, 120, 148, 61]"
232,1,2464,1798,8214,0,534,1930,"[85, 0, 257, 600, 174, 223, 462, 345, 61, 233, 628, 597, 63, 418, 532, 431, 429, 118, 445, 448, 362, 201, 86, 251, 314, 320, 206]"
233,1,2829,5206,5837,0,900,1929,"[520, 0, 35, 237, 171, 146, 124, 182, 338, 394, 221, 479, 641, 96, 365, 1, 616, 475, 50, 54, 599, 137, 524, 525, 362, 12, 57]"
234,1,1225,1068,5994,0,516,709,"[231, 0, 160, 115, 97, 188, 0, 48, 75, 58, 73, 147, 33, 43, 189, 119, 28, 219, 4, 57, 175, 166, 214, 94, 126, 185, 24]"
235,1,1577,213,7358,0,603,974,"[98, 0, 37, 73, 206, 291, 207, 261, 191, 221, 275, 99, 182, 42, 64, 241, 41, 174, 200, 100, 12, 274, 216, 254, 194, 194, 56]"
236,1,2012,1858,7512,0,1006,1006,"[98, 0, 169, 174, 331, 91, 193, 69, 265, 125, 135, 123, 155, 153, 112, 74, 97, 33, 140, 208, 310, 181, 101, 27, 253, 27, 85]"
237,1,2068,1794,7786,0,1826,242,"[30, 0, 8, 7, 75, 25, 10, 33, 22, 10, 79, 70, 55, 71, 20, 48, 39, 57, 67, 42, 36, 79, 59, 70, 18, 9, 30]"
238,1,2705,1138,9353,0,2416,289,"[84, 0, 79, 62, 46, 45, 0, 50, 80, 1, 20, 69, 20, 52, 51, 21, 44, 83, 58, 5, 21, 18, 50, 6, 96, 85, 47]"
239,1,2175,5995,5533,0,204,1971,"[458, 0, 488, 432, 184, 64, 268, 424, 180, 224, 324, 184, 457, 16, 369, 486, 419, 6, 380, 438, 607, 634, 27, 427, 199, 468, 32]"
240,1,1052,1017,5568,0,230,822,"[186, 0, 228, 174, 163, 257, 161, 188, 16, 159, 74, 220, 191, 180, 174, 139, 45, 66, 254, 229, 75, 208, 194, 269, 190, 267, 269]"
241,1,2805,1707,6666,0,357,2448,"[411, 0, 69, 481, 800, 417, 811, 21, 736, 58, 61, 731, 117, 25, 201, 113, 94, 781, 89, 237, 390, 128, 220, 751, 761, 392, 245]"
242,1,1791,1536,6921,0,869,922,"[93, 0, 290, 13, 171, 216, 248, 30, 112, 232, 175, 155, 235, 266, 156, 51, 217, 190, 206, 103, 264, 247, 213, 296, 60, 2, 140]"
243,1,2171,532,8560,0,503,1668,"[186, 0, 272, 314, 218, 549, 498, 18, 153, 357, 128, 226, 35, 491, 4, 516, 368, 38, 66, 116, 387, 218, 450, 459, 507, 66, 157]"
244,1,1769,968,9361,0,1660,109,"[11, 0, 31, 6, 4, 12, 4, 29, 19, 23, 4, 9, 18, 3, 24, 20, 34, 5, 17, 23, 30, 17, 5, 2, 34, 15, 36]"
245,1,1806,5409,5758,0,708,1098,"[244, 0, 213, 175, 354, 1, 277, 70, 117, 72, 321, 29, 341, 301, 358, 31, 300, 101, 91, 186, 265, 26, 220, 12, 91, 199, 206]"
246,1,2446,511,7693,0,1052,1394,"[332, 0, 276, 451, 392, 329, 434, 393, 267, 179, 103, 377, 447, 302, 47, 77, 105, 348, 258, 112, 237, 324, 2, 149, 27, 268, 250]"
247,1,2630,1632,8691,0,2345,285,"[47, 0, 84, 17, 52, 12, 35, 95, 37, 24, 6, 5, 48, 21, 6, 23, 28, 37, 25, 17, 40, 93, 2, 58, 53, 88, 37]"
248,1,2363,7415,3639,0,1782,581,"[58, 0, 121, 60, 17, 28, 160, 37, 140, 129, 79, 120, 80, 172, 117, 40, 29, 63, 117, 63, 64, 107, 185, 112, 8, 52, 188]"
249,1,2668,405,5902,0,1195,1473,"[284, 0, 431, 380, 294, 338, 182, 260, 128, 412, 465, 269, 204, 171, 131, 142, 18, 49, 354, 333, 113, 377, 248, 282, 440, 220, 270]"
250,1,1459,1421,5940,0,1428,31,"[1, 0, 9, 6, 4, 7, 9, 10, 8, 10, 2, 5, 2, 1, 7, 5, 3, 10, 4, 4, 8, 9, 8, 5, 5, 6, 6]"
251,1,1210,491,6659,0,446,764,"[49, 0, 79, 250, 65, 111, 216, 152, 80, 71, 43, 164, 76, 30, 105, 84, 229, 68, 120, 251, 249, 118, 154, 169, 74, 236, 227]"
252,1,2898,1228,8329,0,687,2211,"[729, 0, 24, 452, 695, 429, 629, 361, 160, 306, 468, 455, 106, 440, 676, 17, 640, 32, 158, 45, 186, 165, 484, 187, 736, 583, 285]"
253,1,2063,1181,9211,0,713,1350,"[303, 0, 365, 137, 272, 188, 388, 443, 265, 247, 385, 386, 6, 197, 89, 397, 384, 278, 334, 367, 302, 311, 89, 415, 85, 381, 243]"
254,1,2031,5458,5784,0,1817,214,"[22, 0, 7, 23, 36, 66, 12, 9, 32, 57, 54, 19, 66, 57, 47, 33, 56, 53, 59, 42, 53, 62, 71, 10, 53, 45, 10]"
255,1,2690,1052,7422,0,1364,1326,"[59, 0, 320, 64, 76, 229, 354, 148, 13, 61, 132, 47, 134, 264, 148, 421, 354, 369, 362, 58, 154, 399, 191, 387, 313, 180, 409]"
256,1,2661,1522,8561,0,1242,1419,"[0, 0, 288, 469, 123, 17, 18, 222, 298, 184, 101, 272, 429, 425, 442, 169, 441, 30, 426, 355, 148, 19, 311, 355, 432, 445, 137]"
257,1,1547,1096,9012,0,955,592,"[71, 0, 143, 187, 53, 83, 91, 193, 118, 158, 99, 56, 64, 138, 89, 62, 62, 118, 112, 106, 119, 189, 174, 22, 22, 62, 46]"
258,1,2115,6967,4160,0,1812,303,"[93, 0, 48, 69, 27, 84, 73, 22, 0, 53, 43, 28, 36, 61, 4, 67, 54, 99, 7, 68, 42, 82, 35, 20, 45, 79, 15]"
259,1,2699,2518,4341,0,1105,1594,"[513, 0, 270, 313, 48, 149, 457, 125, 173, 481, 472, 421, 108, 208, 124, 414, 216, 480, 234, 33, 268, 306, 58, 311, 524, 22, 81]"
260,1,2173,1571,4943,0,1137,1036,"[54, 0, 196, 319, 316, 47, 313, 294, 55, 148, 267, 69, 94, 311, 47, 270, 259, 36, 90, 226, 271, 288, 224, 54, 142, 206, 276]"
261,1,2343,81,7205,0,2088,255,"[8, 0, 46, 43, 9, 78, 63, 78, 44, 23, 28, 14, 37, 49, 81, 62, 52, 55, 83, 82, 55, 53, 69, 55, 9, 57, 84]"
262,1,1021,269,7957,0,642,379,"[124, 0, 106, 6, 53, 32, 65, 51, 112, 9, 69, 7, 38, 35, 54, 86, 91, 32, 117, 102, 2, 110, 76, 25, 51, 18, 8]"
263,1,1076,422,8611,0,684,392,"[116, 0, 98, 115, 80, 32, 127, 99, 32, 21, 109, 66, 21, 129, 41, 74, 106, 64, 29, 17, 66, 16, 76, 92, 80, 33, 61]"
264,1,1723,475,9859,0,149,1574,"[78, 0, 164, 260, 258, 232, 221, 327, 31, 320, 338, 523, 473, 352, 312, 300, 298, 131, 185, 125, 46, 306, 325, 462, 321, 59, 311]"
265,1,2731,5515,7075,0,2577,154,"[11, 0, 45, 41, 0, 49, 47, 7, 3, 30, 25, 37, 9, 36, 51, 11, 6, 50, 22, 35, 6, 18, 23, 3, 27, 42, 47]"
266,1,2050,1037,8088,0,336,1714,"[132, 0, 218, 39, 342, 204, 225, 526, 72, 250, 46, 167, 337, 2, 550, 306, 429, 173, 355, 250, 91, 464, 446, 94, 389, 438, 23]"
267,1,2374,1843,8619,0,2070,304,"[36, 0, 26, 55, 86, 76, 17, 26, 72, 35, 27, 74, 68, 28, 16, 86, 24, 76, 75, 2, 68, 97, 40, 28, 0, 13, 11]"
268,1,2450,7259,3810,0,978,1472,"[87, 0, 152, 62, 20, 253, 181, 226, 486, 248, 205, 432, 159, 84, 321, 39, 19, 241, 405, 80, 191, 90, 429, 272, 393, 95, 383]"
269,1,1540,1125,4225,0,408,1132,"[363, 0, 171, 288, 18, 108, 56, 362, 199, 332, 48, 86, 304, 155, 7, 234, 267, 65, 183, 310, 252, 309, 34, 234, 15, 98, 223]"
270,1,2097,121,6201,0,1223,874,"[272, 0, 93, 113, 118, 17, 277, 207, 245, 219, 207, 13, 196, 54, 2, 172, 89, 240, 4, 100, 92, 206, 217, 213, 107, 212, 136]"
271,1,1964,1409,6756,0,118,1846,"[330, 0, 384, 164, 328, 344, 24, 115, 233, 555, 276, 205, 519, 71, 160, 403, 275, 22, 525, 232, 584, 237, 55, 267, 594, 295, 399]"
272,1,2089,1295,7550,0,378,1711,"[493, 0, 394, 166, 507, 423, 457, 317, 239, 102, 133, 312, 98, 152, 226, 508, 169, 40, 86, 558, 183, 535, 144, 235, 368, 55, 145]"
273,1,1200,909,7841,0,239,961,"[254, 0, 198, 320, 320, 168, 277, 43, 18, 184, 132, 144, 113, 99, 103, 174, 63, 307, 81, 54, 298, 299, 199, 101, 181, 91, 192]"
274,1,2929,2283,8487,0,2801,128,"[34, 0, 6, 17, 3, 5, 25, 33, 37, 0, 11, 26, 14, 2, 5, 28, 0, 34, 2, 30, 39, 22, 42, 9, 34, 24, 41]"
275,1,1477,924,9040,0,188,1289,"[250, 0, 152, 156, 147, 251, 215, 137, 349, 298, 122, 21, 234, 324, 158, 13, 191, 329, 235, 278, 286, 286, 312, 127, 239, 53, 414]"
276,1,2256,5066,6230,0,1436,820,"[92, 0, 227, 131, 72, 145, 114, 87, 118, 1, 155, 213, 112, 256, 113, 171, 0, 109, 154, 28, 84, 194, 249, 95, 173, 243, 196]"
277,1,1050,392,6888,0,819,231,"[47, 0, 3, 3, 53, 21, 32, 75, 61, 48, 41, 34, 45, 53, 56, 38, 30, 10, 11, 26, 53, 26, 30, 32, 4, 65, 76]"
278,1,2005,1191,7702,0,3,2002,"[656, 0, 547, 643, 272, 112, 145, 160, 434, 496, 202, 220, 52, 172, 475, 229, 477, 81, 185, 98, 270, 298, 332, 308, 171, 153, 482]"
279,1,2906,1074,9534,0,111,2795,"[657, 0, 561, 505, 520, 147, 623, 212, 312, 133, 879, 127, 41, 717, 293, 764, 188, 507, 698, 82, 259, 925, 605, 794, 9, 497, 22]"
280,1,1068,351,10000,251,721,347,"[111, 0, 40, 47, 112, 114, 77, 51, 115, 73, 1, 83, 97, 72, 80, 107, 19, 97, 77, 56, 80, 26, 24, 48, 42, 28, 65]"
281,1,2194,6285,5909,0,599,1595,"[137, 0, 232, 296, 135, 83, 494, 311, 318, 388, 320, 342, 501, 119, 73, 524, 47, 85, 10, 187, 244, 365, 177, 375, 487, 469, 342]"
282,1,2763,924,7748,0,1298,1465,"[353, 0, 70, 414, 291, 147, 396, 49, 281, 469, 32, 427, 260, 456, 124, 456, 310, 353, 74, 398, 328, 403, 410, 359, 390, 427, 352]"
283,1,2014,1834,7928,0,968,1046,"[189, 0, 97, 103, 260, 114, 295, 302, 32, 179, 203, 25, 146, 146, 158, 29, 318, 100, 50, 265, 123, 279, 99, 266, 191, 103, 303]"
284,1,2859,1227,9560,0,1212,1647,"[138, 0, 314, 264, 70, 432, 34, 508, 129, 515, 472, 158, 418, 323, 520, 384, 541, 26, 157, 361, 193, 276, 129, 539, 295, 362, 509]"
285,1,1756,7022,4294,0,1721,35,"[5, 0, 1, 10, 8, 4, 1, 0, 5, 2, 7, 3, 11, 8, 9, 7, 10, 7, 2, 0, 10, 8, 9, 8, 6, 8, 2]"
286,1,2817,2581,4530,0,912,1905,"[226, 0, 136, 136, 423, 272, 397, 597, 260, 120, 411, 539, 97, 5, 28, 369, 44, 260, 73, 364, 229, 245, 456, 441, 563, 369, 543]"
287,1,1804,1316,5018,0,1680,124,"[34, 0, 23, 14, 6, 23, 1, 33, 7, 33, 0, 39, 33, 1, 19, 21, 36, 37, 17, 1, 32, 7, 34, 21, 37, 15, 6]"
288,1,1438,1362,5094,0,847,591,"[179, 0, 122, 14, 162, 136, 34, 87, 188, 122, 176, 96, 57, 25, 169, 57, 114, 104, 192, 29, 47, 179, 194, 117, 16, 33, 59]"
289,1,2180,1451,5823,0,568,1612,"[130, 0, 6, 533, 101, 54, 315, 325, 225, 410, 199, 69, 84, 454, 408, 338, 122, 257, 485, 422, 159, 296, 116, 280, 465, 123, 79]"
290,1,2771,2502,6092,0,2203,568,"[39, 0, 50, 62, 117, 64, 170, 76, 158, 10, 170, 75, 126, 98, 28, 188, 14, 103, 177, 185, 138, 10, 132, 28, 55, 164, 136]"
291,1,1493,587,6998,0,1011,482,"[144, 0, 101, 20, 103, 86, 38, 95, 25, 40, 32, 0, 140, 148, 81, 3, 70, 9, 51, 8, 125, 148, 16, 154, 81, 114, 75]"
292,1,1988,1763,7223,0,542,1446,"[291, 0, 62, 49, 407, 244, 134, 22, 286, 383, 298, 74, 5, 378, 7, 443, 477, 0, 309, 139, 79, 178, 275, 124, 414, 24, 271]"
293,1,1123,706,7640,0,1099,24,"[1, 0, 4, 2, 1, 5, 1, 4, 5, 4, 5, 2, 8, 8, 4, 5, 8, 3, 0, 0, 3, 4, 7, 7, 2, 7, 2]"
294,1,2921,2715,7846,0,2888,33,"[10, 0, 3, 1, 1, 9, 8, 0, 10, 3, 5, 0, 3, 8, 11, 11, 3, 11, 7, 6, 2, 0, 4, 8, 8, 3, 0]"
295,1,2307,2093,8060,0,2128,179,"[15, 0, 36, 58, 34, 49, 3, 14, 2, 27, 12, 48, 37, 9, 49, 28, 33, 35, 54, 1, 11, 2, 15, 20, 36, 49, 30]"
296,1,1344,77,9327,0,124,1220,"[312, 0, 215, 47, 286, 125, 220, 204, 345, 15, 320, 129, 319, 216, 107, 319, 341, 210, 146, 307, 248, 50, 271, 135, 394, 206, 212]"
297,1,1906,6739,4494,0,857,1049,"[48, 0, 95, 98, 320, 185, 230, 120, 307, 208, 55, 224, 265, 342, 178, 244, 210, 1, 288, 12, 192, 145, 160, 66, 210, 96, 287]"
298,1,1742,665,5571,0,424,1318,"[389, 0, 377, 345, 95, 76, 254, 320, 127, 200, 235, 73, 56, 258, 308, 186, 1, 224, 140, 220, 437, 18, 229, 328, 66, 194, 371]"
299,1,1119,142,6548,0,123,996,"[138, 0, 134, 168, 290, 253, 77, 157, 328, 301, 218, 262, 130, 196, 182, 257, 250, 30, 104, 176, 55, 90, 245, 94, 42, 266, 66]"
0,2,20,0,20,0,6,14,"[0, 3, 0, 4, 2, 0, 0, 3, 0, 0, 3, 2, 2, 4, 2, 4, 4, 3, 2, 4, 2, 0, 3, 3, 4, 0, 3]"
1,2,62,2,80,0,24,38,"[5, 5, 0, 8, 3, 8, 2, 12, 5, 0, 1, 11, 9, 11, 10, 9, 9, 10, 1, 5, 6, 12, 3, 8, 5, 6, 12]"
2,2,17,14,83,0,12,5,"[1, 0, 0, 0, 1, 1, 1, 0, 0, 1, 0, 0, 0, 1, 1, 0, 1, 1, 0, 1, 1, 0, 1, 1, 0, 1, 1]"
3,2,43,42,84,0,12,31,"[6, 3, 0, 2, 0, 3, 4, 10, 7, 6, 8, 5, 8, 1, 9, 5, 10, 6, 4, 0, 3, 0, 7, 4, 2, 1, 7]"
4,2,75,50,109,0,73,2,"[0, 0, 0, 0, 0, 0, 0, 0, 0, 0, 0, 0, 0, 0, 0, 0, 0, 0, 0, 0, 0, 0, 0, 0, 0, 0, 0]"
5,2,30,21,118,0,1,29,"[7, 7, 0, 3, 2, 2, 3, 3, 9, 4, 7, 8, 7, 9, 9, 4, 4, 2, 7, 1, 3, 2, 5, 9, 6, 9, 3]"
6,2,99,35,182,0,77,22,"[5, 0, 0, 3, 6, 0, 4, 6, 1, 1, 5, 7, 6, 2, 0, 7, 4, 0, 6, 5, 3, 3, 6, 4, 5, 3, 2]"
7,2,54,41,195,0,50,4,"[1, 0, 0, 0, 1, 0, 1, 1, 0, 0, 1, 1, 1, 0, 0, 0, 1, 0, 1, 0, 0, 1, 0, 0, 0, 1, 1]"
8,2,38,38,195,0,2,36,"[10, 4, 0, 0, 5, 6, 7, 9, 6, 5, 0, 9, 3, 12, 1, 6, 5, 9, 1, 4, 12, 6, 7, 6, 1, 6, 10]"
9,2,32,5,222,0,20,12,"[4, 0, 0, 4, 3, 2, 3, 2, 3, 0, 4, 4, 3, 0, 4, 2, 1, 4, 3, 1, 4, 3, 4, 1, 2, 4, 4]"
10,2,76,31,267,0,62,14,"[1, 3, 0, 2, 4, 0, 3, 3, 1, 2, 0, 0, 2, 0, 4, 2, 2, 1, 4, 4, 4, 3, 0, 0, 1, 3, 3]"
11,2,95,77,285,0,93,2,"[0, 0, 0, 0, 0, 0, 0, 0, 0, 0, 0, 0, 0, 0, 0, 0, 0, 0, 0, 0, 0, 0, 0, 0, 0, 0, 0]"
12,2,11,10,286,0,5,6,"[0, 0, 0, 0, 1, 1, 2, 0, 1, 1, 2, 1, 1, 1, 2, 1, 1, 1, 1, 0, 1, 2, 1, 1, 2, 2, 2]"
13,2,92,20,358,0,69,23,"[4, 4, 0, 1, 2, 5, 1, 2, 3, 2, 3, 7, 2, 6, 6, 0, 4, 3, 5, 3, 3, 7, 5, 5, 3, 5, 1]"
14,2,22,17,363,0,20,2,"[0, 0, 0, 0, 0, 0, 0, 0, 0, 0, 0, 0, 0, 0, 0, 0, 0, 0, 0, 0, 0, 0, 0, 0, 0, 0, 0]"
15,2,16,15,364,0,7,9,"[0, 3, 0, 2, 2, 2, 3, 2, 1, 0, 2, 2, 1, 2, 3, 3, 3, 0, 3, 2, 0, 3, 2, 1, 1, 1, 0]"
16,2,93,52,405,0,50,43,"[9, 10, 0, 1, 9, 14, 4, 11, 14, 4, 5, 9, 5, 11, 5, 1, 13, 0, 7, 11, 14, 5, 8, 2, 14, 4, 14]"
17,2,78,73,410,0,17,61,"[8, 11, 0, 13, 3, 9, 5, 20, 14, 14, 1, 5, 17, 3, 11, 15, 7, 2, 5, 4, 19, 17, 12, 0, 12, 15, 2]"
18,2,82,23,469,0,73,9,"[0, 3, 0, 0, 0, 2, 0, 2, 1, 1, 3, 1, 3, 0, 3, 1, 3, 3, 2, 2, 3, 2, 1, 0, 0, 0, 0]"
19,2,49,17,501,0,3,46,"[8, 2, 0, 10, 13, 12, 8, 6, 1, 4, 1, 13, 3, 14, 12, 3, 5, 7, 13, 7, 9, 15, 1, 3, 6, 8, 4]"
20,2,0,0,501,0,0,0,"[0, 0, 0, 0, 0, 0, 0, 0, 0, 0, 0, 0, 0, 0, 0, 0, 0, 0, 0, 0, 0, 0, 0, 0, 0, 0, 0]"
21,2,90,75,516,0,0,90,"[2, 30, 0, 0, 19, 11, 11, 17, 12, 25, 6, 5, 2, 6, 0, 11, 17, 23, 6, 23, 3, 1, 30, 4, 17, 17, 29]"
22,2,29,14,531,0,27,2,"[0, 0, 0, 0, 0, 0, 0, 0, 0, 0, 0, 0, 0, 0, 0, 0, 0, 0, 0, 0, 0, 0, 0, 0, 0, 0, 0]"
23,2,84,83,532,0,77,7,"[1, 0, 0, 2, 2, 1, 2, 2, 0, 2, 1, 1, 1, 1, 1, 2, 2, 1, 0, 0, 2, 1, 2, 0, 0, 0, 0]"
24,2,16,2,546,0,12,4,"[0, 1, 0, 1, 0, 1, 1, 1, 1, 1, 0, 1, 0, 1, 0, 0, 0, 1, 0, 1, 1, 1, 1, 1, 0, 1, 0]"
25,2,12,7,551,0,7,5,"[0, 0, 0, 1, 1, 1, 0, 1, 1, 0, 0, 0, 0, 1, 0, 0, 0, 1, 1, 0, 0, 0, 0, 0, 1, 1, 1]"
26,2,72,20,603,0,62,10,"[0, 0, 0, 2, 1, 1, 1, 1, 3, 2, 0, 3, 2, 0, 1, 2, 2, 0, 2, 3, 3, 1, 1, 0, 0, 1, 1]"
27,2,88,6,685,0,80,8,"[0, 1, 0, 0, 2, 1, 0, 1, 1, 0, 0, 0, 2, 0, 1, 2, 1, 1, 2, 2, 1, 1, 0, 0, 0, 0, 1]"
28,2,15,13,687,0,12,3,"[0, 0, 0, 1, 0, 1, 0, 1, 1, 1, 1, 1, 0, 1, 0, 0, 0, 1, 0, 0, 0, 1, 1, 0, 0, 1, 1]"
29,2,29,15,701,0,21,8,"[0, 2, 0, 0, 2, 2, 0, 1, 2, 0, 2, 0, 0, 0, 2, 0, 1, 1, 0, 1, 2, 1, 0, 0, 1, 2, 2]"
30,2,5,1,705,0,1,4,"[1, 1, 0, 1, 0, 1, 0, 1, 1, 0, 1, 0, 1, 1, 0, 1, 0, 1, 0, 0, 0, 0, 0, 0, 0, 1, 1]"
31,2,77,54,728,0,73,4,"[1, 1, 0, 1, 1, 1, 0, 1, 1, 0, 0, 0, 0, 1, 0, 1, 0, 0, 0, 0, 0, 1, 0, 0, 0, 0, 1]"
32,2,48,13,763,0,22,26,"[6, 2, 0, 8, 0, 1, 4, 8, 5, 5, 4, 7, 0, 7, 7, 2, 6, 0, 8, 7, 1, 8, 5, 6, 6, 1, 4]"
33,2,38,21,780,0,37,1,"[0, 0, 0, 0, 0, 0, 0, 0, 0, 0, 0, 0, 0, 0, 0, 0, 0, 0, 0, 0, 0, 0, 0, 0, 0, 0, 0]"
34,2,88,43,825,0,15,73,"[0, 1, 0, 4, 2, 22, 3, 4, 20, 4, 4, 1, 11, 2, 19, 4, 20, 19, 7, 18, 15, 2, 8, 13, 17, 10, 22]"
35,2,98,79,844,0,90,8,"[2, 0, 0, 1, 1, 1, 0, 2, 2, 1, 0, 0, 2, 1, 0, 0, 1, 2, 2, 0, 2, 2, 1, 2, 1, 1, 0]"
36,2,38,4,878,0,22,16,"[3, 2, 0, 2, 2, 1, 3, 0, 4, 4, 0, 0, 4, 0, 2, 4, 5, 2, 2, 4, 2, 3, 2, 1, 2, 2, 3]"
37,2,3,1,880,0,3,0,"[0, 0, 0, 0, 0, 0, 0, 0, 0, 0, 0, 0, 0, 0, 0, 0, 0, 0, 0, 0, 0, 0, 0, 0, 0, 0, 0]"
38,2,55,13,922,0,1,54,"[5, 2, 0, 6, 3, 4, 9, 1, 9, 1, 8, 11, 8, 17, 10, 14, 10, 7, 13, 13, 1, 13, 17, 4, 17, 14, 3]"
39,2,62,33,951,0,53,9,"[0, 1, 0, 2, 1, 0, 2, 3, 0, 1, 1, 3, 1, 0, 1, 3, 0, 1, 2, 0, 0, 2, 2, 1, 3, 1, 1]"
40,2,72,3,1020,0,10,62,"[8, 18, 0, 2, 0, 1, 8, 14, 17, 9, 19, 6, 12, 9, 2, 7, 12, 20, 19, 4, 1, 4, 4, 7, 18, 7, 5]"
41,2,81,54,1047,0,47,34,"[0, 10, 0, 8, 11, 9, 10, 1, 6, 4, 5, 1, 8, 3, 6, 3, 4, 5, 0, 5, 10, 6, 8, 6, 0, 7, 1]"
42,2,44,42,1049,0,28,16,"[1, 0, 0, 3, 4, 4, 1, 3, 3, 1, 0, 1, 4, 3, 0, 3, 5, 3, 0, 3, 0, 1, 1, 2, 2, 5, 4]"
43,2,44,31,1062,0,23,21,"[3, 7, 0, 0, 4, 1, 3, 3, 2, 4, 7, 7, 4, 4, 5, 0, 4, 4, 2, 4, 7, 1, 2, 2, 4, 3, 5]"
44,2,68,66,1064,0,57,11,"[2, 2, 0, 2, 1, 3, 0, 1, 0, 1, 2, 3, 3, 2, 2, 1, 0, 1, 2, 3, 1, 1, 2, 3, 2, 1, 1]"
45,2,89,63,1090,0,64,25,"[1, 6, 0, 0, 1, 1, 1, 1, 7, 2, 6, 8, 7, 1, 0, 4, 2, 7, 4, 5, 0, 1, 7, 3, 1, 2, 5]"
46,2,72,1,1161,0,26,46,"[4, 2, 0, 5, 11, 10, 14, 6, 2, 10, 5, 5, 0, 6, 13, 8, 4, 8, 5, 15, 6, 9, 9, 12, 11, 5, 0]"
47,2,93,49,1205,0,83,10,"[1, 3, 0, 3, 2, 3, 2, 0, 3, 3, 1, 1, 1, 2, 0, 3, 0, 3, 0, 0, 3, 2, 1, 1, 1, 0, 2]"
48,2,43,17,1231,0,25,18,"[5, 0, 0, 3, 6, 3, 4, 5, 0, 2, 0, 4, 0, 1, 6, 0, 6, 0, 6, 1, 1, 6, 2, 6, 5, 4, 0]"
49,2,44,35,1240,0,9,35,"[8, 4, 0, 3, 3, 7, 9, 9, 1, 7, 7, 5, 4, 2, 5, 1, 2, 4, 10, 10, 11, 9, 4, 11, 10, 2, 3]"
50,2,42,18,1264,0,18,24,"[0, 2, 0, 6, 7, 3, 6, 2, 2, 6, 2, 6, 6, 0, 0, 4, 3, 4, 2, 7, 7, 4, 6, 4, 1, 1, 4]"
51,2,59,9,1314,0,20,39,"[11, 6, 0, 12, 9, 7, 8, 13, 13, 10, 12, 6, 11, 8, 5, 9, 1, 12, 4, 9, 3, 6, 8, 6, 8, 13, 3]"
52,2,71,39,1346,0,29,42,"[7, 9, 0, 6, 6, 9, 2, 11, 1, 8, 7, 10, 3, 4, 3, 13, 1, 2, 12, 6, 14, 1, 11, 13, 12, 7, 9]"
53,2,80,71,1355,0,3,77,"[8, 9, 0, 13, 22, 0, 8, 11, 11, 7, 4, 7, 15, 9, 13, 15, 19, 10, 8, 22, 12, 3, 19, 15, 4, 23, 15]"
54,2,29,0,1384,0,29,0,"[0, 0, 0, 0, 0, 0, 0, 0, 0, 0, 0, 0, 0, 0, 0, 0, 0, 0, 0, 0, 0, 0, 0, 0, 0, 0, 0]"
55,2,53,32,1405,0,5,48,"[5, 8, 0, 12, 1, 5, 5, 9, 7, 11, 2, 6, 16, 11, 7, 4, 14, 7, 5, 12, 11, 0, 6, 4, 14, 0, 11]"
56,2,74,29,1450,0,70,4,"[1, 1, 0, 1, 0, 0, 1, 1, 0, 0, 0, 0, 0, 1, 0, 1, 1, 0, 1, 1, 0, 0, 1, 1, 0, 0, 0]"
57,2,0,0,1450,0,0,0,"[0, 0, 0, 0, 0, 0, 0, 0, 0, 0, 0, 0, 0, 0, 0, 0, 0, 0, 0, 0, 0, 0, 0, 0, 0, 0, 0]"
58,2,61,46,1465,0,30,31,"[5, 7, 0, 10, 5, 6, 10, 8, 7, 9, 0, 4, 2, 8, 4, 6, 9, 6, 10, 9, 3, 3, 1, 0, 7, 7, 1]"
59,2,6,3,1468,0,4,2,"[0, 0, 0, 0, 0, 0, 0, 0, 0, 0, 0, 0, 0, 0, 0, 0, 0, 0, 0, 0, 0, 0, 0, 0, 0, 0, 0]"
60,2,40,35,1473,0,10,30,"[6, 9, 0, 8, 8, 2, 5, 4, 0, 2, 2, 3, 4, 6, 2, 2, 7, 8, 10, 4, 5, 0, 8, 8, 6, 0, 0]"
61,2,81,2,1552,0,44,37,"[1, 10, 0, 7, 7, 8, 2, 9, 4, 8, 8, 8, 7, 6, 8, 0, 0, 4, 9, 12, 3, 1, 5, 5, 12, 4, 9]"
62,2,46,26,1572,0,12,34,"[2, 9, 0, 11, 6, 4, 10, 9, 9, 9, 2, 4, 11, 9, 2, 11, 9, 2, 2, 1, 0, 7, 9, 1, 9, 5, 8]"
63,2,66,38,1600,0,22,44,"[8, 8, 0, 1, 10, 1, 3, 13, 5, 2, 5, 8, 13, 12, 14, 10, 6, 10, 0, 1, 9, 10, 8, 8, 10, 1, 0]"
64,2,77,66,1611,0,75,2,"[0, 0, 0, 0, 0, 0, 0, 0, 0, 0, 0, 0, 0, 0, 0, 0, 0, 0, 0, 0, 0, 0, 0, 0, 0, 0, 0]"
65,2,31,30,1612,0,14,17,"[5, 3, 0, 1, 5, 4, 3, 1, 4, 5, 5, 3, 1, 0, 5, 4, 5, 2, 2, 0, 1, 0, 3, 2, 4, 0, 0]"
66,2,83,14,1681,0,13,70,"[5, 2, 0, 0, 18, 17, 9, 15, 7, 22, 12, 6, 11, 6, 0, 1, 14, 8, 18, 12, 0, 15, 9, 13, 13, 0, 12]"
67,2,16,1,1696,0,12,4,"[1, 1, 0, 0, 0, 1, 0, 0, 1, 1, 0, 1, 1, 0, 0, 0, 0, 1, 1, 1, 1, 0, 0, 1, 0, 1, 1]"
68,2,19,18,1697,0,15,4,"[0, 1, 0, 0, 0, 0, 1, 1, 0, 1, 0, 1, 0, 0, 1, 0, 0, 0, 1, 0, 1, 1, 1, 1, 1, 1, 1]"
69,2,94,40,1751,0,87,7,"[2, 0, 0, 2, 2, 0, 2, 1, 1, 1, 1, 2, 0, 2, 2, 1, 1, 2, 2, 0, 1, 0, 2, 0, 0, 0, 0]"
70,2,92,62,1781,0,12,80,"[17, 14, 0, 8, 0, 5, 18, 14, 18, 3, 9, 5, 2, 18, 6, 25, 20, 19, 9, 9, 0, 4, 8, 3, 10, 0, 7]"
71,2,78,9,1850,0,67,11,"[3, 0, 0, 1, 2, 2, 1, 0, 1, 3, 0, 2, 1, 3, 0, 3, 2, 0, 0, 1, 2, 1, 2, 3, 2, 2, 3]"
72,2,8,6,1852,0,6,2,"[0, 0, 0, 0, 0, 0, 0, 0, 0, 0, 0, 0, 0, 0, 0, 0, 0, 0, 0, 0, 0, 0, 0, 0, 0, 0, 0]"
73,2,13,5,1860,0,4,9,"[1, 2, 0, 2, 1, 1, 3, 2, 1, 1, 1, 0, 3, 1, 2, 2, 3, 1, 3, 1, 3, 1, 2, 2, 0, 2, 0]"
74,2,20,3,1877,0,12,8,"[2, 1, 0, 1, 1, 2, 1, 1, 0, 1, 2, 1, 1, 2, 0, 2, 0, 1, 0, 1, 1, 0, 1, 1, 0, 1, 1]"
75,2,89,42,1924,0,83,6,"[2, 2, 0, 2, 0, 2, 2, 2, 0, 2, 0, 1, 0, 1, 1, 0, 1, 2, 0, 0, 2, 1, 2, 0, 2, 0, 0]"
76,2,1,0,1878,0,0,1,"[0, 0, 0, 0, 0, 0, 0, 0, 0, 0, 0, 0, 0, 0, 0, 0, 0, 0, 0, 0, 0, 0, 0, 0, 0, 0, 0]"
77,2,6,2,1882,0,0,6,"[0, 1, 0, 2, 1, 0, 0, 1, 2, 0, 2, 2, 2, 2, 2, 2, 0, 2, 0, 0, 2, 0, 2, 0, 2, 2, 1]"
78,2,3,3,1882,0,0,3,"[0, 1, 0, 1, 0, 1, 0, 1, 1, 0, 1, 0, 0, 0, 0, 0, 0, 1, 0, 0, 0, 0, 0, 0, 1, 1, 1]"
79,2,41,19,1904,0,22,19,"[0, 2, 0, 1, 0, 0, 0, 0, 3, 0, 0, 2, 4, 5, 1, 3, 0, 2, 1, 0, 6, 0, 3, 4, 2, 3, 2]"
80,2,94,66,1932,0,53,41,"[0, 5, 0, 6, 7, 1, 4, 9, 13, 6, 3, 4, 12, 9, 2, 5, 9, 1, 0, 11, 11, 1, 11, 6, 4, 11, 7]"
81,2,57,38,1951,0,28,29,"[9, 8, 0, 9, 1, 9, 8, 7, 5, 4, 4, 8, 7, 8, 6, 7, 9, 3, 0, 5, 6, 1, 7, 5, 0, 9, 7]"
82,2,75,42,1984,0,68,7,"[0, 1, 0, 0, 0, 0, 2, 1, 0, 2, 2, 2, 0, 0, 2, 1, 1, 0, 0, 2, 1, 0, 2, 2, 1, 0, 0]"
83,2,57,56,1985,0,56,1,"[0, 0, 0, 0, 0, 0, 0, 0, 0, 0, 0, 0, 0, 0, 0, 0, 0, 0, 0, 0, 0, 0, 0, 0, 0, 0, 0]"
84,2,85,67,2003,0,12,73,"[10, 15, 0, 6, 2, 2, 1, 23, 18, 8, 5, 22, 15, 0, 1, 17, 0, 5, 23, 17, 5, 13, 2, 19, 24, 16, 17]"
85,2,75,37,2041,0,8,67,"[16, 10, 0, 20, 20, 11, 12, 2, 10, 0, 7, 2, 17, 17, 18, 10, 0, 13, 19, 20, 0, 15, 10, 22, 7, 0, 6]"
86,2,44,5,2080,0,40,4,"[1, 1, 0, 0, 1, 0, 0, 1, 0, 0, 1, 0, 0, 1, 0, 0, 1, 0, 0, 0, 1, 1, 1, 0, 1, 0, 1]"
87,2,28,0,2108,0,26,2,"[0, 0, 0, 0, 0, 0, 0, 0, 0, 0, 0, 0, 0, 0, 0, 0, 0, 0, 0, 0, 0, 0, 0, 0, 0, 0, 0]"
88,2,26,17,2117,0,15,11,"[3, 3, 0, 3, 1, 3, 0, 1, 0, 3, 2, 1, 2, 3, 0, 3, 0, 1, 1, 1, 2, 3, 3, 3, 2, 3, 3]"
89,2,49,34,2132,0,2,47,"[14, 3, 0, 12, 11, 7, 11, 14, 10, 7, 11, 6, 10, 10, 5, 4, 11, 15, 5, 15, 13, 9, 11, 7, 4, 2, 5]"
90,2,36,8,2160,0,35,1,"[0, 0, 0, 0, 0, 0, 0, 0, 0, 0, 0, 0, 0, 0, 0, 0, 0, 0, 0, 0, 0, 0, 0, 0, 0, 0, 0]"
91,2,34,33,2161,0,14,20,"[6, 2, 0, 6, 3, 3, 6, 1, 6, 5, 0, 0, 4, 6, 3, 5, 2, 5, 3, 4, 2, 1, 1, 1, 0, 0, 6]"
92,2,49,32,2178,0,29,20,"[1, 2, 0, 5, 5, 6, 5, 0, 3, 1, 2, 0, 6, 2, 0, 4, 0, 5, 5, 0, 6, 1, 0, 1, 5, 1, 4]"
93,2,85,52,2211,0,9,76,"[19, 14, 0, 18, 10, 23, 8, 3, 0, 12, 16, 21, 21, 3, 3, 14, 24, 14, 11, 0, 0, 9, 12, 18, 3, 13, 16]"
94,2,33,22,2222,0,18,15,"[5, 1, 0, 4, 5, 3, 1, 5, 2, 3, 0, 4, 2, 1, 4, 5, 1, 1, 0, 3, 4, 3, 5, 1, 0, 5, 4]"
95,2,79,49,2252,0,55,24,"[4, 4, 0, 7, 7, 8, 7, 4, 4, 3, 3, 2, 4, 7, 4, 2, 2, 2, 7, 0, 3, 7, 1, 1, 1, 5, 3]"
96,2,58,17,2293,0,18,40,"[2, 9, 0, 13, 2, 7, 3, 9, 4, 3, 3, 13, 6, 1, 8, 6, 9, 3, 13, 13, 1, 11, 8, 6, 2, 9, 1]"
97,2,80,51,2322,0,36,44,"[4, 3, 0, 7, 4, 12, 1, 10, 6, 2, 12, 5, 0, 10, 2, 12, 6, 14, 4, 5, 11, 4, 1, 1, 10, 8, 9]"
98,2,99,12,2409,0,0,99,"[1, 32, 0, 11, 23, 2, 18, 1, 23, 32, 9, 4, 28, 23, 30, 10, 24, 9, 18, 13, 24, 12, 8, 22, 4, 22, 26]"
99,2,52,21,2440,0,35,17,"[4, 3, 0, 4, 3, 2, 2, 5, 2, 1, 1, 3, 2, 3, 2, 4, 1, 1, 5, 5, 3, 2, 1, 0, 4, 5, 1]"
100,2,10,8,2442,0,2,8,"[0, 0, 0, 1, 2, 1, 1, 2, 0, 2, 1, 1, 2, 0, 0, 1, 1, 1, 0, 0, 1, 2, 1, 2, 0, 0, 0]"
101,2,57,25,2474,0,42,15,"[1, 4, 0, 4, 1, 4, 4, 1, 1, 3, 5, 0, 0, 0, 1, 5, 3, 5, 3, 3, 5, 5, 4, 5, 0, 0, 1]"
102,2,97,45,2526,0,17,80,"[9, 17, 0, 21, 18, 6, 23, 26, 1, 0, 10, 7, 11, 15, 19, 10, 19, 16, 4, 8, 23, 21, 21, 0, 10, 4, 5]"
103,2,9,3,2532,0,7,2,"[0, 0, 0, 0, 0, 0, 0, 0, 0, 0, 0, 0, 0, 0, 0, 0, 0, 0, 0, 0, 0, 0, 0, 0, 0, 0, 0]"
104,2,64,21,2575,0,4,60,"[6, 12, 0, 17, 15, 0, 10, 6, 6, 19, 12, 12, 13, 20, 4, 1, 6, 3, 18, 9, 2, 3, 3, 11, 1, 18, 20]"
105,2,18,11,2582,0,6,12,"[3, 1, 0, 0, 0, 4, 0, 2, 1, 4, 0, 2, 2, 2, 3, 2, 1, 4, 4, 0, 2, 4, 1, 3, 4, 1, 3]"
106,2,42,30,2594,0,6,36,"[2, 11, 0, 7, 9, 11, 6, 2, 5, 9, 7, 10, 0, 7, 10, 0, 0, 8, 1, 4, 8, 7, 3, 12, 11, 6, 4]"
107,2,11,3,2602,0,7,4,"[1, 0, 0, 1, 1, 1, 0, 0, 1, 1, 1, 1, 1, 1, 0, 1, 1, 0, 1, 1, 1, 1, 0, 0, 1, 1, 1]"
108,2,26,19,2609,0,1,25,"[5, 2, 0, 2, 3, 6, 4, 8, 0, 6, 6, 4, 7, 6, 6, 3, 2, 8, 4, 2, 0, 1, 5, 1, 2, 0, 3]"
109,2,2,2,2609,0,2,0,"[0, 0, 0, 0, 0, 0, 0, 0, 0, 0, 0, 0, 0, 0, 0, 0, 0, 0, 0, 0, 0, 0, 0, 0, 0, 0, 0]"
110,2,11,0,2620,0,3,8,"[2, 1, 0, 2, 0, 1, 0, 2, 1, 1, 0, 0, 0, 1, 2, 1, 2, 2, 2, 0, 0, 0, 1, 2, 1, 0, 1]"
111,2,97,10,2707,0,71,26,"[2, 7, 0, 0, 4, 3, 1, 5, 3, 6, 4, 2, 8, 5, 6, 1, 4, 3, 8, 7, 8, 2, 6, 3, 8, 0, 1]"
112,2,38,0,2745,0,16,22,"[2, 2, 0, 2, 1, 0, 4, 5, 5, 0, 3, 1, 1, 2, 2, 5, 2, 0, 1, 6, 4, 2, 3, 0, 5, 5, 1]"
113,2,94,18,2821,0,37,57,"[0, 2, 0, 14, 9, 9, 0, 3, 9, 6, 19, 12, 12, 15, 11, 9, 9, 11, 5, 7, 2, 1, 17, 16, 17, 6, 13]"
114,2,69,14,2876,0,39,30,"[9, 1, 0, 5, 9, 7, 0, 8, 7, 1, 1, 3, 8, 3, 7, 2, 0, 0, 7, 0, 0, 4, 4, 2, 10, 5, 5]"
115,2,77,56,2897,0,24,53,"[7, 4, 0, 13, 2, 15, 11, 1, 17, 15, 13, 10, 3, 14, 1, 9, 12, 3, 8, 10, 8, 13, 15, 2, 14, 4, 1]"
116,2,42,14,2925,0,18,24,"[4, 0, 0, 4, 7, 0, 8, 2, 6, 7, 4, 1, 0, 7, 6, 2, 0, 7, 5, 7, 1, 5, 6, 3, 0, 5, 8]"
117,2,3,3,2925,0,3,0,"[0, 0, 0, 0, 0, 0, 0, 0, 0, 0, 0, 0, 0, 0, 0, 0, 0, 0, 0, 0, 0, 0, 0, 0, 0, 0, 0]"
118,2,81,19,2987,0,34,47,"[7, 0, 0, 15, 9, 3, 8, 3, 14, 8, 0, 5, 1, 9, 14, 14, 0, 0, 9, 2, 6, 5, 7, 13, 2, 8, 7]"
119,2,86,69,3004,0,85,1,"[0, 0, 0, 0, 0, 0, 0, 0, 0, 0, 0, 0, 0, 0, 0, 0, 0, 0, 0, 0, 0, 0, 0, 0, 0, 0, 0]"
120,2,80,35,3049,0,45,35,"[10, 11, 0, 11, 10, 4, 4, 5, 11, 11, 11, 4, 11, 3, 8, 6, 8, 4, 7, 6, 8, 10, 5, 11, 3, 5, 11]"
121,2,84,62,3071,0,80,4,"[0, 1, 0, 0, 1, 0, 0, 1, 1, 0, 1, 0, 0, 0, 1, 0, 1, 0, 1, 0, 1, 1, 0, 1, 1, 0, 1]"
122,2,24,5,3090,0,5,19,"[6, 4, 0, 3, 5, 0, 4, 4, 2, 4, 4, 2, 1, 1, 5, 4, 3, 0, 5, 3, 5, 3, 5, 1, 1, 5, 2]"
123,2,3,0,3093,0,2,1,"[0, 0, 0, 0, 0, 0, 0, 0, 0, 0, 0, 0, 0, 0, 0, 0, 0, 0, 0, 0, 0, 0, 0, 0, 0, 0, 0]"
124,2,9,9,3093,0,8,1,"[0, 0, 0, 0, 0, 0, 0, 0, 0, 0, 0, 0, 0, 0, 0, 0, 0, 0, 0, 0, 0, 0, 0, 0, 0, 0, 0]"
125,2,41,36,3098,0,28,13,"[0, 0, 0, 2, 1, 1, 2, 0, 4, 3, 1, 4, 2, 1, 4, 3, 0, 3, 4, 2, 2, 2, 4, 2, 0, 3, 2]"
126,2,31,25,3104,0,5,26,"[0, 3, 0, 1, 6, 7, 3, 3, 7, 7, 2, 4, 7, 6, 1, 5, 0, 2, 1, 3, 6, 0, 6, 1, 1, 2, 6]"
127,2,33,11,3126,0,25,8,"[2, 0, 0, 1, 2, 0, 2, 1, 2, 0, 2, 1, 0, 0, 1, 0, 1, 2, 1, 0, 0, 0, 0, 0, 2, 0, 2]"
128,2,1,0,3105,0,0,1,"[0, 0, 0, 0, 0, 0, 0, 0, 0, 0, 0, 0, 0, 0, 0, 0, 0, 0, 0, 0, 0, 0, 0, 0, 0, 0, 0]"
129,2,13,6,3112,0,9,4,"[0, 1, 0, 1, 0, 1, 0, 1, 1, 0, 0, 0, 1, 0, 0, 1, 0, 0, 0, 0, 1, 1, 1, 1, 1, 1, 0]"
130,2,86,22,3176,0,33,53,"[13, 4, 0, 6, 16, 13, 9, 17, 2, 0, 5, 15, 5, 12, 1, 10, 11, 17, 6, 14, 0, 1, 10, 15, 3, 2, 11]"
131,2,78,72,3182,0,14,64,"[4, 4, 0, 16, 2, 18, 4, 4, 17, 1, 9, 6, 15, 16, 8, 17, 3, 3, 5, 21, 14, 18, 1, 9, 21, 6, 14]"
132,2,15,11,3186,0,2,13,"[4, 1, 0, 3, 0, 3, 0, 3, 3, 0, 4, 3, 1, 1, 0, 3, 4, 1, 0, 3, 2, 4, 4, 0, 1, 3, 0]"
133,2,50,47,3189,0,6,44,"[1, 11, 0, 6, 14, 9, 11, 5, 6, 5, 7, 7, 13, 0, 5, 2, 8, 9, 12, 2, 5, 0, 12, 2, 9, 2, 7]"
134,2,67,40,3216,0,15,52,"[12, 2, 0, 1, 12, 3, 15, 17, 0, 6, 11, 9, 6, 7, 17, 1, 14, 0, 6, 10, 10, 16, 3, 4, 17, 15, 6]"
135,2,92,13,3295,0,92,0,"[0, 0, 0, 0, 0, 0, 0, 0, 0, 0, 0, 0, 0, 0, 0, 0, 0, 0, 0, 0, 0, 0, 0, 0, 0, 0, 0]"
136,2,21,19,3297,0,12,9,"[3, 1, 0, 1, 0, 2, 1, 0, 1, 1, 2, 1, 1, 3, 0, 0, 1, 3, 0, 0, 2, 2, 0, 1, 0, 1, 2]"
137,2,17,6,3308,0,3,14,"[2, 4, 0, 3, 2, 0, 3, 3, 3, 0, 0, 3, 4, 1, 4, 4, 1, 2, 3, 3, 1, 2, 0, 0, 1, 1, 3]"
138,2,44,34,3318,0,31,13,"[1, 1, 0, 3, 0, 2, 0, 4, 4, 3, 3, 0, 4, 2, 1, 3, 2, 0, 4, 2, 3, 1, 1, 0, 1, 4, 3]"
139,2,71,0,3389,0,31,40,"[9, 11, 0, 1, 8, 10, 4, 6, 5, 8, 5, 2, 8, 4, 3, 12, 4, 4, 7, 11, 9, 6, 5, 12, 10, 9, 5]"
140,2,18,3,3404,0,18,0,"[0, 0, 0, 0, 0, 0, 0, 0, 0, 0, 0, 0, 0, 0, 0, 0, 0, 0, 0, 0, 0, 0, 0, 0, 0, 0, 0]"
141,2,8,1,3411,0,2,6,"[2, 0, 0, 0, 1, 1, 0, 0, 1, 2, 0, 0, 0, 2, 1, 0, 0, 0, 0, 2, 2, 0, 2, 2, 1, 1, 2]"
142,2,26,11,3426,0,25,1,"[0, 0, 0, 0, 0, 0, 0, 0, 0, 0, 0, 0, 0, 0, 0, 0, 0, 0, 0, 0, 0, 0, 0, 0, 0, 0, 0]"
143,2,50,9,3467,0,29,21,"[4, 6, 0, 3, 2, 4, 5, 4, 3, 4, 6, 2, 3, 0, 5, 0, 7, 5, 1, 6, 5, 4, 0, 2, 1, 0, 6]"
144,2,62,27,3502,0,14,48,"[12, 16, 0, 3, 16, 5, 16, 8, 10, 5, 9, 6, 7, 11, 5, 12, 4, 13, 14, 3, 3, 0, 12, 13, 12, 14, 11]"
145,2,38,29,3511,0,34,4,"[0, 1, 0, 0, 0, 0, 0, 0, 0, 1, 1, 0, 1, 1, 0, 1, 0, 0, 0, 1, 0, 1, 0, 0, 1, 1, 1]"
146,2,90,81,3520,0,68,22,"[5, 3, 0, 7, 7, 0, 4, 5, 0, 2, 2, 5, 2, 2, 0, 2, 4, 0, 2, 3, 4, 7, 1, 0, 3, 5, 2]"
147,2,59,42,3537,0,57,2,"[0, 0, 0, 0, 0, 0, 0, 0, 0, 0, 0, 0, 0, 0, 0, 0, 0, 0, 0, 0, 0, 0, 0, 0, 0, 0, 0]"
148,2,90,86,3541,0,40,50,"[12, 9, 0, 16, 14, 5, 7, 10, 1, 4, 13, 2, 8, 7, 10, 9, 5, 9, 0, 8, 15, 16, 14, 12, 10, 13, 5]"
149,2,22,14,3549,0,4,18,"[5, 5, 0, 4, 5, 0, 3, 0, 5, 1, 3, 4, 5, 3, 1, 0, 2, 0, 2, 2, 4, 2, 2, 6, 2, 0, 2]"
150,2,46,16,3579,0,33,13,"[2, 4, 0, 4, 4, 0, 3, 4, 3, 1, 2, 4, 4, 4, 4, 3, 1, 4, 3, 0, 2, 3, 3, 2, 2, 0, 4]"
151,2,24,23,3580,0,5,19,"[6, 0, 0, 2, 3, 5, 4, 2, 2, 6, 4, 5, 5, 0, 4, 0, 1, 3, 0, 3, 4, 4, 0, 4, 0, 2, 1]"
152,2,6,2,3584,0,6,0,"[0, 0, 0, 0, 0, 0, 0, 0, 0, 0, 0, 0, 0, 0, 0, 0, 0, 0, 0, 0, 0, 0, 0, 0, 0, 0, 0]"
153,2,75,48,3611,0,52,23,"[5, 6, 0, 2, 4, 1, 1, 7, 4, 5, 6, 1, 1, 2, 0, 2, 3, 0, 3, 2, 1, 3, 7, 0, 0, 5, 4]"
154,2,94,94,3611,0,73,21,"[1, 2, 0, 1, 1, 1, 6, 6, 6, 5, 4, 7, 7, 0, 6, 7, 4, 0, 4, 6, 2, 7, 2, 1, 5, 0, 6]"
155,2,50,49,3612,0,4,46,"[5, 2, 0, 14, 10, 14, 4, 14, 0, 14, 2, 4, 10, 1, 11, 2, 15, 3, 5, 5, 12, 1, 5, 7, 9, 15, 11]"
156,2,59,8,3663,0,33,26,"[8, 1, 0, 4, 1, 7, 0, 8, 2, 4, 8, 6, 5, 4, 0, 6, 0, 4, 8, 3, 2, 0, 6, 6, 1, 6, 1]"
157,2,19,7,3675,0,4,15,"[1, 1, 0, 0, 1, 4, 5, 3, 3, 0, 5, 3, 3, 3, 5, 4, 3, 4, 5, 4, 5, 4, 1, 1, 0, 4, 2]"
158,2,3,1,3677,0,0,3,"[1, 1, 0, 0, 0, 1, 0, 1, 1, 1, 1, 0, 0, 0, 0, 0, 1, 1, 1, 0, 1, 1, 1, 0, 0, 1, 0]"
159,2,74,43,3708,0,3,71,"[23, 5, 0, 8, 3, 19, 15, 2, 14, 16, 2, 23, 11, 15, 14, 8, 9, 13, 9, 17, 22, 15, 1, 7, 0, 20, 8]"
160,2,84,72,3720,0,15,69,"[16, 6, 0, 23, 23, 9, 22, 11, 19, 20, 10, 20, 9, 21, 13, 16, 15, 22, 21, 2, 1, 4, 10, 8, 7, 3, 6]"
161,2,88,7,3801,0,76,12,"[0, 4, 0, 1, 2, 2, 2, 4, 4, 4, 0, 3, 0, 2, 4, 2, 2, 2, 1, 2, 4, 3, 1, 3, 1, 3, 1]"
162,2,68,29,3840,0,66,2,"[0, 0, 0, 0, 0, 0, 0, 0, 0, 0, 0, 0, 0, 0, 0, 0, 0, 0, 0, 0, 0, 0, 0, 0, 0, 0, 0]"
163,2,21,19,3842,0,21,0,"[0, 0, 0, 0, 0, 0, 0, 0, 0, 0, 0, 0, 0, 0, 0, 0, 0, 0, 0, 0, 0, 0, 0, 0, 0, 0, 0]"
164,2,71,1,3912,0,46,25,"[2, 4, 0, 0, 1, 4, 3, 3, 4, 8, 4, 4, 5, 0, 4, 2, 3, 0, 8, 4, 0, 7, 8, 1, 5, 0, 3]"
165,2,60,19,3953,0,54,6,"[0, 1, 0, 1, 2, 0, 1, 1, 0, 1, 2, 0, 2, 0, 0, 2, 0, 0, 1, 1, 2, 2, 0, 2, 0, 0, 0]"
166,2,10,9,3954,0,2,8,"[2, 1, 0, 1, 1, 2, 1, 2, 1, 0, 2, 1, 2, 1, 1, 2, 2, 1, 0, 0, 2, 0, 1, 2, 0, 0, 2]"
167,2,57,4,4007,0,49,8,"[0, 2, 0, 0, 1, 2, 0, 1, 1, 0, 1, 0, 0, 1, 0, 0, 1, 2, 2, 1, 0, 0, 2, 0, 1, 1, 0]"
168,2,66,1,4072,0,18,48,"[11, 11, 0, 15, 9, 5, 4, 11, 10, 3, 6, 1, 15, 14, 11, 6, 3, 10, 10, 11, 5, 9, 16, 14, 4, 15, 4]"
169,2,86,24,4134,0,82,4,"[0, 0, 0, 0, 0, 0, 1, 0, 1, 0, 0, 1, 1, 0, 0, 1, 1, 1, 0, 1, 0, 1, 0, 0, 0, 0, 0]"
170,2,96,11,4219,0,22,74,"[4, 6, 0, 3, 4, 23, 16, 10, 1, 18, 14, 3, 2, 6, 7, 21, 15, 8, 4, 4, 20, 4, 4, 23, 21, 20, 19]"
171,2,60,48,4231,0,22,38,"[2, 4, 0, 11, 5, 4, 11, 4, 2, 12, 6, 1, 8, 2, 12, 2, 4, 12, 5, 10, 12, 5, 8, 9, 8, 9, 6]"
172,2,85,34,4282,0,85,0,"[0, 0, 0, 0, 0, 0, 0, 0, 0, 0, 0, 0, 0, 0, 0, 0, 0, 0, 0, 0, 0, 0, 0, 0, 0, 0, 0]"
173,2,60,27,4315,0,0,60,"[6, 17, 0, 1, 11, 10, 6, 18, 19, 8, 9, 12, 12, 3, 11, 2, 10, 10, 12, 20, 4, 10, 10, 14, 2, 0, 9]"
174,2,61,43,4333,0,12,49,"[14, 13, 0, 2, 8, 10, 6, 3, 1, 1, 10, 14, 5, 6, 11, 13, 1, 1, 5, 12, 7, 0, 5, 2, 5, 6, 6]"
175,2,41,23,4351,0,26,15,"[0, 0, 0, 2, 4, 5, 5, 4, 3, 2, 4, 4, 2, 0, 3, 3, 3, 2, 1, 4, 3, 2, 5, 3, 2, 1, 5]"
176,2,33,14,4370,0,26,7,"[0, 2, 0, 2, 2, 1, 0, 0, 2, 0, 1, 0, 2, 0, 1, 0, 2, 0, 1, 0, 0, 0, 0, 2, 1, 2, 0]"
177,2,82,50,4402,0,13,69,"[20, 5, 0, 14, 8, 14, 5, 23, 15, 3, 16, 3, 4, 13, 21, 16, 14, 7, 5, 6, 10, 2, 22, 13, 3, 17, 16]"
178,2,69,7,4464,0,11,58,"[16, 7, 0, 3, 17, 5, 19, 2, 17, 9, 6, 16, 6, 2, 6, 16, 1, 18, 13, 19, 2, 12, 4, 14, 16, 10, 14]"
179,2,94,33,4525,0,45,49,"[6, 4, 0, 11, 8, 4, 8, 15, 4, 0, 5, 4, 9, 6, 9, 9, 6, 12, 8, 0, 7, 11, 11, 8, 7, 6, 15]"
180,2,1,0,4465,0,0,1,"[0, 0, 0, 0, 0, 0, 0, 0, 0, 0, 0, 0, 0, 0, 0, 0, 0, 0, 0, 0, 0, 0, 0, 0, 0, 0, 0]"
181,2,23,7,4481,0,19,4,"[1, 0, 0, 1, 1, 1, 0, 1, 0, 0, 0, 0, 0, 1, 1, 0, 0, 0, 0, 1, 0, 1, 0, 1, 1, 1, 1]"
182,2,1,0,4466,0,1,0,"[0, 0, 0, 0, 0, 0, 0, 0, 0, 0, 0, 0, 0, 0, 0, 0, 0, 0, 0, 0, 0, 0, 0, 0, 0, 0, 0]"
183,2,85,51,4500,0,75,10,"[2, 1, 0, 0, 1, 2, 0, 1, 2, 3, 3, 2, 1, 1, 1, 3, 2, 1, 0, 1, 0, 1, 2, 3, 3, 1, 0]"
184,2,28,16,4512,0,3,25,"[0, 2, 0, 1, 5, 4, 8, 8, 3, 7, 4, 5, 3, 2, 5, 3, 3, 3, 0, 8, 1, 2, 4, 0, 3, 6, 7]"
185,2,57,35,4534,0,33,24,"[3, 4, 0, 0, 0, 3, 1, 8, 2, 7, 2, 3, 6, 8, 5, 3, 4, 2, 6, 3, 6, 6, 4, 0, 5, 3, 5]"
186,2,71,29,4576,0,58,13,"[2, 1, 0, 3, 0, 1, 4, 4, 3, 0, 0, 3, 1, 1, 0, 4, 2, 1, 4, 0, 2, 0, 1, 2, 4, 1, 1]"
187,2,1,0,4535,0,1,0,"[0, 0, 0, 0, 0, 0, 0, 0, 0, 0, 0, 0, 0, 0, 0, 0, 0, 0, 0, 0, 0, 0, 0, 0, 0, 0, 0]"
188,2,63,5,4593,0,36,27,"[2, 4, 0, 6, 4, 5, 3, 1, 6, 8, 3, 7, 0, 6, 1, 7, 0, 6, 2, 3, 3, 1, 9, 6, 6, 9, 8]"
189,2,12,3,4602,0,10,2,"[0, 0, 0, 0, 0, 0, 0, 0, 0, 0, 0, 0, 0, 0, 0, 0, 0, 0, 0, 0, 0, 0, 0, 0, 0, 0, 0]"
190,2,20,13,4609,0,12,8,"[0, 2, 0, 2, 0, 0, 0, 2, 2, 0, 1, 0, 2, 2, 2, 0, 1, 2, 1, 1, 1, 2, 0, 1, 2, 1, 2]"
191,2,71,12,4668,0,57,14,"[3, 4, 0, 2, 0, 4, 1, 2, 4, 0, 2, 1, 1, 4, 1, 3, 0, 3, 3, 4, 0, 4, 3, 2, 3, 2, 3]"
192,2,8,2,4674,0,4,4,"[1, 1, 0, 0, 1, 0, 0, 0, 1, 0, 0, 1, 0, 1, 0, 1, 1, 0, 1, 1, 0, 0, 1, 1, 0, 1, 1]"
193,2,67,13,4728,0,26,41,"[6, 2, 0, 10, 4, 5, 10, 2, 7, 4, 4, 6, 5, 3, 11, 0, 13, 8, 9, 7, 7, 5, 3, 5, 7, 7, 12]"
194,2,56,53,4731,0,46,10,"[0, 3, 0, 0, 3, 2, 1, 3, 0, 1, 3, 1, 0, 1, 2, 3, 3, 1, 3, 0, 3, 3, 0, 3, 3, 1, 3]"
195,2,80,43,4768,0,35,45,"[13, 3, 0, 4, 8, 4, 6, 10, 10, 6, 10, 8, 8, 0, 10, 8, 13, 0, 10, 11, 10, 9, 14, 12, 13, 8, 0]"
196,2,58,45,4781,0,46,12,"[4, 0, 0, 0, 2, 2, 0, 3, 0, 4, 1, 0, 2, 1, 2, 3, 2, 4, 3, 4, 0, 1, 3, 3, 2, 3, 2]"
197,2,2,1,4782,0,0,2,"[0, 0, 0, 0, 0, 0, 0, 0, 0, 0, 0, 0, 0, 0, 0, 0, 0, 0, 0, 0, 0, 0, 0, 0, 0, 0, 0]"
198,2,18,14,4786,0,11,7,"[1, 1, 0, 1, 1, 0, 2, 0, 1, 0, 1, 2, 1, 1, 0, 2, 0, 2, 2, 2, 2, 2, 2, 2, 2, 1, 0]"
199,2,80,39,4827,0,44,36,"[3, 7, 0, 6, 4, 7, 3, 4, 1, 9, 6, 5, 9, 5, 8, 8, 12, 11, 8, 2, 10, 7, 4, 9, 11, 8, 6]"
200,2,48,4,4871,0,25,23,"[4, 2, 0, 7, 1, 1, 3, 0, 7, 6, 3, 3, 2, 4, 2, 3, 1, 0, 2, 1, 1, 3, 3, 0, 6, 2, 1]"
201,2,51,38,4884,0,50,1,"[0, 0, 0, 0, 0, 0, 0, 0, 0, 0, 0, 0, 0, 0, 0, 0, 0, 0, 0, 0, 0, 0, 0, 0, 0, 0, 0]"
202,2,34,12,4906,0,26,8,"[1, 1, 0, 0, 2, 1, 0, 1, 0, 0, 2, 0, 1, 2, 2, 0, 1, 0, 2, 2, 2, 1, 2, 2, 1, 2, 0]"
203,2,91,81,4916,0,48,43,"[8, 10, 0, 9, 3, 11, 11, 7, 2, 4, 11, 3, 0, 3, 1, 9, 5, 14, 8, 7, 4, 10, 4, 4, 7, 6, 0]"
204,2,70,18,4968,0,56,14,"[2, 0, 0, 4, 0, 0, 3, 2, 0, 4, 3, 4, 3, 0, 0, 0, 3, 0, 3, 0, 1, 1, 0, 3, 4, 1, 1]"
205,2,65,17,5016,0,20,45,"[8, 12, 0, 3, 12, 1, 13, 8, 10, 5, 7, 0, 0, 10, 15, 9, 14, 6, 2, 9, 3, 8, 6, 2, 5, 5, 14]"
206,2,75,24,5067,0,33,42,"[4, 9, 0, 13, 4, 9, 8, 0, 13, 4, 5, 13, 0, 8, 0, 8, 0, 5, 13, 14, 6, 4, 1, 2, 12, 5, 4]"
207,2,68,36,5099,0,3,65,"[11, 20, 0, 6, 17, 14, 19, 19, 14, 4, 11, 20, 0, 9, 5, 3, 19, 19, 9, 10, 21, 3, 5, 12, 17, 13, 7]"
208,2,20,1,5118,0,5,15,"[2, 0, 0, 5, 2, 3, 2, 2, 3, 5, 1, 3, 4, 0, 3, 3, 0, 1, 4, 1, 2, 3, 4, 1, 0, 1, 1]"
209,2,38,37,5119,0,36,2,"[0, 0, 0, 0, 0, 0, 0, 0, 0, 0, 0, 0, 0, 0, 0, 0, 0, 0, 0, 0, 0, 0, 0, 0, 0, 0, 0]"
210,2,89,74,5134,0,31,58,"[14, 12, 0, 14, 12, 2, 13, 4, 10, 17, 5, 0, 13, 1, 13, 6, 7, 2, 9, 17, 10, 13, 0, 0, 4, 13, 18]"
211,2,47,11,5170,0,0,47,"[10, 4, 0, 5, 11, 8, 5, 12, 15, 2, 0, 7, 15, 13, 14, 2, 10, 8, 14, 2, 3, 9, 5, 0, 0, 13, 14]"
212,2,87,28,5229,0,76,11,"[3, 0, 0, 1, 3, 1, 3, 2, 2, 2, 0, 0, 2, 0, 1, 3, 2, 1, 1, 0, 0, 0, 3, 1, 3, 3, 0]"
213,2,90,19,5300,0,44,46,"[9, 9, 0, 11, 10, 1, 14, 1, 11, 13, 3, 0, 6, 6, 12, 5, 7, 2, 7, 12, 2, 14, 1, 14, 5, 3, 0]"
214,2,70,43,5327,0,64,6,"[1, 2, 0, 0, 1, 0, 1, 1, 1, 1, 1, 1, 1, 0, 1, 0, 1, 1, 1, 1, 0, 2, 0, 0, 1, 0, 2]"
215,2,88,5,5410,0,20,68,"[4, 17, 0, 14, 1, 2, 21, 16, 16, 9, 22, 15, 3, 10, 21, 22, 6, 2, 22, 20, 8, 18, 11, 22, 17, 19, 10]"
216,2,99,93,5416,0,4,95,"[20, 20, 0, 24, 2, 2, 26, 16, 29, 27, 29, 11, 25, 28, 27, 1, 17, 26, 2, 4, 22, 30, 7, 17, 21, 5, 13]"
217,2,60,35,5441,0,41,19,"[5, 3, 0, 2, 5, 5, 6, 4, 2, 6, 4, 3, 3, 0, 4, 0, 6, 6, 2, 1, 6, 5, 6, 0, 1, 5, 3]"
218,2,60,45,5456,0,38,22,"[1, 4, 0, 3, 4, 2, 7, 4, 2, 3, 5, 1, 1, 6, 6, 7, 4, 0, 6, 5, 2, 3, 1, 6, 7, 2, 1]"
219,2,18,6,5468,0,7,11,"[3, 3, 0, 1, 2, 2, 3, 1, 2, 3, 2, 2, 0, 3, 0, 0, 3, 0, 0, 1, 1, 2, 2, 1, 1, 1, 2]"
220,2,80,19,5529,0,32,48,"[3, 5, 0, 15, 7, 10, 16, 12, 2, 14, 10, 9, 3, 15, 11, 15, 11, 14, 1, 7, 15, 12, 0, 9, 14, 9, 16]"
221,2,27,2,5554,0,14,13,"[1, 1, 0, 4, 2, 2, 3, 2, 3, 4, 2, 2, 4, 2, 2, 2, 0, 2, 4, 1, 2, 1, 3, 1, 0, 3, 4]"
222,2,89,24,5619,0,31,58,"[3, 4, 0, 1, 15, 11, 6, 16, 17, 2, 14, 2, 2, 2, 18, 17, 10, 19, 7, 9, 2, 17, 12, 10, 6, 11, 10]"
223,2,90,44,5665,0,76,14,"[2, 0, 0, 3, 1, 1, 3, 1, 1, 0, 1, 3, 1, 1, 4, 0, 2, 1, 1, 1, 3, 3, 3, 3, 0, 0, 3]"
224,2,81,37,5709,0,13,68,"[10, 17, 0, 19, 11, 4, 16, 2, 15, 11, 16, 9, 14, 22, 15, 7, 15, 2, 14, 6, 14, 4, 7, 21, 1, 0, 7]"
225,2,2,0,5711,0,2,0,"[0, 0, 0, 0, 0, 0, 0, 0, 0, 0, 0, 0, 0, 0, 0, 0, 0, 0, 0, 0, 0, 0, 0, 0, 0, 0, 0]"
226,2,94,54,5751,0,33,61,"[9, 7, 0, 2, 19, 20, 18, 16, 10, 3, 5, 6, 3, 16, 2, 19, 17, 1, 11, 1, 10, 13, 17, 0, 5, 2, 4]"
227,2,80,45,5786,0,22,58,"[14, 7, 0, 2, 7, 7, 13, 1, 6, 5, 0, 7, 9, 17, 11, 1, 15, 3, 19, 15, 17, 1, 9, 7, 4, 16, 11]"
228,2,56,27,5815,0,22,34,"[1, 2, 0, 5, 1, 5, 10, 1, 8, 10, 1, 4, 0, 2, 5, 8, 11, 7, 10, 3, 10, 11, 3, 9, 1, 8, 9]"
229,2,25,8,5832,0,1,24,"[4, 5, 0, 4, 0, 6, 6, 5, 7, 6, 5, 6, 2, 5, 3, 5, 7, 4, 2, 7, 4, 8, 2, 8, 7, 2, 6]"
230,2,37,34,5835,0,25,12,"[1, 2, 0, 3, 3, 2, 4, 1, 0, 0, 1, 3, 3, 1, 4, 1, 3, 1, 2, 4, 0, 1, 1, 0, 0, 2, 4]"
231,2,3,0,5838,0,3,0,"[0, 0, 0, 0, 0, 0, 0, 0, 0, 0, 0, 0, 0, 0, 0, 0, 0, 0, 0, 0, 0, 0, 0, 0, 0, 0, 0]"
232,2,27,5,5860,0,14,13,"[1, 1, 0, 0, 4, 0, 0, 2, 0, 2, 3, 0, 2, 0, 3, 0, 3, 4, 4, 0, 4, 2, 0, 4, 1, 3, 3]"
233,2,31,9,5882,0,20,11,"[3, 1, 0, 2, 2, 0, 3, 2, 3, 0, 2, 2, 1, 3, 1, 1, 2, 2, 1, 3, 3, 3, 0, 0, 0, 0, 3]"
234,2,59,4,5937,0,7,52,"[15, 6, 0, 3, 7, 2, 16, 13, 15, 3, 5, 2, 15, 1, 17, 9, 11, 2, 3, 9, 11, 3, 1, 14, 9, 9, 12]"
235,2,41,10,5968,0,40,1,"[0, 0, 0, 0, 0, 0, 0, 0, 0, 0, 0, 0, 0, 0, 0, 0, 0, 0, 0, 0, 0, 0, 0, 0, 0, 0, 0]"
236,2,24,19,5973,0,9,15,"[1, 2, 0, 2, 2, 2, 0, 0, 3, 2, 2, 1, 5, 2, 5, 2, 5, 4, 2, 3, 2, 5, 4, 4, 1, 3, 5]"
237,2,24,18,5979,0,9,15,"[0, 5, 0, 2, 0, 5, 2, 0, 3, 1, 5, 3, 5, 2, 4, 4, 5, 3, 1, 4, 1, 1, 3, 5, 0, 5, 0]"
238,2,38,37,5980,0,38,0,"[0, 0, 0, 0, 0, 0, 0, 0, 0, 0, 0, 0, 0, 0, 0, 0, 0, 0, 0, 0, 0, 0, 0, 0, 0, 0, 0]"
239,2,45,38,5987,0,20,25,"[0, 5, 0, 7, 1, 2, 1, 1, 7, 0, 0, 0, 5, 8, 2, 6, 5, 8, 5, 1, 7, 6, 2, 7, 1, 0, 8]"
240,2,24,21,5990,0,20,4,"[1, 1, 0, 0, 0, 1, 1, 1, 1, 1, 1, 1, 1, 1, 0, 1, 0, 0, 0, 1, 0, 0, 1, 0, 1, 1, 0]"
241,2,54,29,6015,0,12,42,"[8, 12, 0, 13, 3, 1, 7, 12, 14, 0, 1, 2, 1, 11, 4, 2, 5, 11, 1, 3, 1, 3, 7, 13, 3, 8, 14]"
242,2,60,26,6049,0,44,16,"[2, 2, 0, 3, 0, 4, 1, 2, 1, 3, 4, 3, 0, 2, 4, 3, 3, 1, 2, 0, 4, 2, 3, 1, 3, 1, 3]"
243,2,48,1,6096,0,37,11,"[2, 1, 0, 2, 0, 1, 1, 3, 1, 0, 2, 0, 2, 2, 2, 1, 0, 3, 3, 1, 1, 2, 0, 0, 3, 1, 0]"
244,2,41,38,6099,0,26,15,"[3, 3, 0, 1, 0, 5, 1, 1, 5, 3, 4, 0, 4, 3, 2, 4, 2, 1, 3, 2, 3, 5, 0, 1, 1, 5, 2]"
245,2,46,6,6139,0,18,28,"[5, 4, 0, 8, 1, 4, 3, 4, 5, 6, 5, 6, 1, 4, 3, 1, 6, 0, 4, 6, 4, 6, 2, 0, 2, 4, 0]"
246,2,26,6,6159,0,10,16,"[5, 3, 0, 0, 2, 5, 2, 5, 3, 1, 5, 2, 1, 2, 2, 0, 1, 4, 2, 3, 5, 1, 5, 2, 5, 4, 1]"
247,2,68,1,6226,0,56,12,"[0, 1, 0, 4, 2, 4, 2, 1, 0, 1, 1, 0, 1, 2, 4, 4, 2, 2, 3, 3, 1, 1, 3, 1, 4, 4, 4]"
248,2,1,0,6160,0,1,0,"[0, 0, 0, 0, 0, 0, 0, 0, 0, 0, 0, 0, 0, 0, 0, 0, 0, 0, 0, 0, 0, 0, 0, 0, 0, 0, 0]"
249,2,87,16,6231,0,72,15,"[3, 0, 0, 5, 3, 2, 1, 1, 5, 4, 4, 5, 3, 1, 3, 0, 4, 4, 2, 1, 2, 2, 0, 2, 1, 4, 1]"
250,2,90,25,6296,0,78,12,"[3, 2, 0, 3, 4, 3, 2, 3, 1, 4, 1, 1, 1, 2, 0, 2, 4, 2, 3, 0, 2, 1, 0, 2, 2, 4, 0]"
251,2,85,9,6372,0,49,36,"[0, 1, 0, 10, 6, 0, 4, 11, 10, 2, 11, 5, 9, 11, 10, 5, 7, 3, 8, 9, 11, 9, 3, 12, 6, 5, 0]"
252,2,12,8,6376,0,4,8,"[0, 2, 0, 2, 0, 0, 0, 2, 1, 1, 2, 1, 1, 1, 0, 2, 0, 0, 2, 0, 1, 1, 0, 1, 0, 2, 2]"
253,2,61,8,6429,0,28,33,"[11, 9, 0, 10, 8, 8, 9, 0, 10, 2, 9, 8, 9, 7, 9, 2, 0, 6, 2, 10, 10, 11, 9, 5, 4, 0, 11]"
254,2,9,0,6438,0,0,9,"[1, 1, 0, 0, 3, 1, 0, 1, 3, 3, 3, 3, 1, 2, 3, 3, 1, 1, 1, 1, 0, 2, 3, 2, 3, 2, 3]"
255,2,3,0,6441,0,1,2,"[0, 0, 0, 0, 0, 0, 0, 0, 0, 0, 0, 0, 0, 0, 0, 0, 0, 0, 0, 0, 0, 0, 0, 0, 0, 0, 0]"
256,2,16,3,6454,0,14,2,"[0, 0, 0, 0, 0, 0, 0, 0, 0, 0, 0, 0, 0, 0, 0, 0, 0, 0, 0, 0, 0, 0, 0, 0, 0, 0, 0]"
257,2,48,16,6486,0,6,42,"[13, 9, 0, 8, 1, 11, 8, 12, 11, 4, 12, 9, 12, 12, 5, 0, 14, 14, 12, 12, 13, 8, 0, 8, 7, 0, 11]"
258,2,79,61,6504,0,33,46,"[11, 6, 0, 14, 0, 11, 0, 15, 10, 7, 14, 6, 10, 2, 7, 12, 10, 15, 10, 13, 14, 0, 8, 11, 5, 13, 11]"
259,2,38,22,6520,0,16,22,"[5, 3, 0, 6, 4, 2, 4, 6, 6, 5, 3, 2, 3, 6, 2, 7, 5, 6, 0, 0, 3, 7, 4, 1, 4, 4, 1]"
260,2,94,54,6560,0,37,57,"[2, 12, 0, 12, 8, 5, 16, 8, 15, 9, 12, 6, 5, 6, 4, 0, 1, 8, 6, 17, 5, 18, 19, 17, 18, 10, 19]"
261,2,51,42,6569,0,7,44,"[2, 14, 0, 12, 14, 7, 13, 2, 7, 9, 7, 13, 11, 1, 3, 11, 5, 10, 0, 0, 14, 10, 11, 6, 2, 0, 9]"
262,2,64,38,6595,0,6,58,"[8, 1, 0, 4, 2, 0, 11, 18, 12, 8, 18, 1, 15, 2, 5, 5, 7, 8, 13, 13, 2, 5, 12, 5, 12, 8, 2]"
263,2,8,5,6598,0,2,6,"[0, 0, 0, 0, 0, 0, 1, 2, 0, 0, 2, 0, 1, 0, 2, 0, 1, 2, 2, 2, 1, 1, 0, 0, 1, 1, 1]"
264,2,36,29,6605,0,21,15,"[2, 3, 0, 5, 5, 3, 0, 0, 4, 0, 3, 5, 2, 0, 1, 1, 1, 2, 1, 1, 0, 0, 4, 4, 4, 1, 2]"
265,2,59,28,6636,0,45,14,"[2, 0, 0, 3, 1, 3, 0, 1, 0, 4, 2, 0, 1, 1, 3, 0, 3, 3, 2, 1, 3, 4, 3, 0, 3, 2, 3]"
266,2,18,3,6651,0,18,0,"[0, 0, 0, 0, 0, 0, 0, 0, 0, 0, 0, 0, 0, 0, 0, 0, 0, 0, 0, 0, 0, 0, 0, 0, 0, 0, 0]"
267,2,2,0,6653,0,2,0,"[0, 0, 0, 0, 0, 0, 0, 0, 0, 0, 0, 0, 0, 0, 0, 0, 0, 0, 0, 0, 0, 0, 0, 0, 0, 0, 0]"
268,2,82,72,6663,0,9,73,"[12, 15, 0, 19, 3, 6, 10, 1, 5, 22, 15, 12, 1, 6, 15, 7, 6, 13, 18, 10, 22, 14, 20, 18, 8, 18, 13]"
269,2,55,35,6683,0,51,4,"[1, 1, 0, 1, 0, 0, 0, 0, 1, 0, 0, 0, 1, 0, 0, 0, 0, 1, 1, 0, 0, 0, 1, 0, 1, 0, 0]"
270,2,71,42,6712,0,68,3,"[1, 1, 0, 0, 1, 0, 0, 0, 0, 0, 0, 1, 1, 1, 0, 1, 0, 1, 1, 1, 0, 0, 0, 1, 1, 0, 1]"
271,2,4,3,6713,0,4,0,"[0, 0, 0, 0, 0, 0, 0, 0, 0, 0, 0, 0, 0, 0, 0, 0, 0, 0, 0, 0, 0, 0, 0, 0, 0, 0, 0]"
272,2,98,32,6779,0,6,92,"[17, 4, 0, 14, 8, 3, 10, 27, 15, 26, 24, 11, 26, 28, 8, 21, 13, 3, 18, 25, 17, 24, 30, 9, 0, 1, 21]"
273,2,13,7,6785,0,1,12,"[2, 1, 0, 2, 0, 2, 0, 1, 3, 4, 3, 0, 1, 2, 4, 0, 3, 2, 1, 1, 2, 4, 2, 4, 2, 0, 2]"
274,2,91,38,6838,0,89,2,"[0, 0, 0, 0, 0, 0, 0, 0, 0, 0, 0, 0, 0, 0, 0, 0, 0, 0, 0, 0, 0, 0, 0, 0, 0, 0, 0]"
275,2,64,45,6857,0,52,12,"[0, 4, 0, 2, 1, 2, 4, 4, 4, 1, 0, 1, 3, 2, 4, 4, 2, 1, 2, 1, 3, 0, 4, 0, 1, 1, 2]"
276,2,76,64,6869,0,50,26,"[8, 7, 0, 1, 0, 3, 7, 0, 8, 6, 2, 1, 1, 5, 2, 1, 4, 6, 1, 2, 4, 2, 4, 5, 2, 8, 8]"
277,2,11,0,6880,0,8,3,"[0, 1, 0, 0, 0, 1, 1, 0, 0, 1, 1, 1, 0, 0, 1, 1, 0, 1, 1, 0, 1, 0, 1, 0, 1, 1, 1]"
278,2,62,60,6882,0,39,23,"[5, 1, 0, 2, 3, 1, 0, 7, 1, 6, 2, 0, 5, 3, 7, 7, 6, 7, 2, 6, 0, 4, 4, 4, 1, 0, 5]"
279,2,7,6,6883,0,7,0,"[0, 0, 0, 0, 0, 0, 0, 0, 0, 0, 0, 0, 0, 0, 0, 0, 0, 0, 0, 0, 0, 0, 0, 0, 0, 0, 0]"
280,2,49,34,6898,0,33,16,"[0, 2, 0, 3, 3, 0, 5, 5, 5, 0, 4, 1, 1, 0, 5, 0, 1, 5, 1, 5, 4, 5, 4, 3, 0, 1, 4]"
281,2,16,15,6899,0,13,3,"[1, 1, 0, 1, 0, 1, 0, 0, 1, 1, 0, 0, 1, 0, 0, 1, 1, 1, 0, 1, 0, 0, 1, 0, 0, 0, 0]"
282,2,79,44,6934,0,38,41,"[6, 0, 0, 0, 9, 7, 10, 7, 8, 9, 7, 7, 1, 10, 9, 10, 11, 10, 11, 9, 5, 4, 10, 5, 5, 11, 12]"
283,2,43,9,6968,0,12,31,"[7, 6, 0, 2, 10, 5, 10, 3, 5, 9, 0, 10, 10, 1, 1, 9, 7, 2, 8, 7, 6, 9, 3, 7, 8, 8, 3]"
284,2,38,15,6991,0,16,22,"[0, 5, 0, 6, 7, 0, 1, 2, 2, 7, 3, 6, 4, 4, 7, 3, 2, 7, 4, 6, 0, 1, 6, 0, 6, 5, 1]"
285,2,55,0,7046,0,5,50,"[15, 15, 0, 1, 14, 15, 11, 16, 14, 11, 7, 2, 13, 5, 11, 5, 1, 7, 6, 3, 16, 6, 5, 8, 5, 12, 8]"
286,2,13,0,7059,0,6,7,"[1, 2, 0, 1, 0, 2, 1, 0, 2, 0, 2, 2, 0, 2, 0, 2, 1, 2, 2, 2, 2, 0, 2, 0, 0, 0, 2]"
287,2,72,44,7087,0,11,61,"[3, 5, 0, 13, 20, 18, 19, 5, 4, 3, 10, 20, 16, 19, 20, 20, 5, 3, 12, 7, 0, 19, 19, 11, 14, 8, 3]"
288,2,59,0,7146,0,41,18,"[2, 6, 0, 1, 0, 2, 2, 3, 6, 0, 6, 1, 4, 4, 5, 5, 0, 0, 6, 6, 1, 3, 4, 3, 2, 4, 3]"
289,2,47,20,7173,0,2,45,"[6, 8, 0, 6, 11, 12, 1, 7, 12, 0, 7, 13, 9, 9, 10, 6, 2, 14, 8, 14, 7, 10, 14, 6, 15, 8, 0]"
290,2,21,0,7194,0,12,9,"[2, 0, 0, 3, 0, 1, 0, 1, 0, 3, 2, 0, 0, 1, 2, 3, 3, 2, 0, 2, 0, 3, 0, 3, 1, 2, 2]"
291,2,98,84,7208,0,22,76,"[6, 25, 0, 25, 0, 10, 0, 19, 5, 7, 14, 14, 18, 21, 24, 8, 4, 18, 11, 0, 1, 4, 18, 20, 23, 25, 5]"
292,2,80,55,7233,0,6,74,"[18, 10, 0, 7, 9, 1, 24, 21, 18, 20, 2, 14, 9, 20, 13, 19, 15, 6, 6, 2, 15, 9, 10, 4, 20, 23, 21]"
293,2,92,36,7289,0,17,75,"[16, 7, 0, 15, 11, 5, 7, 2, 4, 17, 8, 12, 20, 9, 17, 23, 11, 20, 15, 11, 23, 2, 0, 9, 9, 18, 16]"
294,2,16,1,7304,0,16,0,"[0, 0, 0, 0, 0, 0, 0, 0, 0, 0, 0, 0, 0, 0, 0, 0, 0, 0, 0, 0, 0, 0, 0, 0, 0, 0, 0]"
295,2,23,3,7324,0,9,14,"[4, 3, 0, 3, 2, 0, 1, 2, 2, 1, 0, 1, 0, 1, 1, 3, 4, 4, 2, 3, 2, 2, 1, 4, 1, 1, 3]"
296,2,6,1,7329,0,4,2,"[0, 0, 0, 0, 0, 0, 0, 0, 0, 0, 0, 0, 0, 0, 0, 0, 0, 0, 0, 0, 0, 0, 0, 0, 0, 0, 0]"
297,2,10,2,7337,0,2,8,"[1, 2, 0, 1, 2, 1, 1, 0, 1, 2, 2, 2, 0, 0, 2, 0, 2, 1, 0, 2, 0, 0, 1, 1, 2, 1, 2]"
298,2,65,48,7354,0,44,21,"[3, 1, 0, 6, 3, 0, 6, 5, 4, 1, 6, 2, 7, 1, 3, 4, 0, 3, 0, 4, 3, 3, 6, 6, 7, 6, 1]"
299,2,25,21,7358,0,12,13,"[1, 0, 0, 4, 3, 0, 0, 3, 1, 3, 3, 2, 1, 1, 3, 4, 1, 2, 4, 4, 2, 4, 4, 3, 3, 0, 0]"
0,3,2083,0,2083,0,245,1838,"[355, 507, 86, 0, 329, 610, 311, 237, 528, 218, 550, 267, 192, 141, 511, 350, 120, 486, 32, 106, 138, 142, 332, 521, 274, 229, 403]"
1,3,1337,411,3009,0,376,961,"[242, 178, 114, 0, 277, 89, 84, 56, 173, 261, 45, 282, 57, 133, 156, 252, 170, 163, 220, 67, 156, 291, 49, 199, 284, 22, 204]"
2,3,1440,864,3585,0,3,1437,"[26, 171, 150, 0, 18, 149, 226, 422, 83, 438, 160, 217, 358, 108, 388, 6, 48, 392, 124, 289, 408, 361, 370, 58, 372, 420, 207]"
3,3,1734,1333,3986,0,859,875,"[257, 113, 105, 0, 66, 260, 276, 70, 81, 81, 159, 115, 27, 263, 69, 60, 239, 171, 184, 276, 77, 144, 54, 226, 86, 225, 242]"
4,3,1883,1488,4381,0,501,1382,"[285, 97, 379, 0, 136, 393, 301, 37, 346, 6, 182, 445, 130, 455, 87, 391, 18, 221, 417, 151, 356, 385, 262, 260, 255, 10, 105]"
5,3,1590,345,5626,0,1058,532,"[23, 91, 144, 0, 9, 90, 6, 141, 153, 28, 159, 10, 164, 21, 172, 121, 34, 124, 94, 63, 14, 118, 117, 112, 107, 87, 120]"
6,3,1662,1605,5683,0,191,1471,"[134, 425, 6, 0, 271, 319, 60, 182, 380, 221, 138, 154, 464, 103, 28, 89, 152, 226, 168, 398, 258, 444, 217, 202, 53, 85, 66]"
7,3,1399,933,6149,0,487,912,"[264, 286, 302, 0, 52, 206, 66, 135, 100, 130, 39, 109, 295, 293, 184, 198, 247, 43, 14, 234, 96, 239, 246, 248, 111, 273, 300]"
8,3,1753,933,6969,0,1475,278,"[22, 58, 80, 0, 55, 27, 42, 15, 22, 59, 79, 34, 53, 77, 59, 82, 36, 74, 7, 48, 44, 45, 9, 81, 75, 40, 86]"
9,3,2067,741,8295,0,541,1526,"[159, 39, 294, 0, 207, 273, 210, 319, 374, 370, 485, 220, 301, 407, 303, 94, 55, 80, 322, 180, 56, 490, 245, 501, 25, 222, 295]"
10,3,2107,861,9541,0,1842,265,"[12, 37, 29, 0, 41, 6, 29, 83, 88, 34, 55, 56, 29, 65, 67, 7, 19, 81, 53, 72, 10, 86, 84, 70, 31, 80, 50]"
11,3,2905,7412,5034,0,1637,1268,"[154, 330, 309, 0, 204, 119, 386, 348, 352, 318, 248, 309, 419, 2, 177, 402, 163, 369, 414, 343, 292, 39, 139, 356, 188, 409, 371]"
12,3,1602,388,6248,0,765,837,"[35, 256, 156, 0, 35, 139, 188, 170, 184, 35, 134, 1, 215, 98, 125, 213, 99, 242, 125, 233, 91, 251, 84, 192, 123, 139, 275]"
13,3,2585,1939,6894,0,2506,79,"[14, 14, 12, 0, 10, 5, 26, 9, 12, 0, 8, 6, 10, 25, 3, 17, 18, 14, 15, 10, 8, 23, 12, 7, 11, 13, 0]"
14,3,2990,2457,7427,0,2924,66,"[10, 9, 0, 0, 11, 19, 2, 15, 21, 5, 9, 3, 6, 13, 12, 7, 7, 19, 12, 11, 21, 17, 2, 5, 16, 17, 0]"
15,3,2060,290,9197,0,1435,625,"[83, 72, 176, 0, 39, 191, 191, 161, 75, 21, 202, 73, 100, 77, 170, 172, 140, 102, 114, 140, 192, 157, 132, 194, 157, 42, 5]"
16,3,1196,756,9637,0,873,323,"[31, 64, 107, 0, 47, 107, 60, 52, 105, 69, 39, 26, 106, 62, 22, 52, 26, 51, 60, 2, 96, 93, 64, 12, 69, 50, 57]"
17,3,2738,5465,6910,0,1916,822,"[38, 44, 145, 0, 21, 208, 29, 112, 122, 237, 160, 95, 91, 229, 237, 118, 234, 258, 111, 236, 212, 56, 269, 266, 215, 197, 196]"
18,3,1906,852,7964,0,604,1302,"[118, 197, 99, 0, 24, 321, 70, 364, 265, 383, 343, 106, 158, 328, 386, 187, 34, 204, 318, 118, 317, 337, 342, 263, 154, 180, 126]"
19,3,1968,777,9155,0,1415,553,"[158, 168, 53, 0, 82, 150, 70, 176, 83, 121, 168, 41, 136, 104, 81, 155, 76, 61, 117, 108, 9, 21, 176, 141, 16, 146, 175]"
20,3,2741,5379,6517,0,1737,1004,"[61, 89, 164, 0, 182, 47, 215, 309, 228, 244, 81, 185, 34, 18, 56, 262, 253, 327, 227, 271, 217, 150, 324, 60, 334, 21, 118]"
21,3,2938,902,8553,0,393,2545,"[770, 14, 258, 0, 489, 573, 771, 837, 699, 451, 510, 407, 133, 651, 516, 607, 238, 138, 806, 848, 302, 79, 296, 351, 432, 843, 197]"
22,3,1386,473,9466,0,620,766,"[149, 119, 48, 0, 130, 217, 150, 63, 155, 30, 19, 189, 140, 58, 34, 247, 76, 91, 250, 180, 251, 78, 105, 210, 3, 185, 87]"
23,3,1000,103,10000,363,202,798,"[112, 60, 48, 0, 218, 180, 264, 62, 109, 27, 265, 132, 20, 3, 7, 239, 110, 185, 262, 235, 72, 261, 262, 26, 85, 164, 194]"
24,3,2172,6186,5986,0,401,1771,"[31, 123, 514, 0, 373, 481, 251, 144, 260, 564, 561, 574, 22, 230, 355, 50, 269, 218, 446, 517, 20, 533, 0, 139, 108, 527, 412]"
25,3,2305,404,7887,0,738,1567,"[431, 470, 55, 0, 113, 203, 349, 272, 489, 288, 516, 467, 475, 244, 371, 522, 316, 64, 32, 315, 275, 230, 128, 233, 481, 480, 172]"
26,3,2462,1585,8764,0,1112,1350,"[446, 250, 176, 0, 257, 27, 286, 222, 363, 201, 333, 64, 255, 356, 123, 184, 259, 372, 321, 340, 28, 119, 308, 112, 378, 48, 298]"
27,3,2781,5997,5548,0,2106,675,"[47, 59, 175, 0, 67, 191, 217, 118, 166, 72, 202, 71, 117, 9, 218, 58, 161, 186, 50, 4, 51, 115, 145, 165, 21, 172, 132]"
28,3,1308,820,6036,0,205,1103,"[22, 159, 255, 0, 207, 206, 99, 176, 33, 255, 287, 165, 103, 168, 172, 356, 77, 34, 110, 363, 305, 242, 159, 215, 76, 314, 182]"
29,3,2658,2513,6181,0,1673,985,"[235, 151, 288, 0, 140, 288, 108, 252, 93, 18, 41, 131, 283, 323, 31, 92, 313, 89, 115, 63, 75, 58, 122, 310, 163, 113, 94]"
30,3,1522,207,7496,0,302,1220,"[195, 25, 107, 0, 180, 36, 40, 177, 2, 268, 29, 109, 130, 29, 149, 160, 356, 34, 79, 242, 291, 189, 188, 121, 88, 35, 396]"
31,3,2521,729,9288,0,725,1796,"[479, 178, 496, 0, 89, 328, 559, 224, 595, 454, 359, 7, 262, 367, 559, 434, 47, 406, 178, 165, 115, 593, 97, 368, 138, 251, 522]"
32,3,1207,328,10000,167,549,658,"[110, 213, 175, 0, 114, 190, 133, 151, 68, 21, 33, 186, 129, 34, 74, 94, 118, 141, 81, 25, 219, 17, 197, 91, 88, 143, 148]"
33,3,2137,6337,5800,0,875,1262,"[79, 339, 104, 0, 26, 162, 278, 378, 17, 30, 1, 292, 283, 150, 136, 309, 110, 154, 369, 352, 40, 253, 354, 85, 134, 140, 191]"
34,3,2522,2358,5964,0,1168,1354,"[382, 27, 342, 0, 81, 335, 254, 229, 273, 205, 242, 392, 421, 170, 0, 27, 411, 311, 298, 24, 413, 363, 51, 17, 332, 434, 311]"
35,3,1232,1212,5984,0,1001,231,"[49, 10, 15, 0, 23, 30, 26, 50, 46, 12, 34, 52, 49, 51, 33, 38, 43, 0, 54, 29, 11, 5, 61, 33, 65, 70, 20]"
36,3,2029,909,7104,0,1746,283,"[4, 46, 57, 0, 12, 91, 80, 75, 16, 70, 30, 66, 70, 66, 86, 67, 67, 33, 73, 74, 68, 20, 78, 83, 24, 12, 38]"
37,3,1211,409,7906,0,1093,118,"[18, 36, 25, 0, 12, 27, 31, 20, 6, 4, 30, 7, 17, 33, 10, 8, 35, 18, 34, 27, 19, 7, 0, 17, 23, 11, 4]"
38,3,2029,1214,8721,0,271,1758,"[117, 573, 60, 0, 453, 370, 153, 101, 3, 444, 398, 179, 36, 552, 451, 545, 332, 311, 24, 155, 339, 379, 210, 417, 458, 463, 359]"
39,3,2439,5770,5390,0,228,2211,"[504, 429, 238, 0, 232, 224, 290, 299, 660, 587, 469, 300, 680, 663, 598, 615, 210, 194, 597, 108, 301, 442, 731, 119, 26, 332, 732]"
40,3,2614,1324,6680,0,1215,1399,"[316, 343, 298, 0, 14, 272, 238, 108, 398, 334, 253, 135, 263, 358, 431, 199, 195, 332, 122, 49, 434, 28, 369, 32, 232, 428, 132]"
41,3,1042,544,7178,0,107,935,"[52, 9, 26, 0, 274, 305, 214, 5, 73, 134, 166, 2, 230, 254, 215, 17, 205, 192, 279, 257, 124, 133, 214, 282, 236, 153, 244]"
42,3,1796,1086,7888,0,355,1441,"[274, 381, 360, 0, 189, 112, 459, 206, 326, 107, 457, 229, 162, 94, 149, 0, 2, 354, 3, 163, 266, 404, 105, 271, 310, 13, 194]"
43,3,1138,366,8660,0,876,262,"[10, 0, 76, 0, 53, 53, 77, 25, 86, 4, 84, 71, 39, 55, 41, 9, 13, 43, 29, 63, 14, 20, 69, 37, 39, 46, 4]"
44,3,1580,22,10000,218,244,1336,"[396, 77, 11, 0, 148, 62, 306, 89, 217, 300, 140, 155, 162, 374, 398, 87, 3, 184, 51, 207, 364, 36, 383, 77, 62, 435, 3]"
45,3,1825,6931,4894,0,761,1064,"[208, 180, 149, 0, 159, 166, 98, 70, 53, 323, 142, 215, 227, 249, 338, 170, 206, 277, 69, 314, 31, 68, 102, 308, 256, 95, 47]"
46,3,1265,93,6066,0,383,882,"[77, 252, 57, 0, 71, 259, 142, 290, 74, 101, 106, 140, 149, 274, 212, 7, 5, 25, 262, 187, 78, 222, 257, 40, 290, 17, 272]"
47,3,1952,1349,6669,0,510,1442,"[327, 188, 210, 0, 230, 276, 267, 311, 264, 388, 291, 427, 221, 473, 281, 467, 60, 38, 324, 416, 301, 331, 68, 372, 283, 125, 125]"
48,3,1899,899,7669,0,17,1882,"[487, 407, 109, 0, 397, 253, 168, 491, 294, 464, 461, 622, 229, 8, 453, 445, 617, 457, 89, 160, 228, 372, 75, 426, 204, 506, 569]"
49,3,1987,1458,8198,0,625,1362,"[369, 84, 190, 0, 213, 57, 48, 239, 51, 48, 383, 427, 293, 444, 198, 56, 351, 217, 251, 377, 343, 13, 170, 17, 230, 181, 104]"
50,3,2626,1864,8960,0,2102,524,"[9, 113, 56, 0, 142, 81, 99, 166, 10, 29, 165, 134, 34, 4, 101, 107, 74, 12, 114, 78, 173, 63, 60, 74, 59, 89, 27]"
51,3,1918,1032,9846,0,1477,441,"[24, 25, 27, 0, 2, 136, 73, 108, 15, 99, 29, 85, 107, 140, 116, 82, 117, 145, 82, 32, 53, 133, 133, 96, 122, 122, 104]"
52,3,1035,677,10000,204,524,511,"[106, 88, 5, 0, 132, 156, 53, 126, 31, 50, 3, 123, 97, 51, 2, 126, 89, 112, 44, 100, 49, 4, 50, 150, 95, 56, 146]"
53,3,2865,5569,7296,0,949,1916,"[8, 603, 567, 0, 464, 179, 10, 339, 571, 148, 107, 54, 139, 416, 184, 417, 274, 356, 121, 72, 257, 35, 376, 182, 549, 74, 53]"
54,3,1412,1341,7367,0,779,633,"[147, 79, 34, 0, 35, 30, 170, 140, 129, 80, 148, 175, 152, 182, 29, 139, 60, 76, 37, 86, 14, 131, 49, 206, 24, 48, 172]"
55,3,1340,950,7757,0,139,1201,"[27, 173, 152, 0, 327, 104, 93, 107, 203, 327, 136, 355, 95, 79, 102, 358, 87, 88, 61, 286, 327, 145, 374, 67, 116, 113, 71]"
56,3,2246,1575,8428,0,1331,915,"[113, 135, 52, 0, 29, 297, 187, 228, 124, 117, 14, 247, 97, 280, 157, 121, 50, 224, 212, 151, 107, 211, 225, 234, 254, 109, 54]"
57,3,1165,631,8962,0,785,380,"[65, 29, 27, 0, 14, 82, 73, 8, 37, 58, 26, 89, 22, 34, 29, 118, 116, 49, 46, 22, 114, 74, 43, 55, 44, 23, 123]"
58,3,2317,5172,6107,0,216,2101,"[15, 553, 31, 0, 217, 686, 262, 232, 120, 488, 242, 419, 252, 227, 100, 128, 439, 392, 51, 200, 235, 616, 568, 71, 218, 87, 321]"
59,3,2348,1402,7053,0,1810,538,"[113, 48, 173, 0, 179, 0, 27, 141, 172, 55, 114, 113, 55, 129, 0, 97, 170, 50, 155, 174, 157, 120, 135, 139, 49, 9, 167]"
60,3,2889,2804,7138,0,511,2378,"[259, 279, 563, 0, 629, 178, 156, 7, 701, 659, 538, 416, 312, 577, 245, 450, 180, 671, 74, 649, 172, 783, 263, 366, 151, 123, 122]"
61,3,1440,833,7745,0,769,671,"[13, 167, 164, 0, 102, 10, 55, 48, 37, 78, 5, 20, 180, 170, 94, 205, 15, 9, 138, 64, 163, 175, 85, 134, 196, 68, 222]"
62,3,1792,178,9359,0,477,1315,"[296, 253, 214, 0, 34, 382, 316, 417, 287, 431, 161, 75, 204, 79, 203, 343, 356, 230, 268, 413, 411, 334, 112, 378, 157, 79, 328]"
63,3,2841,7081,5119,0,5,2836,"[777, 362, 794, 0, 118, 169, 357, 272, 95, 310, 429, 10, 921, 252, 236, 154, 851, 490, 604, 858, 864, 223, 852, 484, 941, 681, 255]"
64,3,2993,491,7621,0,1481,1512,"[496, 124, 350, 0, 290, 106, 214, 373, 431, 123, 355, 183, 229, 501, 444, 436, 420, 6, 173, 393, 126, 231, 310, 495, 255, 374, 194]"
65,3,1659,914,8366,0,341,1318,"[157, 180, 192, 0, 175, 29, 166, 88, 27, 13, 238, 46, 265, 432, 293, 361, 306, 75, 42, 24, 426, 191, 190, 267, 156, 34, 356]"
66,3,2531,2068,8829,0,407,2124,"[381, 639, 307, 0, 189, 167, 163, 259, 576, 367, 640, 192, 470, 42, 619, 342, 222, 301, 708, 471, 42, 657, 280, 107, 691, 634, 434]"
67,3,1671,157,10000,343,1166,505,"[151, 70, 142, 0, 80, 40, 74, 34, 44, 84, 134, 39, 42, 113, 83, 64, 107, 133, 9, 47, 61, 80, 29, 155, 79, 167, 105]"
68,3,2732,7466,5266,0,1756,976,"[113, 47, 253, 0, 176, 272, 289, 239, 275, 223, 4, 228, 84, 248, 253, 6, 239, 210, 223, 140, 42, 315, 141, 230, 46, 198, 185]"
69,3,2958,2215,6009,0,2034,924,"[84, 217, 211, 0, 162, 255, 167, 7, 29, 119, 66, 221, 153, 199, 284, 267, 261, 138, 307, 304, 216, 121, 106, 185, 87, 278, 153]"
70,3,2472,1063,7418,0,259,2213,"[150, 93, 425, 0, 607, 408, 669, 315, 43, 202, 633, 433, 408, 254, 377, 102, 671, 79, 571, 672, 588, 152, 626, 326, 335, 594, 88]"
71,3,1359,57,8720,0,570,789,"[137, 56, 84, 0, 248, 72, 192, 240, 79, 4, 239, 6, 188, 61, 237, 173, 252, 186, 12, 230, 163, 76, 207, 205, 138, 201, 51]"
72,3,2293,6935,4078,0,34,2259,"[169, 635, 250, 0, 73, 696, 52, 254, 149, 317, 129, 208, 732, 72, 711, 603, 465, 110, 537, 363, 371, 303, 505, 233, 417, 557, 590]"
73,3,1542,1201,4419,0,660,882,"[155, 202, 145, 0, 276, 130, 118, 291, 78, 189, 272, 79, 123, 94, 239, 23, 27, 205, 165, 72, 5, 222, 163, 132, 268, 277, 32]"
74,3,2009,1190,5238,0,1274,735,"[47, 235, 238, 0, 43, 96, 74, 194, 121, 215, 152, 192, 2, 160, 71, 198, 203, 114, 148, 63, 146, 22, 147, 39, 202, 95, 184]"
75,3,2744,509,7473,0,2420,324,"[15, 71, 47, 0, 32, 95, 106, 25, 93, 33, 63, 17, 82, 36, 47, 19, 18, 85, 2, 79, 21, 97, 78, 10, 47, 71, 71]"
76,3,1461,32,8902,0,1249,212,"[70, 53, 57, 0, 10, 49, 39, 67, 15, 61, 67, 24, 60, 37, 23, 34, 25, 27, 5, 58, 69, 45, 58, 10, 53, 13, 32]"
77,3,2713,5399,6216,0,910,1803,"[333, 560, 352, 0, 326, 345, 96, 377, 110, 528, 34, 532, 292, 143, 127, 190, 542, 104, 135, 475, 127, 406, 355, 173, 446, 302, 417]"
78,3,1915,1802,6329,0,517,1398,"[77, 167, 353, 0, 402, 461, 136, 409, 350, 244, 323, 105, 246, 51, 419, 92, 232, 112, 58, 370, 105, 153, 178, 428, 223, 158, 410]"
79,3,1953,540,7742,0,882,1071,"[33, 357, 239, 0, 302, 47, 336, 52, 184, 43, 24, 95, 223, 99, 40, 89, 211, 307, 204, 76, 188, 338, 260, 287, 353, 330, 321]"
80,3,2122,1759,8105,0,930,1192,"[163, 107, 371, 0, 129, 43, 381, 348, 213, 57, 395, 14, 279, 96, 299, 313, 321, 268, 360, 369, 46, 343, 380, 155, 36, 267, 94]"
81,3,2305,969,9441,0,1711,594,"[157, 20, 10, 0, 68, 125, 169, 65, 5, 145, 72, 90, 101, 12, 142, 1, 32, 43, 4, 58, 3, 82, 37, 142, 3, 51, 157]"
82,3,2928,6596,5773,0,2653,275,"[3, 48, 41, 0, 28, 19, 9, 44, 30, 22, 45, 30, 70, 61, 16, 35, 85, 91, 83, 89, 7, 69, 41, 79, 59, 54, 55]"
83,3,2603,2224,6152,0,53,2550,"[699, 807, 566, 0, 355, 742, 287, 263, 38, 312, 729, 12, 670, 796, 612, 407, 624, 840, 564, 620, 458, 247, 794, 125, 365, 290, 608]"
84,3,2307,1561,6898,0,701,1606,"[219, 1, 56, 0, 394, 257, 504, 81, 52, 91, 335, 381, 200, 512, 508, 190, 145, 462, 479, 283, 147, 497, 134, 482, 245, 404, 84]"
85,3,1902,1698,7102,0,1880,22,"[3, 3, 5, 0, 1, 1, 2, 7, 4, 0, 5, 2, 0, 5, 6, 5, 7, 1, 0, 3, 0, 3, 1, 4, 6, 1, 2]"
86,3,2769,2481,7390,0,318,2451,"[457, 802, 87, 0, 2, 520, 286, 269, 26, 410, 556, 219, 428, 536, 535, 600, 705, 681, 288, 722, 135, 508, 610, 272, 286, 13, 603]"
87,3,2806,57,10000,139,643,2163,"[599, 233, 375, 0, 23, 47, 543, 625, 230, 673, 162, 382, 491, 58, 670, 257, 318, 26, 476, 376, 183, 266, 622, 138, 497, 437, 617]"
88,3,1430,6790,4640,0,901,529,"[94, 144, 44, 0, 4, 62, 94, 123, 39, 132, 50, 17, 18, 7, 62, 149, 70, 23, 150, 70, 25, 150, 107, 7, 126, 130, 129]"
89,3,1141,566,5215,0,70,1071,"[155, 285, 212, 0, 214, 172, 68, 18, 168, 140, 238, 88, 75, 36, 41, 90, 203, 91, 195, 112, 254, 223, 101, 198, 251, 315, 88]"
90,3,2123,1797,5541,0,1490,633,"[110, 41, 36, 0, 65, 68, 47, 34, 113, 200, 57, 9, 205, 174, 197, 158, 6, 169, 151, 0, 117, 52, 132, 206, 80, 175, 73]"
91,3,2372,1871,6042,0,686,1686,"[109, 140, 463, 0, 173, 22, 185, 470, 241, 421, 381, 216, 489, 242, 7, 259, 499, 178, 282, 160, 73, 521, 136, 132, 46, 331, 545]"
92,3,1067,530,6579,0,691,376,"[38, 40, 46, 0, 43, 89, 24, 74, 45, 38, 110, 81, 57, 110, 29, 110, 95, 4, 25, 101, 1, 84, 3, 12, 68, 1, 35]"
93,3,2928,1079,8428,0,2809,119,"[13, 30, 30, 0, 4, 25, 30, 36, 14, 12, 3, 30, 28, 12, 32, 8, 30, 11, 0, 14, 3, 25, 20, 13, 22, 28, 27]"
94,3,1834,1531,8731,0,291,1543,"[391, 107, 483, 0, 224, 357, 37, 514, 381, 342, 393, 367, 99, 63, 359, 464, 342, 0, 132, 119, 218, 302, 137, 402, 291, 83, 36]"
95,3,1095,182,9644,0,1043,52,"[17, 17, 9, 0, 8, 12, 11, 17, 4, 17, 2, 17, 14, 12, 15, 1, 14, 13, 13, 12, 4, 15, 6, 10, 14, 14, 2]"
96,3,1981,6985,4640,0,1945,36,"[7, 4, 9, 0, 5, 4, 3, 12, 0, 11, 9, 6, 10, 0, 8, 3, 3, 2, 4, 2, 5, 5, 6, 6, 7, 5, 9]"
97,3,2101,1079,5662,0,1425,676,"[213, 78, 146, 0, 35, 206, 137, 37, 174, 150, 136, 59, 26, 42, 41, 48, 165, 191, 204, 70, 54, 223, 80, 48, 164, 44, 134]"
98,3,1455,351,6766,0,1355,100,"[27, 29, 9, 0, 29, 3, 23, 22, 11, 4, 26, 26, 23, 28, 24, 13, 14, 0, 1, 24, 10, 29, 17, 4, 21, 4, 3]"
99,3,2589,998,8357,0,1575,1014,"[219, 65, 56, 0, 133, 250, 46, 65, 33, 329, 337, 226, 259, 50, 30, 291, 116, 172, 265, 86, 145, 83, 191, 275, 246, 168, 277]"
100,3,1857,150,10000,64,1033,824,"[99, 65, 231, 0, 18, 167, 214, 267, 249, 153, 30, 241, 77, 162, 4, 247, 32, 265, 74, 118, 191, 119, 124, 12, 37, 258, 159]"
101,3,1830,6889,4941,0,529,1301,"[123, 359, 271, 0, 224, 367, 234, 213, 213, 424, 208, 430, 14, 321, 282, 221, 11, 222, 94, 164, 63, 107, 261, 222, 66, 339, 364]"
102,3,1275,157,6059,0,1075,200,"[9, 6, 19, 0, 48, 63, 9, 37, 6, 33, 14, 25, 5, 43, 28, 24, 17, 5, 65, 11, 31, 40, 11, 15, 65, 45, 40]"
103,3,2369,606,7822,0,1189,1180,"[195, 32, 80, 0, 149, 110, 368, 292, 166, 212, 117, 236, 380, 227, 91, 123, 5, 309, 82, 125, 227, 245, 255, 109, 233, 275, 290]"
104,3,1483,517,8788,0,696,787,"[118, 228, 190, 0, 118, 254, 183, 204, 185, 2, 22, 261, 196, 110, 137, 5, 168, 221, 153, 120, 127, 5, 141, 167, 230, 70, 227]"
105,3,1084,276,9596,0,241,843,"[230, 275, 7, 0, 46, 235, 226, 70, 89, 57, 140, 156, 115, 157, 40, 186, 111, 31, 257, 117, 260, 158, 257, 41, 126, 223, 181]"
106,3,2055,6780,4871,0,1557,498,"[33, 58, 55, 0, 83, 159, 32, 34, 155, 42, 135, 127, 30, 71, 92, 116, 90, 65, 7, 58, 43, 36, 65, 5, 36, 12, 11]"
107,3,2213,1361,5723,0,1471,742,"[138, 85, 149, 0, 116, 199, 222, 0, 233, 33, 137, 160, 35, 191, 202, 172, 29, 4, 156, 40, 86, 16, 233, 159, 89, 239, 32]"
108,3,2947,2920,5750,0,2203,744,"[175, 41, 212, 0, 140, 114, 168, 227, 140, 124, 242, 248, 32, 231, 31, 61, 45, 22, 203, 42, 218, 54, 79, 35, 57, 18, 247]"
109,3,2879,1276,7353,0,2332,547,"[173, 21, 55, 0, 161, 30, 40, 55, 145, 176, 76, 178, 57, 137, 169, 180, 41, 2, 101, 33, 34, 176, 93, 15, 103, 176, 113]"
110,3,1543,1332,7564,0,140,1403,"[144, 1, 287, 0, 282, 281, 106, 97, 327, 231, 67, 446, 331, 308, 214, 50, 281, 82, 231, 453, 180, 404, 302, 34, 165, 429, 152]"
111,3,2790,2689,7665,0,2310,480,"[53, 72, 146, 0, 122, 123, 128, 36, 119, 25, 27, 101, 47, 31, 2, 123, 110, 121, 19, 116, 76, 67, 103, 40, 99, 52, 106]"
112,3,1403,538,8530,0,1300,103,"[4, 13, 11, 0, 24, 26, 31, 5, 30, 3, 10, 28, 4, 6, 8, 3, 13, 25, 5, 34, 6, 17, 8, 18, 12, 16, 25]"
113,3,2039,831,9738,0,756,1283,"[163, 241, 181, 0, 82, 138, 191, 6, 35, 390, 90, 409, 343, 382, 408, 296, 397, 389, 60, 229, 138, 245, 45, 5, 212, 366, 267]"
114,3,1570,5940,5368,0,706,864,"[232, 239, 124, 0, 122, 162, 246, 10, 211, 197, 123, 111, 13, 263, 131, 175, 15, 239, 123, 213, 87, 241, 28, 69, 203, 74, 237]"
115,3,2183,125,7426,0,1338,845,"[247, 198, 54, 0, 147, 204, 274, 32, 193, 273, 206, 280, 214, 168, 187, 61, 87, 278, 147, 99, 278, 52, 89, 187, 176, 244, 66]"
116,3,2811,2447,7790,0,767,2044,"[628, 294, 670, 0, 491, 429, 548, 233, 129, 234, 679, 642, 353, 20, 380, 120, 529, 388, 484, 338, 183, 623, 653, 411, 526, 105, 83]"
117,3,2522,1351,8961,0,1561,961,"[127, 260, 34, 0, 56, 308, 276, 214, 104, 19, 247, 315, 222, 296, 45, 66, 9, 280, 148, 145, 202, 25, 317, 244, 232, 193, 189]"
118,3,2407,6882,4486,0,860,1547,"[6, 483, 236, 0, 190, 387, 254, 143, 437, 250, 512, 68, 21, 297, 349, 444, 177, 125, 163, 245, 99, 316, 55, 95, 119, 299, 345]"
119,3,2827,2476,4837,0,1291,1536,"[262, 164, 287, 0, 131, 8, 210, 17, 80, 56, 431, 395, 155, 378, 137, 308, 2, 330, 249, 485, 372, 441, 256, 365, 59, 127, 183]"
120,3,1077,251,5663,0,723,354,"[100, 118, 14, 0, 44, 47, 23, 104, 2, 30, 114, 22, 102, 75, 75, 52, 84, 33, 31, 96, 11, 76, 40, 75, 104, 40, 2]"
121,3,1928,1856,5735,0,344,1584,"[280, 163, 505, 0, 234, 349, 433, 175, 217, 326, 154, 410, 357, 489, 397, 10, 453, 52, 42, 463, 504, 104, 82, 5, 310, 118, 41]"
122,3,2380,1969,6146,0,244,2136,"[113, 708, 479, 0, 251, 334, 225, 148, 551, 399, 385, 535, 66, 74, 527, 169, 518, 507, 145, 517, 655, 674, 277, 680, 570, 248, 241]"
123,3,1722,541,7327,0,41,1681,"[113, 139, 429, 0, 464, 151, 440, 411, 153, 211, 28, 172, 100, 50, 334, 363, 267, 166, 118, 221, 56, 411, 28, 471, 307, 67, 255]"
124,3,2866,2590,7603,0,1240,1626,"[212, 212, 362, 0, 205, 278, 508, 237, 415, 196, 486, 45, 45, 2, 340, 390, 531, 75, 527, 215, 38, 181, 342, 38, 404, 198, 336]"
125,3,1315,921,7997,0,456,859,"[171, 195, 203, 0, 177, 103, 286, 39, 79, 38, 264, 178, 151, 58, 37, 229, 166, 119, 212, 90, 49, 183, 235, 2, 211, 48, 62]"
126,3,2066,557,9506,0,1487,579,"[81, 52, 137, 0, 188, 157, 158, 104, 15, 32, 127, 8, 112, 68, 80, 13, 150, 118, 16, 154, 5, 86, 29, 34, 123, 141, 66]"
127,3,1944,6511,4939,0,1115,829,"[275, 78, 66, 0, 258, 266, 49, 218, 231, 77, 166, 63, 79, 153, 42, 18, 17, 89, 269, 272, 61, 229, 175, 237, 48, 10, 257]"
128,3,1647,316,6270,0,104,1543,"[495, 110, 468, 0, 146, 324, 372, 7, 429, 280, 330, 138, 382, 183, 139, 407, 177, 300, 509, 142, 330, 28, 208, 457, 83, 349, 358]"
129,3,2642,335,8577,0,288,2354,"[410, 137, 382, 0, 305, 430, 726, 413, 3, 688, 65, 554, 634, 395, 648, 782, 86, 251, 228, 378, 40, 157, 219, 572, 769, 582, 775]"
130,3,1542,746,9373,0,86,1456,"[159, 440, 242, 0, 437, 276, 116, 462, 82, 210, 24, 394, 55, 474, 61, 333, 460, 257, 49, 315, 77, 422, 213, 421, 388, 291, 290]"
131,3,1192,125,10000,440,415,777,"[171, 242, 40, 0, 253, 168, 30, 174, 50, 193, 64, 189, 83, 23, 25, 187, 61, 31, 239, 122, 164, 94, 152, 112, 218, 157, 181]"
132,3,2556,5340,7216,0,1510,1046,"[227, 332, 321, 0, 227, 299, 33, 46, 250, 56, 40, 302, 145, 240, 171, 30, 264, 239, 183, 215, 142, 24, 227, 217, 126, 278, 238]"
133,3,2305,1808,7713,0,1406,899,"[255, 203, 202, 0, 150, 16, 145, 291, 172, 245, 79, 163, 188, 28, 210, 294, 179, 178, 176, 188, 262, 172, 27, 81, 39, 96, 156]"
134,3,1292,623,8382,0,817,475,"[46, 115, 123, 0, 87, 79, 96, 8, 9, 47, 152, 67, 14, 40, 29, 126, 93, 147, 132, 152, 59, 62, 104, 128, 35, 106, 19]"
135,3,1145,1131,8396,0,694,451,"[38, 95, 95, 0, 20, 53, 41, 62, 70, 106, 23, 3, 46, 31, 101, 12, 58, 98, 34, 29, 37, 145, 15, 2, 121, 119, 94]"
136,3,2291,75,10000,612,1683,608,"[9, 201, 192, 0, 162, 19, 161, 79, 46, 8, 75, 123, 103, 131, 110, 103, 186, 34, 15, 66, 191, 124, 120, 101, 0, 114, 175]"
137,3,1717,5765,5952,0,1635,82,"[17, 2, 25, 0, 21, 26, 20, 9, 21, 20, 10, 16, 7, 26, 21, 3, 18, 1, 20, 0, 9, 15, 27, 11, 12, 3, 17]"
138,3,2650,1422,7180,0,1821,829,"[45, 264, 111, 0, 37, 73, 160, 187, 226, 115, 79, 222, 193, 113, 142, 155, 187, 142, 221, 2, 151, 239, 254, 40, 193, 24, 204]"
139,3,1318,1303,7195,0,725,593,"[142, 118, 187, 0, 170, 149, 147, 131, 192, 54, 82, 125, 45, 41, 55, 116, 106, 190, 118, 107, 120, 40, 81, 41, 32, 31, 60]"
140,3,2507,1796,7906,0,2007,500,"[75, 126, 54, 0, 82, 36, 107, 78, 10, 4, 86, 61, 75, 18, 149, 110, 110, 49, 66, 125, 136, 14, 110, 43, 121, 106, 102]"
141,3,1373,823,8456,0,832,541,"[35, 127, 22, 0, 51, 68, 70, 85, 77, 63, 147, 57, 47, 9, 29, 90, 125, 51, 153, 33, 65, 43, 60, 153, 164, 118, 100]"
142,3,1759,1600,8615,0,207,1552,"[225, 516, 302, 0, 466, 351, 4, 32, 100, 48, 161, 306, 102, 274, 156, 257, 311, 13, 508, 43, 101, 214, 62, 155, 419, 380, 361]"
143,3,2812,7259,4168,0,2080,732,"[55, 64, 209, 0, 178, 174, 172, 186, 143, 140, 37, 70, 109, 230, 51, 14, 14, 92, 45, 43, 79, 229, 170, 7, 29, 57, 46]"
144,3,2318,2176,4310,0,2165,153,"[8, 51, 42, 0, 9, 44, 34, 8, 0, 28, 26, 5, 17, 20, 24, 33, 21, 4, 44, 48, 0, 27, 34, 33, 8, 27, 30]"
145,3,1086,503,4893,0,901,185,"[46, 3, 30, 0, 13, 59, 39, 17, 14, 0, 46, 44, 9, 58, 4, 34, 35, 38, 50, 2, 57, 60, 31, 60, 59, 15, 33]"
146,3,2956,1790,6059,0,2700,256,"[25, 48, 5, 0, 52, 14, 23, 15, 57, 77, 35, 12, 76, 67, 44, 3, 17, 22, 10, 57, 50, 40, 24, 25, 43, 78, 8]"
147,3,1634,445,7248,0,999,635,"[17, 91, 117, 0, 16, 209, 107, 105, 102, 61, 154, 71, 154, 192, 92, 53, 31, 103, 29, 202, 1, 174, 85, 174, 44, 31, 170]"
148,3,1319,1255,7312,0,1196,123,"[29, 29, 30, 0, 23, 3, 2, 34, 15, 31, 28, 23, 34, 26, 37, 21, 29, 33, 27, 41, 28, 10, 1, 31, 30, 10, 5]"
149,3,2757,1296,8773,0,2712,45,"[13, 1, 10, 0, 8, 12, 1, 11, 8, 3, 10, 13, 7, 15, 10, 15, 10, 13, 0, 0, 3, 5, 9, 3, 13, 6, 8]"
150,3,1113,85,9801,0,126,987,"[128, 237, 22, 0, 309, 120, 317, 280, 50, 244, 165, 84, 328, 129, 63, 269, 111, 201, 74, 53, 185, 134, 96, 62, 303, 194, 190]"
151,3,2388,7041,5148,0,936,1452,"[225, 226, 108, 0, 87, 332, 75, 177, 275, 88, 279, 292, 175, 246, 76, 349, 227, 343, 186, 437, 273, 23, 450, 269, 166, 207, 147]"
152,3,1193,766,5575,0,164,1029,"[159, 159, 114, 0, 45, 76, 256, 303, 38, 142, 37, 210, 208, 288, 96, 101, 284, 326, 310, 95, 133, 88, 56, 307, 265, 325, 147]"
153,3,1664,661,6578,0,296,1368,"[222, 453, 146, 0, 409, 446, 301, 160, 337, 182, 230, 61, 146, 46, 256, 359, 128, 66, 406, 162, 160, 17, 349, 263, 449, 196, 214]"
154,3,2621,2461,6738,0,148,2473,"[161, 239, 575, 0, 367, 354, 800, 630, 635, 811, 36, 645, 38, 635, 271, 771, 77, 370, 421, 370, 310, 308, 490, 688, 394, 735, 578]"
155,3,2040,1283,7495,0,1406,634,"[175, 183, 181, 0, 133, 147, 37, 25, 111, 47, 205, 160, 124, 122, 170, 63, 91, 127, 98, 167, 78, 150, 125, 165, 145, 1, 182]"
156,3,1328,989,7834,0,297,1031,"[24, 258, 217, 0, 146, 163, 253, 311, 66, 232, 68, 99, 86, 140, 96, 10, 77, 103, 247, 251, 191, 289, 53, 166, 172, 119, 189]"
157,3,2802,401,10000,235,2587,215,"[29, 46, 38, 0, 42, 3, 19, 1, 60, 58, 56, 24, 19, 9, 36, 50, 47, 0, 30, 33, 5, 25, 61, 5, 44, 54, 14]"
158,3,2113,7169,4944,0,124,1989,"[51, 452, 27, 0, 604, 610, 142, 503, 223, 181, 215, 424, 308, 108, 648, 124, 174, 52, 543, 40, 628, 65, 605, 273, 514, 172, 21]"
159,3,2390,803,6531,0,1423,967,"[232, 150, 114, 0, 134, 104, 299, 68, 30, 56, 157, 155, 95, 39, 117, 187, 282, 97, 321, 219, 169, 287, 270, 198, 231, 204, 98]"
160,3,2161,411,8281,0,1996,165,"[32, 34, 21, 0, 54, 15, 28, 38, 32, 9, 25, 19, 24, 32, 15, 49, 19, 39, 16, 49, 19, 7, 50, 14, 48, 45, 3]"
161,3,1560,218,9623,0,564,996,"[219, 155, 202, 0, 190, 160, 326, 318, 22, 210, 275, 304, 274, 38, 90, 157, 57, 68, 47, 201, 86, 119, 202, 238, 177, 249, 91]"
162,3,1207,527,10000,303,275,932,"[192, 229, 22, 0, 202, 23, 71, 212, 104, 293, 115, 74, 116, 29, 200, 171, 35, 137, 288, 20, 242, 152, 38, 45, 215, 294, 273]"
163,3,2769,6543,6226,0,2533,236,"[55, 77, 21, 0, 43, 40, 21, 15, 16, 39, 6, 2, 31, 9, 56, 48, 20, 28, 73, 12, 3, 3, 72, 43, 76, 75, 36]"
164,3,1422,545,7103,0,1003,419,"[92, 27, 94, 0, 10, 38, 69, 122, 122, 93, 61, 57, 77, 93, 23, 120, 41, 79, 99, 139, 85, 139, 69, 21, 40, 67, 91]"
165,3,2662,1278,8487,0,1976,686,"[218, 127, 124, 0, 40, 0, 31, 18, 117, 58, 149, 70, 159, 171, 99, 90, 90, 117, 57, 126, 203, 170, 228, 5, 4, 36, 155]"
166,3,1219,442,9264,0,398,821,"[156, 170, 179, 0, 88, 186, 253, 146, 47, 199, 17, 145, 206, 80, 138, 96, 197, 132, 269, 32, 77, 144, 158, 192, 239, 22, 52]"
167,3,2213,6071,5406,0,691,1522,"[318, 269, 296, 0, 377, 374, 314, 210, 471, 224, 255, 312, 220, 502, 27, 40, 51, 231, 139, 303, 252, 385, 170, 14, 454, 490, 56]"
168,3,1162,931,5637,0,959,203,"[34, 63, 65, 0, 15, 60, 57, 19, 59, 13, 53, 38, 3, 25, 31, 8, 63, 32, 47, 35, 26, 14, 32, 45, 0, 64, 45]"
169,3,2052,1458,6231,0,1378,674,"[202, 9, 41, 0, 82, 35, 194, 211, 136, 4, 58, 177, 124, 47, 219, 13, 57, 174, 31, 150, 190, 25, 69, 7, 197, 121, 151]"
170,3,2983,1902,7312,0,2324,659,"[197, 185, 107, 0, 167, 82, 215, 4, 105, 25, 170, 33, 203, 85, 18, 56, 162, 53, 73, 123, 46, 75, 110, 191, 14, 82, 72]"
171,3,1939,1836,7415,0,39,1900,"[182, 168, 628, 0, 578, 239, 67, 403, 390, 491, 230, 343, 500, 295, 383, 447, 232, 574, 595, 328, 326, 229, 259, 120, 561, 188, 307]"
172,3,2221,1276,8360,0,19,2202,"[253, 355, 97, 0, 36, 559, 221, 10, 376, 519, 321, 152, 207, 398, 691, 649, 174, 703, 695, 88, 726, 0, 513, 418, 330, 143, 556]"
173,3,1105,209,9256,0,835,270,"[66, 37, 32, 0, 71, 71, 86, 7, 24, 27, 47, 30, 90, 55, 64, 74, 60, 55, 46, 26, 11, 87, 3, 4, 7, 9, 48]"
174,3,2631,7413,4474,0,1565,1066,"[259, 273, 117, 0, 236, 340, 108, 118, 230, 57, 3, 43, 11, 217, 144, 102, 143, 221, 273, 97, 323, 194, 344, 336, 203, 68, 319]"
175,3,2795,2294,4975,0,159,2636,"[310, 674, 334, 0, 108, 197, 875, 102, 441, 834, 778, 368, 370, 61, 766, 814, 532, 711, 246, 801, 169, 152, 4, 66, 552, 340, 136]"
176,3,1268,1011,5232,0,238,1030,"[98, 84, 51, 0, 235, 34, 253, 3, 343, 122, 290, 158, 270, 65, 243, 111, 68, 39, 265, 103, 44, 43, 182, 30, 19, 198, 57]"
177,3,1396,478,6150,0,868,528,"[67, 114, 68, 0, 134, 115, 163, 130, 117, 99, 155, 133, 120, 33, 65, 122, 11, 31, 153, 171, 27, 155, 44, 97, 10, 43, 128]"
178,3,1687,102,7735,0,1104,583,"[94, 94, 25, 0, 49, 103, 151, 49, 67, 3, 117, 158, 176, 151, 95, 152, 50, 163, 102, 86, 154, 105, 153, 74, 62, 128, 20]"
179,3,1013,908,7840,0,172,841,"[130, 261, 19, 0, 124, 47, 212, 75, 204, 69, 271, 164, 271, 23, 153, 245, 0, 224, 131, 226, 196, 154, 260, 103, 280, 34, 97]"
180,3,1018,427,8431,0,834,184,"[45, 48, 13, 0, 14, 30, 59, 43, 20, 13, 34, 50, 21, 59, 9, 17, 61, 16, 49, 50, 26, 33, 15, 30, 12, 49, 38]"
181,3,1741,815,9357,0,1170,571,"[96, 0, 174, 0, 22, 139, 98, 5, 138, 123, 178, 119, 63, 188, 148, 128, 77, 11, 59, 64, 147, 28, 0, 85, 120, 144, 69]"
182,3,1543,594,10000,306,427,1116,"[123, 67, 124, 0, 329, 85, 330, 22, 235, 72, 346, 323, 139, 129, 369, 115, 180, 331, 4, 339, 13, 354, 281, 268, 286, 55, 53]"
183,3,1147,5495,5652,0,801,346,"[24, 13, 41, 0, 39, 6, 58, 50, 88, 17, 110, 49, 31, 92, 26, 40, 6, 108, 26, 83, 31, 0, 115, 83, 3, 91, 37]"
184,3,2704,548,7808,0,782,1922,"[76, 347, 613, 0, 163, 23, 440, 295, 635, 160, 57, 330, 336, 333, 325, 272, 413, 405, 425, 314, 308, 547, 543, 387, 396, 35, 481]"
185,3,2953,93,10000,668,111,2842,"[838, 861, 48, 0, 417, 111, 118, 386, 762, 467, 473, 368, 561, 487, 184, 408, 750, 620, 651, 134, 21, 157, 302, 415, 509, 101, 531]"
186,3,1245,7259,3986,0,1202,43,"[11, 3, 12, 0, 2, 6, 9, 3, 7, 11, 0, 5, 13, 0, 7, 0, 1, 6, 0, 13, 2, 13, 1, 0, 6, 13, 9]"
187,3,1459,1083,4362,0,1414,45,"[12, 11, 5, 0, 11, 15, 4, 5, 15, 0, 4, 4, 4, 14, 2, 12, 12, 5, 3, 5, 15, 15, 14, 11, 5, 14, 8]"
188,3,1764,1291,4835,0,751,1013,"[323, 149, 236, 0, 144, 52, 300, 244, 15, 107, 66, 203, 83, 94, 105, 45, 262, 19, 279, 133, 208, 287, 290, 190, 259, 25, 219]"
189,3,2898,972,6761,0,2313,585,"[105, 70, 46, 0, 178, 56, 166, 87, 111, 50, 155, 32, 169, 10, 133, 112, 38, 41, 0, 140, 40, 182, 159, 92, 67, 71, 96]"
190,3,1764,1585,6940,0,1662,102,"[6, 22, 10, 0, 26, 9, 3, 2, 20, 15, 28, 33, 9, 22, 32, 4, 33, 2, 15, 29, 31, 30, 33, 7, 15, 24, 7]"
191,3,1242,128,8054,0,797,445,"[38, 71, 76, 0, 112, 48, 108, 46, 148, 9, 53, 34, 77, 113, 25, 117, 120, 70, 128, 89, 28, 77, 100, 55, 128, 76, 127]"
192,3,1499,507,9046,0,936,563,"[181, 22, 185, 0, 47, 164, 174, 153, 101, 81, 6, 133, 62, 117, 105, 80, 10, 7, 20, 154, 82, 8, 176, 129, 74, 91, 69]"
193,3,2542,5042,6546,0,1568,974,"[207, 134, 60, 0, 147, 224, 291, 39, 115, 314, 45, 68, 266, 120, 247, 35, 195, 21, 207, 213, 160, 160, 246, 152, 234, 231, 50]"
194,3,2801,2163,7184,0,1108,1693,"[149, 154, 341, 0, 185, 185, 141, 425, 256, 536, 529, 91, 62, 258, 458, 77, 323, 315, 70, 225, 248, 87, 332, 70, 24, 490, 132]"
195,3,1800,785,8199,0,1111,689,"[65, 125, 45, 0, 88, 77, 25, 201, 103, 57, 209, 99, 125, 82, 58, 222, 125, 162, 11, 189, 128, 211, 203, 82, 8, 167, 177]"
196,3,1965,683,9481,0,1944,21,"[3, 2, 6, 0, 6, 3, 1, 4, 4, 3, 3, 6, 2, 1, 0, 6, 0, 2, 7, 0, 7, 7, 0, 5, 7, 5, 4]"
197,3,2132,7033,4580,0,1318,814,"[18, 57, 39, 0, 197, 247, 222, 43, 238, 27, 208, 266, 99, 70, 173, 133, 56, 244, 104, 147, 206, 134, 161, 158, 15, 145, 23]"
198,3,1502,1213,4869,0,584,918,"[226, 121, 25, 0, 67, 13, 226, 283, 185, 95, 162, 52, 42, 223, 114, 286, 48, 97, 238, 228, 266, 139, 23, 127, 77, 76, 187]"
199,3,1854,568,6155,0,121,1733,"[149, 339, 127, 0, 80, 476, 250, 385, 122, 431, 322, 516, 503, 572, 485, 80, 82, 301, 499, 466, 86, 184, 530, 572, 208, 276, 390]"
200,3,2238,702,7691,0,863,1375,"[70, 35, 161, 0, 293, 218, 64, 123, 92, 144, 249, 329, 233, 132, 301, 9, 335, 269, 104, 456, 247, 21, 87, 122, 113, 412, 184]"
201,3,2448,996,9143,0,1352,1096,"[281, 332, 343, 0, 26, 225, 346, 131, 102, 208, 289, 43, 42, 206, 338, 286, 213, 173, 290, 212, 338, 79, 62, 350, 249, 98, 203]"
202,3,1385,1369,9159,0,422,963,"[176, 122, 138, 0, 7, 72, 129, 146, 48, 245, 318, 26, 272, 117, 285, 27, 171, 148, 230, 175, 247, 269, 238, 3, 118, 78, 132]"
203,3,1670,1085,9744,0,1251,419,"[121, 25, 54, 0, 31, 107, 3, 78, 55, 117, 122, 29, 35, 84, 29, 101, 93, 0, 9, 135, 22, 50, 87, 27, 35, 120, 52]"
204,3,1541,6065,5220,0,1207,334,"[99, 89, 39, 0, 90, 48, 86, 29, 9, 49, 60, 60, 77, 1, 34, 34, 38, 87, 16, 93, 104, 20, 93, 101, 22, 82, 58]"
205,3,2388,1572,6036,0,1201,1187,"[294, 294, 375, 0, 180, 315, 157, 287, 232, 201, 187, 22, 102, 248, 131, 267, 349, 377, 36, 189, 342, 148, 388, 201, 297, 113, 178]"
206,3,1453,1310,6179,0,1253,200,"[4, 61, 23, 0, 61, 43, 64, 27, 64, 33, 24, 52, 61, 23, 19, 46, 45, 29, 22, 50, 40, 46, 26, 34, 65, 44, 58]"
207,3,1909,628,7460,0,1451,458,"[146, 66, 141, 0, 25, 67, 94, 113, 1, 45, 127, 41, 52, 10, 114, 142, 128, 115, 71, 63, 50, 78, 134, 8, 126, 151, 125]"
208,3,1634,934,8160,0,77,1557,"[512, 250, 371, 0, 461, 311, 25, 154, 498, 295, 111, 109, 168, 288, 187, 346, 121, 110, 501, 365, 136, 369, 327, 212, 326, 173, 175]"
209,3,2242,408,9994,0,717,1525,"[199, 205, 188, 0, 258, 279, 391, 160, 471, 480, 121, 322, 187, 407, 435, 104, 164, 396, 464, 218, 423, 1, 32, 331, 337, 20, 407]"
210,3,2897,5802,7089,0,828,2069,"[203, 134, 430, 0, 120, 149, 134, 123, 621, 460, 635, 29, 466, 229, 265, 299, 215, 532, 498, 40, 168, 274, 177, 243, 166, 50, 515]"
211,3,1211,141,8159,0,276,935,"[27, 30, 215, 0, 196, 253, 126, 253, 69, 267, 175, 239, 94, 78, 165, 47, 2, 196, 254, 174, 197, 10, 139, 304, 264, 263, 170]"
212,3,1756,315,9600,0,307,1449,"[9, 316, 420, 0, 31, 217, 33, 86, 329, 293, 445, 56, 410, 366, 353, 287, 277, 115, 294, 125, 152, 342, 179, 128, 240, 383, 477]"
213,3,2255,5426,6429,0,349,1906,"[442, 374, 499, 0, 122, 81, 255, 26, 193, 321, 296, 497, 94, 242, 315, 185, 11, 606, 616, 151, 255, 311, 308, 423, 86, 130, 327]"
214,3,2675,556,8548,0,917,1758,"[310, 443, 483, 0, 108, 344, 225, 317, 192, 188, 53, 169, 468, 446, 277, 218, 23, 444, 250, 61, 221, 329, 178, 287, 73, 534, 24]"
215,3,2535,6947,4136,0,199,2336,"[713, 764, 570, 0, 766, 553, 614, 272, 267, 615, 145, 367, 509, 591, 705, 231, 227, 108, 723, 199, 769, 661, 762, 176, 116, 358, 49]"
216,3,1865,1457,4544,0,423,1442,"[223, 142, 241, 0, 72, 170, 106, 449, 33, 91, 393, 118, 74, 185, 453, 282, 15, 419, 34, 267, 217, 403, 17, 16, 81, 459, 155]"
217,3,1123,704,4963,0,168,955,"[48, 144, 63, 0, 204, 193, 263, 263, 181, 250, 274, 308, 290, 202, 131, 117, 217, 106, 29, 115, 259, 49, 253, 249, 3, 191, 135]"
218,3,1772,523,6212,0,1198,574,"[167, 72, 15, 0, 101, 189, 146, 168, 115, 20, 19, 141, 57, 86, 66, 1, 81, 161, 185, 139, 143, 139, 181, 2, 20, 143, 53]"
219,3,1461,876,6797,0,192,1269,"[151, 173, 389, 0, 368, 382, 16, 67, 68, 250, 202, 49, 238, 119, 122, 304, 65, 169, 297, 408, 31, 99, 222, 256, 223, 411, 320]"
220,3,1370,146,8021,0,1260,110,"[25, 14, 14, 0, 33, 20, 4, 34, 24, 30, 24, 32, 25, 13, 24, 12, 25, 34, 36, 11, 24, 6, 25, 36, 30, 5, 15]"
221,3,2515,1186,9350,0,2246,269,"[51, 36, 79, 0, 40, 4, 24, 43, 15, 60, 60, 44, 38, 71, 58, 59, 47, 26, 22, 3, 35, 33, 36, 51, 37, 43, 46]"
222,3,2551,7078,4823,0,2273,278,"[55, 12, 5, 0, 49, 15, 19, 66, 29, 6, 39, 42, 72, 54, 76, 43, 19, 86, 38, 44, 10, 21, 10, 11, 27, 11, 23]"
223,3,2317,642,6498,0,62,2255,"[340, 136, 403, 0, 99, 6, 712, 552, 396, 697, 280, 103, 720, 589, 655, 225, 552, 485, 420, 499, 480, 655, 95, 681, 392, 100, 316]"
224,3,1284,518,7264,0,124,1160,"[377, 321, 59, 0, 71, 364, 168, 177, 351, 100, 173, 59, 217, 92, 370, 133, 303, 378, 126, 133, 51, 0, 22, 212, 186, 302, 220]"
225,3,2937,240,9961,0,946,1991,"[450, 406, 478, 0, 344, 47, 511, 197, 356, 374, 412, 336, 380, 129, 186, 89, 562, 349, 386, 394, 283, 370, 287, 48, 394, 523, 155]"
226,3,1483,5024,6420,0,443,1040,"[330, 322, 219, 0, 62, 220, 83, 316, 141, 164, 275, 48, 284, 81, 321, 2, 85, 323, 296, 89, 343, 251, 194, 118, 304, 32, 123]"
227,3,1024,474,6970,0,699,325,"[46, 47, 83, 0, 62, 63, 26, 16, 25, 11, 71, 82, 68, 82, 51, 35, 103, 2, 8, 57, 63, 35, 65, 68, 50, 15, 64]"
228,3,1085,524,7531,0,459,626,"[101, 135, 194, 0, 70, 151, 10, 33, 76, 156, 82, 35, 88, 141, 69, 152, 95, 22, 75, 134, 149, 10, 142, 80, 68, 157, 5]"
229,3,2566,509,9588,0,2381,185,"[6, 55, 42, 0, 0, 58, 49, 5, 58, 13, 9, 44, 51, 44, 40, 59, 4, 15, 18, 5, 35, 10, 49, 48, 52, 50, 27]"
230,3,1839,5872,5555,0,1075,764,"[208, 149, 254, 0, 147, 209, 183, 46, 167, 65, 244, 198, 222, 81, 162, 221, 113, 38, 102, 76, 210, 13, 42, 80, 147, 158, 137]"
231,3,1353,985,5923,0,546,807,"[63, 70, 237, 0, 229, 61, 137, 237, 136, 169, 228, 50, 153, 237, 238, 164, 137, 40, 142, 123, 81, 46, 56, 18, 98, 27, 206]"
232,3,2162,472,7613,0,243,1919,"[455, 254, 75, 0, 584, 54, 1, 605, 239, 627, 391, 531, 11, 595, 533, 342, 84, 336, 594, 341, 300, 571, 530, 278, 404, 440, 492]"
233,3,2568,716,9465,0,1983,585,"[146, 85, 189, 0, 119, 72, 8, 162, 162, 176, 189, 68, 109, 112, 93, 33, 79, 91, 104, 151, 0, 142, 70, 89, 112, 126, 107]"
234,3,2939,5095,7309,0,1339,1600,"[487, 428, 51, 0, 459, 305, 72, 93, 366, 414, 521, 513, 184, 219, 346, 279, 491, 69, 360, 45, 524, 432, 102, 40, 100, 175, 196]"
235,3,1457,1218,7548,0,1120,337,"[98, 41, 44, 0, 99, 60, 84, 70, 50, 26, 24, 105, 100, 65, 32, 18, 11, 93, 51, 69, 57, 31, 7, 43, 74, 44, 0]"
236,3,1078,304,8322,0,906,172,"[41, 27, 15, 0, 2, 46, 35, 45, 6, 4, 15, 6, 24, 16, 1, 50, 26, 28, 34, 36, 10, 6, 42, 48, 47, 41, 52]"
237,3,1031,486,8867,0,593,438,"[70, 10, 139, 0, 5, 37, 119, 66, 92, 29, 11, 111, 137, 108, 105, 43, 85, 104, 72, 73, 40, 57, 38, 23, 9, 27, 91]"
238,3,1961,1135,9693,0,713,1248,"[84, 166, 265, 0, 246, 49, 360, 415, 192, 399, 398, 269, 227, 51, 7, 275, 388, 398, 238, 176, 348, 245, 9, 166, 78, 258, 391]"
239,3,2488,6732,5449,0,1564,924,"[173, 144, 164, 0, 94, 11, 10, 106, 120, 298, 266, 176, 280, 59, 89, 82, 210, 221, 76, 178, 258, 218, 148, 74, 59, 79, 255]"
240,3,2597,603,7443,0,643,1954,"[346, 72, 562, 0, 197, 40, 277, 402, 348, 15, 226, 623, 234, 370, 479, 438, 603, 313, 191, 203, 111, 408, 537, 458, 403, 342, 532]"
241,3,1686,682,8447,0,420,1266,"[206, 231, 333, 0, 353, 316, 105, 326, 51, 278, 419, 341, 276, 189, 182, 364, 170, 392, 112, 182, 321, 100, 198, 177, 353, 223, 55]"
242,3,2991,6270,5168,0,937,2054,"[254, 240, 223, 0, 243, 166, 234, 476, 271, 168, 455, 159, 279, 278, 4, 251, 669, 91, 557, 180, 191, 345, 315, 142, 677, 655, 77]"
243,3,2989,1449,6708,0,2516,473,"[122, 28, 63, 0, 106, 115, 19, 38, 80, 31, 45, 26, 126, 47, 21, 25, 27, 152, 104, 115, 28, 71, 25, 52, 50, 108, 26]"
244,3,1315,197,7826,0,382,933,"[177, 8, 30, 0, 284, 234, 90, 113, 151, 66, 169, 149, 269, 230, 230, 2, 275, 273, 296, 188, 131, 189, 79, 203, 203, 93, 151]"
245,3,1194,1006,8014,0,1031,163,"[1, 50, 8, 0, 39, 1, 42, 4, 36, 23, 16, 31, 41, 54, 18, 32, 18, 37, 37, 25, 13, 49, 25, 45, 47, 5, 21]"
246,3,2758,1490,9282,0,561,2197,"[223, 323, 394, 0, 667, 367, 172, 663, 465, 717, 262, 690, 501, 434, 97, 105, 705, 475, 581, 468, 69, 55, 237, 178, 682, 311, 280]"
247,3,2434,6236,5480,0,281,2153,"[222, 10, 204, 0, 120, 429, 33, 182, 31, 94, 639, 600, 349, 30, 364, 273, 672, 512, 82, 354, 291, 400, 540, 711, 571, 633, 355]"
248,3,2850,1395,6935,0,213,2637,"[91, 455, 614, 0, 724, 420, 172, 424, 596, 356, 116, 862, 294, 640, 737, 653, 201, 698, 478, 258, 158, 48, 352, 117, 297, 89, 807]"
249,3,1562,683,7814,0,830,732,"[237, 237, 181, 0, 21, 41, 184, 234, 28, 22, 16, 163, 69, 94, 220, 58, 109, 28, 109, 137, 157, 126, 212, 114, 236, 94, 169]"
250,3,1110,760,8164,0,504,606,"[47, 6, 31, 0, 41, 28, 22, 147, 130, 112, 140, 105, 73, 122, 33, 144, 26, 83, 77, 29, 56, 154, 149, 73, 183, 66, 133]"
251,3,2649,1674,9139,0,1276,1373,"[246, 8, 321, 0, 404, 151, 340, 438, 435, 278, 310, 97, 408, 224, 337, 429, 317, 399, 191, 270, 344, 436, 442, 229, 111, 314, 116]"
252,3,1660,996,9803,0,143,1517,"[147, 60, 148, 0, 43, 448, 266, 231, 462, 315, 429, 416, 268, 481, 302, 289, 343, 83, 134, 335, 456, 296, 20, 72, 483, 218, 410]"
253,3,1430,5507,5726,0,262,1168,"[57, 150, 318, 0, 328, 272, 361, 83, 372, 246, 262, 167, 234, 162, 172, 59, 22, 137, 0, 293, 87, 220, 196, 364, 278, 260, 136]"
254,3,1400,521,6605,0,562,838,"[160, 263, 176, 0, 246, 38, 38, 157, 178, 130, 82, 69, 237, 173, 209, 9, 120, 108, 19, 137, 68, 250, 255, 161, 69, 107, 134]"
255,3,2015,1018,7602,0,433,1582,"[498, 385, 346, 0, 202, 452, 63, 432, 321, 24, 180, 197, 64, 74, 482, 451, 162, 327, 115, 465, 166, 22, 68, 81, 519, 285, 327]"
256,3,2198,1075,8725,0,959,1239,"[191, 28, 355, 0, 102, 362, 293, 335, 341, 411, 280, 53, 12, 113, 402, 410, 56, 254, 47, 175, 94, 258, 48, 148, 175, 50, 374]"
257,3,2416,6571,4570,0,1902,514,"[48, 85, 89, 0, 103, 168, 93, 146, 113, 125, 96, 71, 99, 31, 115, 86, 40, 89, 75, 158, 143, 139, 82, 112, 61, 12, 163]"
258,3,2283,141,6712,0,2182,101,"[21, 22, 13, 0, 3, 9, 15, 24, 24, 11, 11, 24, 12, 30, 8, 10, 33, 14, 22, 3, 10, 26, 7, 23, 20, 27, 7]"
259,3,1439,657,7494,0,171,1268,"[45, 25, 272, 0, 98, 327, 68, 107, 137, 97, 83, 358, 289, 69, 229, 349, 13, 265, 209, 49, 283, 349, 93, 392, 97, 317, 18]"
260,3,2059,888,8665,0,1165,894,"[296, 81, 162, 0, 94, 106, 142, 169, 76, 152, 167, 53, 146, 280, 183, 142, 255, 174, 173, 181, 1, 254, 23, 232, 276, 153, 200]"
261,3,2163,156,10000,672,62,2101,"[433, 193, 35, 0, 201, 68, 330, 182, 307, 293, 697, 698, 576, 616, 483, 527, 314, 472, 236, 465, 625, 463, 409, 434, 547, 135, 71]"
262,3,1946,5381,6565,0,550,1396,"[47, 87, 314, 0, 317, 333, 414, 222, 300, 452, 20, 172, 284, 2, 372, 68, 68, 316, 334, 304, 2, 365, 78, 320, 89, 158, 24]"
263,3,1529,1276,6818,0,1104,425,"[12, 16, 12, 0, 54, 97, 54, 29, 58, 111, 140, 1, 133, 72, 118, 34, 112, 93, 51, 39, 44, 101, 18, 39, 134, 37, 26]"
264,3,2240,1463,7595,0,1418,822,"[34, 18, 84, 0, 48, 26, 168, 7, 7, 124, 18, 29, 1, 207, 93, 163, 170, 241, 34, 165, 29, 136, 209, 103, 20, 86, 135]"
265,3,1029,439,8185,0,809,220,"[71, 73, 32, 0, 48, 14, 34, 11, 3, 2, 48, 23, 11, 54, 62, 40, 4, 71, 50, 18, 24, 64, 33, 39, 3, 65, 53]"
266,3,1332,406,9111,0,129,1203,"[347, 141, 145, 0, 228, 159, 101, 5, 350, 249, 77, 182, 140, 201, 215, 328, 119, 54, 279, 79, 162, 207, 320, 327, 169, 106, 64]"
267,3,1310,554,9867,0,162,1148,"[271, 346, 347, 0, 202, 101, 95, 317, 309, 350, 236, 33, 113, 181, 96, 335, 98, 324, 249, 197, 76, 18, 23, 209, 107, 288, 243]"
268,3,2765,5795,6837,0,691,2074,"[118, 406, 330, 0, 479, 410, 659, 292, 152, 653, 373, 603, 570, 218, 377, 620, 234, 368, 561, 679, 404, 292, 277, 336, 96, 206, 571]"
269,3,1981,1411,7407,0,1805,176,"[57, 48, 16, 0, 26, 27, 31, 36, 6, 12, 15, 27, 4, 56, 38, 19, 8, 9, 40, 41, 0, 8, 23, 10, 42, 40, 57]"
270,3,2428,771,9064,0,220,2208,"[652, 410, 216, 0, 470, 316, 112, 421, 343, 501, 380, 573, 23, 694, 331, 319, 585, 435, 733, 62, 564, 254, 247, 41, 726, 382, 133]"
271,3,1729,795,9998,0,287,1442,"[122, 128, 253, 0, 200, 140, 370, 151, 235, 341, 332, 359, 1, 374, 222, 222, 125, 104, 190, 8, 206, 31, 133, 222, 67, 382, 354]"
272,3,1848,6099,5747,0,1554,294,"[89, 74, 8, 0, 82, 93, 52, 98, 94, 86, 44, 29, 7, 40, 78, 5, 27, 14, 69, 7, 84, 8, 20, 11, 36, 32, 32]"
273,3,1722,1031,6438,0,415,1307,"[57, 226, 430, 0, 295, 342, 75, 61, 335, 299, 298, 5, 121, 236, 230, 236, 153, 78, 51, 259, 208, 181, 386, 288, 346, 418, 403]"
274,3,1100,220,7318,0,379,721,"[223, 39, 3, 0, 208, 131, 25, 62, 239, 60, 194, 173, 170, 146, 6, 55, 59, 33, 156, 15, 193, 112, 38, 64, 58, 25, 84]"
275,3,2321,1513,8126,0,1337,984,"[156, 261, 326, 0, 168, 81, 246, 276, 296, 267, 103, 194, 78, 264, 20, 95, 168, 143, 281, 299, 264, 227, 300, 27, 212, 37, 68]"
276,3,1634,601,9159,0,1557,77,"[8, 8, 12, 0, 2, 11, 11, 3, 7, 11, 13, 18, 18, 22, 7, 15, 4, 23, 13, 5, 4, 1, 1, 12, 7, 21, 0]"
277,3,1367,27,10000,499,740,627,"[34, 172, 48, 0, 100, 128, 143, 139, 206, 109, 10, 63, 208, 123, 131, 106, 198, 16, 32, 3, 164, 3, 166, 145, 39, 109, 139]"
278,3,1776,5544,6232,0,854,922,"[14, 135, 100, 0, 88, 96, 196, 258, 110, 144, 207, 109, 144, 268, 167, 105, 3, 125, 183, 189, 41, 287, 89, 112, 55, 208, 87]"
279,3,2963,2716,6479,0,2414,549,"[120, 103, 123, 0, 24, 116, 97, 92, 48, 156, 37, 135, 161, 112, 115, 81, 91, 97, 72, 34, 36, 96, 60, 23, 122, 173, 158]"
280,3,1367,1229,6617,0,162,1205,"[19, 229, 60, 0, 335, 344, 193, 228, 140, 70, 388, 270, 70, 209, 94, 327, 319, 304, 14, 216, 102, 204, 396, 361, 133, 398, 84]"
281,3,1235,143,7709,0,925,310,"[15, 64, 9, 0, 46, 90, 99, 99, 20, 100, 32, 4, 94, 2, 84, 25, 94, 42, 84, 71, 33, 50, 63, 91, 28, 21, 35]"
282,3,1283,287,8705,0,61,1222,"[232, 196, 204, 0, 204, 403, 297, 69, 76, 49, 334, 334, 185, 16, 348, 399, 349, 236, 205, 155, 327, 293, 19, 180, 297, 378, 192]"
283,3,2617,6482,4840,0,1805,812,"[160, 77, 230, 0, 225, 142, 203, 94, 101, 179, 146, 117, 229, 6, 7, 170, 79, 74, 139, 110, 97, 220, 139, 94, 186, 181, 60]"
284,3,1754,1375,5219,0,491,1263,"[282, 64, 419, 0, 244, 125, 214, 136, 168, 395, 39, 334, 296, 196, 347, 174, 235, 355, 416, 183, 16, 322, 182, 333, 131, 380, 121]"
285,3,1539,15,6743,0,233,1306,"[311, 355, 354, 0, 12, 380, 408, 179, 317, 210, 234, 430, 338, 400, 162, 389, 55, 256, 221, 181, 129, 323, 377, 336, 130, 20, 414]"
286,3,2838,2617,6964,0,2776,62,"[1, 11, 4, 0, 3, 18, 8, 15, 13, 1, 0, 10, 0, 3, 0, 11, 14, 6, 19, 12, 13, 16, 9, 5, 17, 7, 7]"
287,3,2300,250,9014,0,1821,479,"[156, 42, 77, 0, 74, 34, 119, 54, 120, 78, 4, 54, 66, 8, 17, 89, 145, 150, 8, 3, 45, 49, 34, 86, 46, 71, 117]"
288,3,2840,6189,5665,0,1746,1094,"[39, 354, 174, 0, 15, 335, 207, 194, 313, 237, 278, 33, 141, 331, 247, 210, 107, 62, 23, 246, 63, 65, 119, 138, 33, 210, 213]"
289,3,2054,85,7634,0,1720,334,"[64, 49, 14, 0, 94, 50, 24, 44, 10, 14, 107, 58, 108, 110, 69, 55, 93, 92, 50, 67, 28, 109, 55, 17, 7, 66, 56]"
290,3,1343,1053,7924,0,185,1158,"[167, 380, 193, 0, 114, 248, 3, 51, 268, 48, 290, 168, 18, 54, 131, 326, 10, 177, 162, 368, 159, 377, 285, 281, 7, 36, 313]"
291,3,2975,2313,8586,0,372,2603,"[119, 588, 16, 0, 128, 307, 298, 144, 48, 309, 55, 777, 690, 195, 604, 802, 78, 101, 128, 854, 757, 774, 835, 204, 637, 439, 208]"
292,3,2545,6921,4210,0,1996,549,"[148, 139, 13, 0, 75, 101, 117, 37, 38, 40, 67, 4, 3, 148, 174, 161, 111, 58, 16, 17, 142, 115, 62, 51, 6, 68, 0]"
293,3,2024,1382,4852,0,1475,549,"[124, 81, 38, 0, 28, 156, 105, 144, 170, 65, 87, 60, 58, 134, 33, 163, 95, 15, 165, 25, 84, 1, 59, 47, 66, 95, 101]"
294,3,1314,1033,5133,0,121,1193,"[347, 90, 343, 0, 357, 197, 97, 175, 141, 84, 114, 300, 307, 79, 11, 138, 311, 97, 207, 221, 266, 298, 395, 339, 191, 80, 69]"
295,3,2100,408,6825,0,919,1181,"[163, 21, 246, 0, 187, 354, 64, 278, 20, 55, 28, 303, 239, 83, 25, 236, 79, 49, 112, 75, 80, 69, 117, 69, 159, 218, 157]"
296,3,1824,1772,6877,0,635,1189,"[318, 196, 224, 0, 376, 121, 190, 351, 81, 145, 354, 65, 331, 204, 219, 259, 260, 310, 87, 2, 32, 134, 368, 65, 382, 98, 395]"
297,3,2234,152,8959,0,1554,680,"[126, 152, 9, 0, 137, 34, 26, 176, 137, 73, 166, 166, 168, 91, 75, 204, 78, 156, 61, 187, 182, 133, 11, 199, 71, 150, 50]"
298,3,1369,374,9954,0,1277,92,"[18, 2, 11, 0, 19, 28, 12, 22, 5, 10, 7, 26, 23, 23, 4, 8, 24, 14, 28, 11, 24, 25, 12, 5, 24, 24, 6]"
299,3,2617,7302,5269,0,337,2280,"[592, 77, 1, 0, 76, 541, 231, 608, 467, 548, 343, 344, 33, 366, 746, 407, 730, 126, 20, 278, 747, 288, 113, 685, 378, 137, 469]"
0,4,5839,0,5839,0,4842,997,"[249, 155, 2, 325, 0, 88, 234, 195, 246, 73, 209, 69, 233, 63, 8, 91, 60, 17, 33, 18, 54, 26, 302, 239, 219, 168, 40, 317]"
1,4,6291,6212,5918,0,4629,1662,"[344, 92, 404, 475, 0, 324, 20, 38, 282, 257, 104, 326, 331, 487, 363, 310, 387, 457, 444, 292, 467, 363, 408, 510, 507, 158, 409, 211]"
2,4,6638,5671,6885,0,4534,2104,"[562, 322, 451, 467, 0, 45, 632, 200, 689, 551, 559, 521, 100, 344, 300, 151, 52, 70, 14, 413, 593, 404, 423, 441, 172, 244, 698, 598]"
3,4,6714,6566,7033,0,4236,2478,"[513, 755, 315, 445, 0, 244, 345, 529, 508, 69, 59, 598, 167, 77, 662, 539, 351, 18, 261, 773, 246, 469, 714, 161, 101, 767, 777, 425]"
4,4,5029,5292,6770,0,718,4311,"[663, 159, 18, 723, 0, 947, 189, 1256, 560, 1385, 834, 763, 715, 1427, 331, 790, 1202, 369, 256, 206, 139, 453, 807, 215, 525, 748, 3, 139]"
5,4,6265,6083,6952,0,5442,823,"[196, 271, 44, 169, 0, 265, 248, 81, 111, 2, 16, 261, 234, 46, 29, 68, 32, 63, 209, 211, 231, 25, 4, 52, 58, 239, 148, 226]"
6,4,5831,6910,5873,0,2905,2926,"[698, 99, 507, 743, 0, 530, 928, 775, 129, 877, 800, 517, 494, 745, 907, 9, 221, 768, 869, 634, 163, 906, 98, 951, 418, 780, 128, 394]"
7,4,5858,6915,4816,0,4375,1483,"[44, 245, 304, 132, 0, 427, 260, 392, 377, 213, 464, 271, 41, 266, 260, 223, 210, 179, 81, 190, 109, 392, 360, 396, 261, 124, 461, 157]"
8,4,6753,7481,4088,0,564,6189,"[237, 1919, 698, 66, 0, 1662, 85, 501, 243, 673, 36, 1121, 426, 1933, 1960, 1263, 1007, 995, 1293, 244, 1724, 1141, 1665, 293, 698, 876, 1831, 1682]"
9,4,6066,3235,6919,0,4470,1596,"[240, 418, 382, 472, 0, 17, 410, 94, 24, 213, 133, 369, 174, 126, 491, 428, 117, 412, 327, 90, 10, 85, 351, 93, 28, 368, 146, 327]"
10,4,6615,5952,7582,0,3886,2729,"[405, 849, 76, 874, 0, 648, 664, 396, 156, 25, 672, 44, 8, 832, 30, 712, 10, 126, 712, 30, 378, 69, 581, 504, 323, 509, 868, 856]"
11,4,5906,6096,7392,0,1395,4511,"[1003, 388, 643, 1457, 0, 143, 77, 618, 931, 833, 207, 1185, 527, 544, 60, 568, 324, 98, 157, 1115, 1178, 487, 940, 1192, 737, 1235, 1152, 354]"
12,4,6818,5402,8808,0,3889,2929,"[884, 69, 29, 915, 0, 688, 831, 155, 297, 288, 466, 277, 362, 93, 533, 10, 404, 78, 887, 660, 262, 118, 783, 640, 538, 372, 717, 875]"
13,4,5983,6800,7991,0,3590,2393,"[82, 331, 3, 673, 0, 538, 17, 639, 218, 724, 237, 472, 81, 549, 728, 47, 246, 737, 99, 203, 644, 358, 623, 176, 244, 553, 221, 225]"
14,4,6837,6574,8254,0,1064,5773,"[1647, 493, 1197, 404, 0, 757, 1227, 899, 1710, 672, 1730, 15, 757, 1588, 679, 1840, 614, 136, 674, 102, 1785, 271, 1900, 523, 1061, 467, 1921, 153]"
15,4,5288,5157,8385,0,941,4347,"[63, 1, 226, 1325, 0, 338, 200, 1436, 1395, 901, 533, 175, 1244, 320, 708, 1015, 1172, 1409, 1051, 976, 298, 1205, 1242, 410, 1131, 556, 178, 316]"
16,4,6209,5521,9073,0,4140,2069,"[331, 7, 304, 470, 0, 266, 663, 291, 385, 524, 365, 358, 254, 192, 515, 417, 182, 272, 136, 44, 155, 251, 64, 116, 49, 451, 596, 34]"
17,4,6335,5405,10000,3,3136,3199,"[456, 412, 498, 770, 0, 788, 198, 830, 802, 321, 435, 507, 1065, 815, 649, 25, 561, 377, 659, 192, 93, 139, 565, 521, 1050, 4, 895, 373]"
18,4,5957,7310,8647,0,5328,629,"[37, 93, 21, 150, 0, 15, 128, 58, 125, 66, 140, 154, 168, 206, 46, 94, 123, 197, 62, 113, 155, 190, 111, 180, 69, 116, 5, 37]"
19,4,6132,7392,7387,0,3224,2908,"[747, 846, 764, 797, 0, 599, 469, 812, 326, 920, 206, 112, 746, 414, 853, 459, 876, 113, 454, 565, 502, 314, 557, 241, 765, 20, 671, 917]"
20,4,6386,7367,6406,0,3473,2913,"[249, 496, 277, 192, 0, 224, 358, 787, 756, 101, 264, 109, 784, 123, 877, 460, 143, 504, 646, 823, 97, 472, 364, 51, 144, 495, 406, 910]"
21,4,5490,7498,4398,0,1941,3549,"[867, 463, 424, 307, 0, 1005, 549, 1083, 588, 853, 496, 1183, 1161, 1070, 407, 975, 992, 777, 569, 378, 563, 1143, 820, 1131, 1016, 107, 388, 302]"
22,4,5893,4101,6190,0,574,5319,"[68, 615, 1, 1645, 0, 1675, 195, 576, 527, 844, 1524, 285, 377, 378, 381, 931, 322, 1134, 854, 149, 1164, 11, 634, 1487, 1214, 557, 314, 520]"
23,4,5614,5117,6687,0,4518,1096,"[234, 85, 290, 114, 0, 144, 154, 63, 257, 190, 62, 122, 292, 192, 152, 100, 295, 96, 340, 99, 10, 103, 336, 171, 337, 49, 252, 135]"
24,4,5037,5227,6497,0,3340,1697,"[36, 186, 447, 331, 0, 224, 30, 267, 340, 347, 5, 162, 334, 108, 494, 264, 70, 514, 264, 176, 167, 128, 320, 103, 439, 246, 253, 506]"
25,4,5042,7184,4355,0,2418,2624,"[140, 239, 292, 672, 0, 117, 610, 36, 286, 176, 227, 69, 263, 305, 434, 112, 263, 804, 639, 707, 306, 355, 457, 642, 413, 530, 65, 267]"
26,4,5254,1171,8438,0,3227,2027,"[9, 591, 352, 34, 0, 522, 232, 36, 339, 147, 356, 122, 300, 417, 571, 428, 312, 323, 355, 572, 330, 265, 666, 582, 353, 326, 464, 355]"
27,4,6786,6341,8883,0,184,6602,"[1713, 2056, 2095, 1446, 0, 1107, 1057, 1310, 687, 260, 568, 146, 408, 8, 30, 1151, 530, 49, 157, 275, 1137, 1439, 970, 2028, 1225, 2143, 877, 786]"
28,4,6827,7281,8429,0,3143,3684,"[625, 760, 872, 6, 0, 492, 380, 1160, 1172, 1015, 506, 1104, 209, 890, 199, 1111, 664, 1127, 766, 728, 625, 606, 847, 0, 753, 749, 698, 44]"
29,4,5878,6750,7557,0,4740,1138,"[36, 254, 218, 363, 0, 171, 33, 222, 350, 8, 354, 173, 199, 137, 194, 201, 283, 208, 36, 187, 170, 325, 121, 119, 224, 73, 358, 27]"
30,4,6411,6992,6976,0,760,5651,"[1050, 657, 1231, 518, 0, 1097, 1591, 1689, 38, 658, 1452, 1132, 224, 1646, 706, 1485, 373, 1036, 1366, 762, 1154, 1632, 10, 311, 1183, 166, 230, 1687]"
31,4,6161,6364,6773,0,3256,2905,"[533, 641, 141, 67, 0, 72, 97, 354, 19, 122, 345, 905, 334, 137, 624, 640, 867, 835, 636, 462, 167, 955, 11, 606, 843, 493, 601, 383]"
32,4,6778,5759,7792,0,209,6569,"[1668, 298, 309, 60, 0, 135, 1028, 2181, 307, 461, 1821, 51, 1464, 1466, 1715, 1982, 293, 342, 1508, 1356, 631, 458, 302, 587, 2093, 2153, 877, 1257]"
33,4,5049,5158,7683,0,3392,1657,"[320, 326, 190, 154, 0, 106, 137, 307, 256, 135, 480, 132, 530, 9, 303, 403, 348, 277, 456, 192, 26, 294, 426, 228, 329, 406, 457, 270]"
34,4,5283,5626,7340,0,1790,3493,"[86, 471, 562, 36, 0, 336, 186, 213, 512, 1138, 1101, 188, 297, 865, 952, 11, 49, 880, 515, 644, 1133, 153, 667, 10, 565, 802, 402, 718]"
35,4,5496,5956,6880,0,3300,2196,"[477, 126, 705, 624, 0, 447, 53, 404, 708, 394, 696, 28, 517, 40, 111, 411, 45, 709, 460, 115, 457, 228, 265, 683, 496, 545, 504, 8]"
36,4,5092,6638,5334,0,3593,1499,"[492, 355, 194, 188, 0, 105, 237, 343, 384, 336, 213, 430, 350, 437, 45, 367, 316, 210, 132, 181, 161, 202, 71, 496, 153, 123, 113, 470]"
37,4,6550,6860,5024,0,1904,4646,"[1464, 384, 108, 588, 0, 554, 825, 479, 530, 363, 849, 1268, 106, 140, 92, 122, 404, 229, 926, 223, 1201, 185, 766, 1188, 670, 285, 1367, 409]"
38,4,5663,3388,7299,0,4743,920,"[300, 177, 102, 221, 0, 162, 220, 157, 306, 87, 155, 267, 172, 267, 139, 118, 109, 28, 145, 171, 152, 35, 290, 96, 64, 66, 4, 212]"
39,4,6659,7352,6606,0,4774,1885,"[194, 579, 174, 508, 0, 474, 600, 189, 528, 594, 368, 494, 266, 186, 474, 159, 284, 23, 505, 421, 280, 12, 91, 117, 429, 424, 180, 306]"
40,4,5137,5428,6315,0,3534,1603,"[451, 251, 293, 170, 0, 473, 165, 433, 220, 472, 91, 150, 351, 395, 28, 330, 416, 308, 323, 148, 437, 303, 391, 207, 514, 213, 450, 418]"
41,4,5226,7236,4305,0,378,4848,"[1303, 1442, 1584, 1493, 0, 189, 35, 1010, 5, 917, 822, 1044, 625, 3, 122, 794, 1385, 443, 714, 1366, 1079, 1384, 260, 1062, 1365, 1563, 1105, 564]"
42,4,5586,2433,7458,0,4392,1194,"[15, 76, 254, 295, 0, 88, 218, 118, 77, 147, 161, 110, 238, 16, 63, 49, 3, 324, 247, 216, 245, 335, 128, 18, 37, 26, 256, 376]"
43,4,5755,6183,7030,0,3243,2512,"[368, 677, 404, 210, 0, 18, 120, 558, 226, 764, 487, 750, 398, 483, 610, 739, 297, 579, 657, 820, 340, 721, 681, 600, 142, 106, 562, 487]"
44,4,6932,6552,7410,0,4452,2480,"[371, 506, 404, 519, 0, 452, 823, 802, 294, 368, 245, 510, 457, 306, 653, 743, 149, 200, 268, 681, 692, 139, 261, 300, 582, 610, 40, 53]"
45,4,6759,6563,7606,0,2806,3953,"[408, 29, 882, 565, 0, 894, 450, 360, 404, 557, 1100, 1172, 366, 553, 836, 250, 988, 960, 926, 212, 531, 1282, 606, 1128, 856, 838, 890, 5]"
46,4,6328,6618,7316,0,869,5459,"[527, 702, 210, 1761, 0, 1289, 1030, 677, 646, 1220, 847, 1205, 986, 804, 238, 69, 532, 157, 1474, 339, 528, 1797, 1460, 1699, 1188, 1600, 1107, 230]"
47,4,5347,6621,6042,0,3012,2335,"[617, 245, 537, 322, 0, 766, 183, 722, 331, 549, 647, 171, 236, 537, 609, 510, 527, 447, 556, 651, 752, 436, 697, 293, 151, 763, 293, 675]"
48,4,6910,5156,7796,0,4026,2884,"[121, 803, 227, 141, 0, 68, 600, 98, 816, 37, 260, 878, 446, 568, 390, 245, 692, 720, 818, 308, 703, 614, 907, 949, 910, 356, 184, 165]"
49,4,5135,5560,7371,0,887,4248,"[494, 505, 473, 276, 0, 566, 961, 360, 545, 1126, 782, 918, 1334, 234, 953, 870, 1155, 125, 648, 6, 820, 668, 1383, 1238, 879, 1139, 170, 1089]"
50,4,6638,5359,8650,0,2725,3913,"[621, 651, 976, 964, 0, 1275, 610, 1271, 80, 294, 944, 179, 1108, 99, 1285, 350, 1208, 766, 303, 388, 270, 785, 911, 976, 1008, 928, 787, 108]"
51,4,5356,6577,7429,0,55,5301,"[587, 1138, 1720, 640, 0, 1215, 538, 177, 1538, 59, 1758, 1204, 769, 1412, 1673, 3, 1076, 1718, 752, 1145, 333, 349, 1566, 1648, 1458, 797, 444, 842]"
52,4,6883,5398,8914,0,2306,4577,"[466, 1390, 120, 754, 0, 720, 907, 755, 177, 222, 1052, 559, 1432, 840, 497, 603, 1130, 1471, 1047, 452, 875, 912, 261, 779, 853, 105, 505, 123]"
53,4,5178,6042,8050,0,4741,437,"[45, 60, 87, 104, 0, 71, 63, 126, 85, 85, 50, 137, 47, 118, 119, 124, 13, 87, 89, 117, 42, 74, 28, 18, 53, 111, 91, 126]"
54,4,6044,7230,6864,0,904,5140,"[1522, 1286, 1536, 1209, 0, 347, 235, 560, 814, 621, 1651, 1693, 1465, 613, 1069, 492, 1106, 1094, 515, 1088, 1365, 1131, 1633, 1343, 684, 1522, 1634, 1056]"
55,4,5120,5005,6979,0,4019,1101,"[102, 298, 239, 125, 0, 42, 156, 166, 83, 148, 310, 178, 206, 270, 314, 65, 289, 341, 245, 133, 327, 164, 0, 201, 96, 226, 237, 160]"
56,4,5349,7273,5055,0,2493,2856,"[355, 939, 627, 927, 0, 526, 734, 938, 640, 13, 333, 835, 443, 58, 858, 27, 948, 509, 851, 235, 639, 103, 758, 511, 800, 408, 627, 304]"
57,4,6537,5843,5749,0,6026,511,"[97, 42, 114, 24, 0, 74, 156, 85, 14, 134, 11, 167, 147, 163, 64, 121, 73, 28, 138, 18, 122, 159, 55, 149, 106, 11, 63, 122]"
58,4,6723,5275,7197,0,1413,5310,"[1042, 289, 682, 723, 0, 444, 423, 1276, 1628, 220, 476, 86, 911, 1362, 641, 206, 1675, 1398, 496, 846, 793, 1544, 889, 1766, 672, 637, 824, 498]"
59,4,6020,7473,5744,0,3857,2163,"[639, 318, 152, 345, 0, 644, 405, 604, 76, 689, 75, 517, 137, 611, 668, 118, 503, 143, 579, 646, 460, 660, 82, 314, 148, 73, 538, 61]"
60,4,6327,7015,5056,0,3267,3060,"[734, 476, 985, 628, 0, 540, 291, 474, 829, 171, 326, 890, 754, 909, 758, 365, 124, 840, 253, 482, 514, 199, 578, 957, 112, 160, 842, 370]"
61,4,6655,5556,6155,0,1107,5548,"[1293, 795, 567, 1126, 0, 46, 49, 353, 750, 522, 1259, 335, 966, 572, 1156, 1273, 1425, 1143, 380, 846, 1812, 1306, 60, 310, 839, 1399, 1836, 940]"
62,4,6068,6326,5897,0,239,5829,"[1110, 49, 72, 589, 0, 131, 1380, 274, 688, 517, 1673, 1680, 1651, 1615, 206, 710, 1412, 1105, 1721, 512, 903, 1260, 1415, 1639, 188, 683, 708, 1396]"
63,4,5444,7154,4187,0,2331,3113,"[641, 278, 820, 150, 0, 880, 394, 510, 903, 327, 370, 492, 487, 667, 651, 96, 911, 1, 496, 162, 519, 10, 954, 140, 135, 476, 471, 815]"
64,4,5926,4936,5177,0,5142,784,"[74, 113, 258, 257, 0, 74, 164, 36, 44, 241, 192, 99, 171, 115, 165, 197, 170, 228, 23, 220, 159, 112, 111, 233, 124, 76, 201, 245]"
65,4,5311,4571,5917,0,4816,495,"[68, 137, 105, 22, 0, 14, 112, 119, 155, 34, 146, 96, 75, 104, 143, 108, 54, 150, 164, 157, 44, 64, 79, 7, 85, 149, 113, 52]"
66,4,5309,5508,5718,0,4242,1067,"[204, 141, 238, 276, 0, 193, 63, 280, 189, 10, 186, 7, 238, 329, 114, 175, 263, 2, 106, 137, 148, 102, 28, 53, 10, 247, 215, 99]"
67,4,5344,6526,4536,0,2299,3045,"[805, 898, 334, 1000, 0, 780, 79, 434, 770, 574, 842, 828, 952, 637, 599, 372, 651, 412, 64, 408, 295, 2, 610, 673, 630, 289, 291, 415]"
68,4,6800,6551,4785,0,5278,1522,"[169, 185, 420, 497, 0, 39, 4, 504, 340, 391, 125, 8, 368, 116, 507, 114, 38, 316, 49, 145, 216, 357, 212, 80, 114, 331, 348, 234]"
69,4,5721,5097,5409,0,5068,653,"[38, 75, 60, 23, 0, 122, 195, 166, 133, 199, 151, 142, 15, 217, 123, 151, 148, 158, 49, 57, 214, 31, 123, 177, 136, 48, 72, 174]"
70,4,6765,5140,7034,0,4485,2280,"[19, 688, 394, 691, 0, 187, 320, 519, 284, 536, 550, 375, 120, 743, 16, 172, 293, 755, 745, 555, 518, 446, 234, 109, 555, 19, 667, 98]"
71,4,5483,6700,5817,0,1730,3753,"[200, 53, 287, 2, 0, 783, 725, 757, 983, 500, 1102, 880, 590, 895, 1194, 994, 687, 361, 1113, 614, 386, 53, 540, 947, 609, 644, 850, 191]"
72,4,5943,6369,5391,0,2462,3481,"[876, 199, 415, 1053, 0, 836, 606, 514, 894, 176, 1058, 339, 507, 47, 685, 454, 476, 1008, 767, 1110, 460, 686, 6, 873, 99, 866, 348, 1007]"
73,4,5479,4783,6087,0,1662,3817,"[781, 912, 674, 82, 0, 673, 462, 1170, 1146, 58, 480, 1243, 819, 1060, 191, 841, 316, 825, 679, 329, 326, 721, 1132, 1164, 1272, 1165, 533, 847]"
74,4,5817,5884,6020,0,2625,3192,"[781, 495, 340, 239, 0, 410, 30, 144, 432, 902, 508, 310, 416, 628, 417, 1022, 791, 289, 4, 902, 433, 808, 6, 959, 22, 474, 957, 1025]"
75,4,6937,5234,7723,0,1737,5200,"[104, 1717, 869, 352, 0, 818, 573, 811, 538, 543, 152, 1168, 1418, 589, 242, 1034, 192, 319, 336, 1035, 296, 727, 1443, 900, 398, 28, 1093, 273]"
76,4,5546,5244,8025,0,3067,2479,"[818, 402, 72, 1, 0, 410, 314, 284, 487, 605, 358, 345, 608, 660, 148, 656, 554, 724, 572, 758, 307, 319, 232, 634, 755, 720, 661, 215]"
77,4,6948,5242,9731,0,4211,2737,"[596, 772, 487, 816, 0, 204, 11, 394, 508, 662, 466, 752, 281, 493, 83, 641, 536, 297, 83, 52, 534, 266, 55, 2, 320, 119, 408, 88]"
78,4,5923,6171,9483,0,764,5159,"[797, 399, 758, 1029, 0, 658, 601, 39, 224, 1141, 1033, 1608, 410, 1006, 244, 489, 886, 618, 780, 1389, 827, 266, 550, 1500, 1365, 413, 905, 407]"
79,4,6955,6152,10000,286,1685,5270,"[15, 401, 503, 875, 0, 1229, 1647, 124, 1490, 1540, 1578, 262, 945, 81, 106, 1258, 1705, 918, 1482, 580, 218, 833, 47, 1057, 818, 192, 821, 746]"
80,4,6651,7481,9170,0,1761,4890,"[376, 381, 680, 904, 0, 1044, 198, 748, 837, 1371, 815, 1196, 817, 809, 1392, 904, 479, 431, 690, 449, 1366, 1541, 613, 804, 264, 918, 218, 924]"
81,4,5495,6068,8597,0,4251,1244,"[72, 260, 238, 13, 0, 101, 195, 316, 385, 357, 267, 114, 109, 150, 412, 206, 169, 362, 314, 345, 181, 352, 193, 75, 398, 398, 395, 202]"
82,4,6661,6202,9056,0,5172,1489,"[468, 347, 354, 164, 0, 412, 347, 392, 239, 252, 360, 36, 91, 172, 144, 136, 398, 386, 281, 39, 396, 2, 287, 209, 496, 200, 260, 226]"
83,4,6426,6234,9248,0,2279,4147,"[607, 69, 1137, 528, 0, 1118, 796, 81, 544, 253, 337, 170, 1016, 758, 1020, 84, 181, 456, 576, 120, 1289, 551, 1115, 901, 1234, 184, 1031, 271]"
84,4,6804,7320,8732,0,3361,3443,"[1034, 489, 579, 457, 0, 1051, 696, 288, 687, 1004, 816, 990, 417, 438, 484, 832, 1113, 304, 1032, 674, 210, 693, 828, 505, 416, 594, 217, 21]"
85,4,5675,6275,8132,0,2418,3257,"[382, 651, 106, 268, 0, 286, 340, 574, 360, 1004, 372, 825, 797, 196, 583, 285, 564, 18, 740, 799, 964, 200, 775, 747, 425, 263, 634, 190]"
86,4,5918,5928,8122,0,3761,2157,"[388, 604, 112, 705, 0, 37, 26, 7, 538, 584, 620, 328, 195, 285, 147, 19, 514, 376, 507, 471, 417, 709, 9, 684, 303, 69, 486, 100]"
87,4,6272,7414,6980,0,4469,1803,"[525, 32, 500, 240, 0, 225, 384, 194, 25, 202, 413, 229, 80, 347, 265, 64, 319, 464, 73, 302, 62, 507, 516, 37, 311, 465, 377, 16]"
88,4,6635,7104,6511,0,5931,704,"[118, 198, 1, 79, 0, 66, 29, 72, 195, 35, 99, 166, 223, 18, 8, 94, 145, 131, 44, 48, 61, 220, 108, 142, 55, 26, 4, 10]"
89,4,6162,5150,7523,0,258,5904,"[1547, 1960, 1323, 1934, 0, 1481, 1383, 262, 1866, 688, 1927, 1660, 1868, 1225, 269, 1488, 1316, 1841, 400, 963, 258, 1309, 783, 1754, 1696, 1666, 38, 312]"
90,4,6967,5421,9069,0,6237,730,"[166, 97, 238, 202, 0, 207, 91, 195, 21, 77, 77, 53, 34, 51, 15, 163, 92, 154, 193, 210, 39, 36, 49, 12, 172, 87, 224, 124]"
91,4,5799,5542,9326,0,5745,54,"[8, 12, 0, 17, 0, 7, 18, 7, 15, 18, 5, 5, 10, 12, 18, 18, 14, 9, 7, 6, 2, 3, 6, 15, 0, 5, 16, 6]"
92,4,5411,7099,7638,0,4373,1038,"[324, 171, 277, 150, 0, 342, 259, 245, 224, 254, 317, 128, 236, 90, 136, 34, 1, 335, 227, 315, 207, 125, 176, 191, 167, 156, 255, 256]"
93,4,6364,6290,7712,0,3293,3071,"[155, 16, 297, 288, 0, 757, 817, 633, 47, 739, 781, 699, 817, 699, 949, 920, 928, 967, 550, 478, 655, 730, 405, 746, 195, 71, 695, 1020]"
94,4,5868,6688,6892,0,3693,2175,"[580, 288, 381, 52, 0, 428, 394, 373, 269, 681, 130, 274, 660, 83, 375, 408, 544, 245, 308, 512, 530, 86, 50, 617, 645, 513, 570, 697]"
95,4,6548,5523,7917,0,31,6517,"[1906, 267, 1856, 1584, 0, 108, 1971, 2086, 372, 321, 977, 874, 750, 2001, 1459, 189, 1110, 1885, 1066, 1618, 1191, 602, 347, 1615, 396, 2158, 544, 1153]"
96,4,5412,6781,6548,0,1505,3907,"[1196, 303, 33, 165, 0, 763, 876, 537, 735, 330, 881, 401, 857, 355, 381, 150, 346, 316, 630, 762, 607, 372, 950, 848, 98, 1000, 196, 127]"
97,4,5159,6896,4811,0,335,4824,"[1567, 1035, 135, 679, 0, 1524, 1206, 689, 163, 622, 11, 1041, 386, 1078, 1564, 460, 1159, 1523, 1261, 566, 1302, 1428, 568, 900, 1424, 145, 106, 1322]"
98,4,6165,5532,5444,0,716,5449,"[305, 140, 180, 1063, 0, 462, 163, 1522, 1765, 814, 1010, 1270, 15, 89, 1012, 1502, 37, 1539, 1241, 1036, 556, 533, 103, 1723, 114, 1757, 1303, 1627]"
99,4,5511,1,10000,954,3159,2352,"[530, 430, 202, 260, 0, 781, 288, 644, 50, 49, 413, 299, 404, 449, 144, 346, 211, 131, 639, 703, 328, 385, 253, 495, 236, 266, 418, 724]"
100,4,5328,7292,8036,0,1022,4306,"[1330, 974, 639, 36, 0, 1019, 1371, 1008, 1027, 802, 328, 678, 630, 157, 283, 414, 1046, 1137, 1149, 205, 391, 565, 1138, 842, 1281, 872, 1031, 948]"
101,4,6368,6492,7912,0,2334,4034,"[507, 809, 353, 549, 0, 287, 718, 418, 833, 115, 635, 1026, 5, 267, 378, 884, 1108, 510, 815, 1274, 859, 670, 331, 1200, 204, 376, 992, 179]"
102,4,6901,7169,7644,0,1951,4950,"[421, 758, 1279, 1126, 0, 1352, 939, 394, 223, 1633, 456, 908, 183, 993, 243, 678, 271, 838, 125, 1128, 802, 1471, 1043, 858, 1591, 813, 163, 716]"
103,4,5644,7058,6230,0,3388,2256,"[368, 679, 560, 580, 0, 706, 484, 632, 525, 436, 226, 635, 582, 446, 739, 142, 660, 196, 111, 184, 566, 64, 573, 384, 82, 138, 457, 305]"
104,4,6700,6070,6860,0,1038,5662,"[702, 454, 1280, 256, 0, 1577, 594, 937, 1728, 1643, 1016, 1616, 1638, 110, 859, 59, 279, 716, 1403, 1599, 690, 1244, 1214, 1289, 955, 359, 1773, 593]"
105,4,5786,7138,5508,0,5128,658,"[46, 18, 154, 135, 0, 179, 111, 16, 9, 78, 215, 110, 54, 14, 165, 10, 57, 117, 47, 104, 5, 1, 111, 21, 185, 36, 141, 93]"
106,4,6467,6171,5804,0,5076,1391,"[461, 359, 229, 313, 0, 4, 285, 189, 3, 274, 156, 260, 125, 2, 199, 188, 232, 208, 265, 71, 324, 437, 25, 399, 356, 187, 169, 240]"
107,4,5261,5614,5451,0,148,5113,"[264, 1012, 1201, 634, 0, 1623, 234, 770, 213, 1562, 1210, 212, 705, 1680, 1350, 1352, 1507, 488, 1563, 837, 1303, 361, 99, 196, 856, 962, 1096, 1686]"
108,4,5489,1501,9439,0,1415,4074,"[707, 1000, 431, 146, 0, 836, 514, 1058, 1323, 966, 980, 1144, 172, 957, 1154, 517, 811, 195, 1167, 357, 129, 301, 1197, 544, 31, 1259, 981, 773]"
109,4,5398,6208,8629,0,5317,81,"[4, 22, 3, 22, 0, 19, 13, 14, 5, 12, 13, 24, 14, 27, 10, 23, 18, 23, 24, 10, 18, 18, 12, 21, 4, 16, 4, 8]"
110,4,6013,5993,8649,0,5332,681,"[208, 107, 131, 164, 0, 181, 120, 125, 1, 104, 25, 1, 136, 33, 221, 130, 96, 156, 170, 175, 32, 41, 61, 216, 131, 104, 98, 0]"
111,4,5777,5616,8810,0,5687,90,"[7, 0, 23, 24, 0, 16, 13, 9, 15, 23, 20, 7, 16, 2, 3, 24, 22, 13, 2, 18, 12, 4, 24, 17, 21, 11, 16, 26]"
112,4,5384,5329,8865,0,2226,3158,"[704, 677, 845, 787, 0, 330, 86, 62, 675, 50, 692, 949, 458, 708, 131, 64, 89, 906, 177, 389, 501, 422, 37, 832, 270, 181, 568, 328]"
113,4,5263,5839,8289,0,621,4642,"[1294, 473, 1007, 1118, 0, 68, 1168, 377, 708, 433, 1299, 111, 910, 1412, 717, 477, 1416, 658, 597, 383, 1409, 872, 247, 132, 613, 1403, 1216, 1025]"
114,4,5382,5086,8585,0,924,4458,"[1140, 1160, 658, 1180, 0, 1397, 1418, 1324, 323, 910, 918, 1126, 773, 698, 830, 683, 1321, 542, 1337, 23, 846, 917, 563, 745, 680, 1309, 1391, 1259]"
115,4,6624,7466,7743,0,3715,2909,"[90, 774, 657, 366, 0, 620, 527, 758, 282, 370, 407, 920, 116, 69, 543, 856, 574, 586, 127, 28, 934, 228, 317, 769, 180, 902, 212, 15]"
116,4,5951,7116,6578,0,1213,4738,"[1063, 88, 1424, 416, 0, 268, 153, 354, 1232, 983, 1036, 148, 1503, 1038, 1314, 847, 942, 1372, 876, 1138, 454, 520, 305, 1202, 285, 1242, 1202, 1196]"
117,4,6685,5226,8037,0,1775,4910,"[1211, 1580, 1631, 349, 0, 1141, 1389, 221, 640, 517, 555, 422, 247, 128, 566, 308, 525, 1113, 329, 850, 494, 461, 1187, 611, 351, 212, 71, 54]"
118,4,6013,6692,7358,0,1252,4761,"[1002, 801, 824, 724, 0, 748, 35, 125, 1478, 614, 738, 921, 858, 684, 692, 781, 70, 1326, 85, 1181, 465, 203, 397, 243, 1172, 872, 1544, 1389]"
119,4,6810,5317,8851,0,1784,5026,"[272, 10, 250, 954, 0, 129, 638, 1130, 843, 650, 252, 1431, 1508, 555, 1278, 135, 1205, 667, 1145, 660, 169, 1449, 828, 1596, 598, 1563, 982, 397]"
120,4,6174,5723,9302,0,4911,1263,"[234, 307, 258, 243, 0, 251, 197, 380, 6, 334, 260, 337, 295, 290, 56, 208, 76, 402, 335, 290, 181, 155, 44, 298, 390, 72, 186, 170]"
121,4,6257,7464,8095,0,3289,2968,"[251, 307, 861, 358, 0, 328, 469, 190, 668, 857, 91, 581, 374, 14, 916, 859, 243, 620, 463, 463, 864, 286, 631, 621, 535, 137, 591, 641]"
122,4,5684,6990,6789,0,1098,4586,"[268, 874, 1268, 112, 0, 82, 976, 1521, 275, 657, 1452, 1342, 458, 758, 917, 797, 173, 58, 443, 1253, 1430, 1468, 417, 1442, 1419, 169, 501, 273]"
123,4,5942,6641,6090,0,1062,4880,"[243, 522, 19, 243, 0, 1413, 501, 511, 1157, 237, 618, 1463, 1329, 11, 1017, 229, 1209, 1428, 163, 1566, 358, 729, 1553, 36, 719, 1395, 1495, 729]"
124,4,6875,6281,6684,0,1777,5098,"[657, 65, 1215, 1083, 0, 1562, 1647, 256, 295, 1098, 376, 1545, 1330, 254, 1537, 560, 434, 1256, 1197, 1528, 778, 1276, 1015, 351, 641, 1689, 99, 1132]"
125,4,6684,5731,7637,0,3808,2876,"[709, 641, 416, 709, 0, 422, 67, 810, 55, 168, 659, 910, 447, 537, 919, 436, 504, 354, 511, 85, 505, 122, 862, 815, 103, 681, 699, 577]"
126,4,6851,7311,7177,0,276,6575,"[1104, 2011, 2010, 552, 0, 1510, 1435, 31, 1555, 610, 935, 804, 905, 1197, 1281, 591, 286, 719, 9, 2137, 2115, 1103, 30, 340, 1406, 806, 338, 263]"
127,4,5031,6249,5959,0,301,4730,"[911, 1175, 866, 670, 0, 1567, 1449, 385, 1530, 174, 1050, 930, 849, 1304, 619, 1018, 1169, 1139, 929, 500, 45, 1106, 85, 448, 1374, 213, 550, 661]"
128,4,6446,6653,5752,0,5065,1381,"[275, 324, 387, 193, 0, 138, 448, 294, 439, 366, 9, 244, 451, 324, 27, 203, 144, 277, 195, 85, 271, 74, 250, 363, 2, 80, 391, 402]"
129,4,5647,6423,4976,0,2234,3413,"[1126, 794, 79, 799, 0, 1072, 838, 1059, 696, 891, 332, 284, 497, 901, 294, 174, 738, 21, 690, 862, 321, 64, 783, 568, 994, 1016, 130, 846]"
130,4,6974,5728,6222,0,994,5980,"[1754, 1258, 1814, 153, 0, 984, 124, 1243, 1790, 1587, 744, 1071, 875, 654, 1693, 649, 1276, 1445, 1294, 984, 100, 782, 994, 437, 799, 1595, 1093, 1676]"
131,4,6047,7247,5022,0,1937,4110,"[541, 584, 392, 267, 0, 808, 684, 165, 43, 441, 929, 1129, 1017, 1000, 553, 1108, 797, 1191, 1045, 825, 1264, 1173, 460, 220, 192, 1357, 1042, 681]"
132,4,6418,5604,5836,0,164,6254,"[1096, 1851, 1102, 102, 0, 2033, 1947, 1951, 2012, 1411, 1381, 384, 1136, 326, 218, 638, 211, 202, 1124, 307, 753, 645, 1244, 889, 1559, 2008, 125, 1132]"
133,4,6947,5063,7720,0,3024,3923,"[1021, 1199, 177, 500, 0, 464, 663, 607, 457, 1268, 1256, 979, 582, 1194, 973, 757, 684, 197, 1086, 988, 965, 411, 328, 276, 95, 558, 626, 177]"
134,4,5717,6962,6475,0,3461,2256,"[82, 261, 721, 123, 0, 670, 401, 432, 624, 62, 500, 376, 222, 166, 401, 45, 185, 240, 35, 622, 355, 49, 229, 588, 299, 142, 103, 125]"
135,4,5504,6598,5381,0,4857,647,"[153, 53, 170, 76, 0, 32, 145, 169, 160, 86, 60, 102, 14, 210, 104, 45, 19, 195, 138, 13, 181, 113, 176, 7, 95, 60, 135, 20]"
136,4,5915,6319,4977,0,1700,4215,"[485, 645, 574, 825, 0, 411, 540, 1105, 778, 430, 1155, 168, 1304, 1298, 1202, 686, 399, 191, 29, 777, 351, 600, 1102, 1200, 817, 326, 671, 578]"
137,4,6344,6020,5301,0,4775,1569,"[412, 134, 51, 38, 0, 424, 84, 171, 6, 364, 103, 193, 35, 112, 88, 440, 491, 62, 116, 489, 71, 288, 336, 70, 461, 428, 220, 344]"
138,4,5640,4876,6065,0,5275,365,"[18, 63, 120, 65, 0, 62, 118, 113, 47, 31, 8, 112, 19, 96, 76, 36, 31, 79, 30, 88, 49, 62, 115, 58, 84, 5, 24, 53]"
139,4,6950,5064,7951,0,1530,5420,"[795, 661, 1781, 1104, 0, 1651, 894, 1351, 226, 479, 729, 1127, 1716, 602, 211, 1116, 1498, 221, 853, 1342, 1048, 718, 1450, 919, 1709, 739, 1434, 759]"
140,4,6252,6373,7830,0,2126,4126,"[62, 818, 1332, 505, 0, 1371, 829, 653, 831, 497, 272, 202, 384, 850, 1277, 109, 904, 836, 53, 488, 1028, 995, 1054, 79, 634, 939, 44, 822]"
141,4,6706,5328,9208,0,6679,27,"[0, 6, 6, 1, 0, 3, 3, 5, 6, 0, 5, 1, 4, 7, 9, 3, 4, 9, 4, 2, 2, 4, 8, 1, 6, 2, 4, 1]"
142,4,5030,5307,8931,0,1811,3219,"[827, 60, 680, 426, 0, 1027, 536, 438, 1005, 414, 424, 486, 618, 696, 512, 1011, 733, 624, 374, 1055, 300, 574, 129, 471, 578, 827, 662, 483]"
143,4,5911,7246,7596,0,941,4970,"[125, 182, 768, 1381, 0, 878, 444, 1651, 961, 1325, 991, 1468, 82, 1212, 191, 915, 1238, 1411, 164, 1111, 1545, 1250, 1351, 67, 988, 263, 963, 1492]"
144,4,5498,6340,6754,0,1878,3620,"[983, 130, 943, 419, 0, 203, 632, 204, 910, 471, 646, 1034, 706, 129, 932, 576, 381, 806, 91, 1188, 897, 404, 1131, 205, 323, 1138, 552, 896]"
145,4,5031,5351,6434,0,4290,741,"[192, 15, 139, 144, 0, 96, 204, 187, 25, 206, 36, 150, 48, 17, 101, 117, 45, 167, 164, 162, 166, 66, 205, 58, 221, 226, 171, 164]"
146,4,6647,5767,7314,0,2079,4568,"[934, 968, 638, 495, 0, 1415, 1056, 1017, 450, 1055, 270, 285, 855, 841, 119, 653, 385, 1084, 1370, 93, 339, 995, 624, 911, 1251, 961, 1361, 81]"
147,4,5482,5996,6800,0,395,5087,"[161, 1181, 1267, 769, 0, 1656, 1439, 1650, 1521, 1474, 558, 1485, 381, 1203, 1552, 673, 423, 973, 1366, 708, 197, 622, 1159, 1677, 377, 612, 519, 1119]"
148,4,5791,6645,5946,0,5521,270,"[15, 22, 90, 37, 0, 62, 0, 75, 73, 75, 3, 86, 34, 85, 28, 71, 52, 38, 57, 83, 25, 89, 58, 21, 6, 16, 76, 3]"
149,4,6804,7091,5659,0,1908,4896,"[1089, 1155, 681, 1205, 0, 772, 167, 293, 507, 1235, 1399, 1188, 699, 1603, 474, 384, 87, 691, 150, 312, 384, 911, 988, 350, 159, 1614, 1455, 926]"
150,4,6949,5752,6856,0,6194,755,"[168, 87, 243, 225, 0, 205, 187, 66, 226, 245, 192, 147, 99, 141, 250, 228, 105, 154, 180, 155, 59, 108, 75, 197, 115, 89, 191, 32]"
151,4,6506,7263,6099,0,3412,3094,"[111, 240, 866, 456, 0, 893, 678, 361, 1026, 377, 829, 747, 146, 759, 919, 191, 792, 530, 944, 578, 842, 719, 955, 86, 353, 507, 280, 259]"
152,4,5965,5967,6097,0,5592,373,"[40, 107, 56, 70, 0, 11, 15, 101, 83, 96, 77, 53, 116, 79, 20, 59, 19, 5, 21, 118, 98, 61, 18, 99, 103, 41, 16, 99]"
153,4,5121,6372,4846,0,2079,3042,"[70, 398, 140, 245, 0, 850, 118, 345, 208, 421, 645, 731, 431, 519, 951, 491, 755, 545, 639, 264, 468, 616, 932, 819, 406, 317, 322, 607]"
154,4,5971,2938,7879,0,2340,3631,"[781, 722, 745, 397, 0, 674, 467, 102, 688, 1098, 500, 962, 1036, 11, 720, 776, 318, 1162, 320, 150, 1063, 142, 387, 900, 702, 14, 160, 445]"
155,4,6891,5366,9404,0,3457,3434,"[1092, 788, 159, 1015, 0, 598, 490, 235, 897, 779, 359, 984, 49, 592, 293, 752, 630, 632, 12, 1130, 606, 160, 896, 799, 607, 1040, 715, 147]"
156,4,6568,5127,10000,845,227,6341,"[636, 229, 1428, 80, 0, 857, 1773, 300, 1450, 165, 212, 1206, 607, 596, 1856, 1059, 1360, 1953, 252, 1249, 2099, 804, 1291, 987, 1794, 94, 900, 210]"
157,4,6462,5072,10000,1390,5471,991,"[182, 202, 102, 128, 0, 198, 204, 93, 240, 303, 55, 229, 209, 255, 223, 167, 62, 171, 27, 214, 109, 292, 118, 291, 326, 238, 178, 118]"
158,4,6108,7093,9015,0,5490,618,"[27, 163, 113, 28, 0, 171, 201, 113, 16, 148, 140, 82, 118, 30, 28, 23, 53, 145, 165, 126, 52, 77, 91, 127, 52, 188, 197, 24]"
159,4,6216,6047,9184,0,2181,4035,"[76, 701, 721, 1303, 0, 896, 662, 408, 1013, 24, 1055, 520, 506, 566, 903, 898, 523, 916, 812, 268, 1122, 1020, 1027, 821, 223, 19, 306, 214]"
160,4,6988,5635,10000,537,5807,1181,"[10, 80, 4, 330, 0, 326, 205, 213, 84, 384, 193, 252, 181, 230, 339, 3, 127, 204, 208, 161, 312, 109, 53, 8, 152, 147, 187, 163]"
161,4,5318,7452,7866,0,214,5104,"[1682, 1657, 1340, 749, 0, 1699, 104, 48, 650, 1492, 448, 1556, 33, 524, 1256, 607, 1363, 1000, 1651, 1216, 967, 858, 933, 699, 1269, 827, 999, 1281]"
162,4,5380,5112,8134,0,2893,2487,"[520, 328, 188, 507, 0, 224, 561, 20, 700, 248, 549, 524, 68, 105, 212, 47, 124, 310, 312, 513, 716, 135, 338, 615, 206, 118, 342, 524]"
163,4,5489,6415,7208,0,3040,2449,"[543, 117, 450, 463, 0, 4, 43, 368, 453, 280, 138, 240, 76, 799, 336, 239, 74, 274, 727, 475, 698, 381, 782, 194, 357, 367, 739, 383]"
164,4,5895,5988,7115,0,5756,139,"[11, 28, 19, 26, 0, 41, 13, 44, 6, 9, 37, 6, 37, 2, 46, 24, 17, 24, 45, 18, 25, 18, 14, 11, 16, 23, 11, 13]"
165,4,6449,6222,7342,0,5987,462,"[40, 70, 60, 41, 0, 85, 33, 92, 59, 83, 36, 10, 133, 96, 71, 31, 67, 17, 26, 73, 48, 144, 126, 119, 127, 99, 115, 116]"
166,4,5522,7104,5760,0,2053,3469,"[29, 308, 375, 512, 0, 27, 65, 97, 1122, 294, 964, 740, 160, 496, 274, 665, 665, 151, 590, 618, 700, 170, 1126, 129, 10, 609, 359, 431]"
167,4,5806,6334,5232,0,2152,3654,"[386, 722, 1087, 425, 0, 1025, 1022, 605, 727, 420, 977, 1111, 308, 1168, 140, 373, 932, 1102, 341, 447, 664, 991, 115, 1005, 241, 519, 871, 996]"
168,4,5411,2025,8618,0,803,4608,"[1087, 173, 787, 484, 0, 262, 1179, 1320, 539, 843, 30, 436, 452, 205, 1190, 1027, 122, 1227, 830, 294, 1147, 989, 1532, 1457, 1489, 270, 886, 481]"
169,4,6720,6280,9058,0,3466,3254,"[780, 1053, 659, 690, 0, 182, 598, 958, 131, 973, 879, 840, 387, 927, 522, 959, 234, 142, 143, 21, 11, 931, 738, 323, 809, 597, 475, 368]"
170,4,5111,6050,8119,0,4554,557,"[33, 175, 68, 53, 0, 177, 51, 89, 169, 115, 31, 138, 9, 113, 96, 182, 164, 83, 109, 21, 84, 167, 125, 136, 46, 156, 93, 89]"
171,4,5579,6215,7483,0,4575,1004,"[264, 262, 141, 291, 0, 17, 44, 227, 43, 322, 112, 206, 270, 199, 262, 67, 162, 230, 224, 153, 282, 181, 204, 323, 324, 330, 69, 259]"
172,4,6498,6888,7093,0,2736,3762,"[1143, 32, 828, 467, 0, 278, 830, 457, 496, 643, 926, 841, 577, 1047, 396, 1250, 7, 321, 463, 715, 586, 380, 100, 1171, 1087, 390, 848, 1040]"
173,4,5382,6681,5794,0,4374,1008,"[258, 229, 46, 114, 0, 310, 259, 266, 285, 136, 13, 278, 7, 288, 190, 116, 9, 258, 7, 251, 134, 309, 335, 281, 162, 188, 192, 99]"
174,4,5228,6910,4112,0,4185,1043,"[313, 198, 168, 57, 0, 334, 155, 210, 119, 72, 250, 192, 267, 200, 55, 138, 213, 119, 66, 227, 181, 153, 68, 74, 320, 277, 246, 191]"
175,4,6026,2640,7498,0,3581,2445,"[574, 11, 671, 190, 0, 87, 639, 533, 516, 667, 607, 562, 406, 585, 773, 207, 764, 690, 276, 655, 388, 357, 179, 638, 721, 246, 725, 165]"
176,4,6687,6156,8029,0,2684,4003,"[155, 302, 352, 1124, 0, 743, 43, 1324, 867, 590, 738, 781, 1196, 438, 881, 39, 959, 389, 367, 1017, 166, 1333, 471, 1121, 1271, 504, 563, 1192]"
177,4,5452,6447,7034,0,1604,3848,"[195, 221, 803, 274, 0, 973, 505, 577, 39, 114, 1132, 331, 192, 800, 343, 332, 346, 179, 800, 309, 13, 973, 787, 96, 372, 440, 309, 1180]"
178,4,5936,6133,6837,0,1031,4905,"[350, 1614, 341, 1453, 0, 909, 1173, 1295, 305, 1013, 1218, 25, 1490, 1170, 1235, 1337, 1029, 485, 958, 21, 781, 311, 841, 642, 552, 1549, 857, 1142]"
179,4,5136,6909,5064,0,2448,2688,"[380, 528, 283, 332, 0, 617, 200, 491, 327, 423, 312, 894, 36, 186, 671, 146, 671, 444, 863, 511, 240, 33, 347, 220, 833, 276, 769, 1]"
180,4,5096,1493,8667,0,2267,2829,"[320, 13, 389, 592, 0, 504, 691, 587, 338, 889, 204, 153, 323, 643, 867, 651, 236, 237, 459, 259, 298, 262, 304, 288, 845, 702, 641, 596]"
181,4,5013,7301,6379,0,2103,2910,"[68, 176, 770, 386, 0, 429, 342, 42, 878, 616, 881, 367, 624, 580, 103, 396, 726, 940, 599, 104, 295, 739, 17, 763, 526, 679, 169, 345]"
182,4,6032,5920,6491,0,2643,3389,"[353, 409, 1087, 930, 0, 36, 1088, 37, 102, 296, 1116, 450, 491, 112, 25, 721, 128, 375, 182, 891, 458, 532, 18, 639, 545, 385, 176, 958]"
183,4,5381,5006,6866,0,4902,479,"[84, 46, 18, 23, 0, 12, 153, 88, 125, 89, 159, 80, 88, 87, 63, 123, 129, 128, 15, 47, 155, 67, 14, 39, 106, 114, 62, 5]"
184,4,5168,7129,4905,0,5051,117,"[31, 9, 2, 16, 0, 32, 29, 17, 4, 9, 38, 24, 37, 28, 27, 35, 35, 16, 37, 33, 16, 37, 26, 21, 15, 24, 11, 13]"
185,4,6922,6608,5219,0,405,6517,"[1097, 998, 634, 1143, 0, 1844, 483, 1351, 133, 237, 1003, 1156, 1919, 2166, 941, 1371, 1164, 1903, 957, 2171, 590, 150, 50, 1194, 1199, 328, 1175, 510]"
186,4,5964,5180,6003,0,648,5316,"[1246, 865, 100, 492, 0, 1605, 1462, 1079, 266, 339, 1264, 531, 183, 1228, 941, 1346, 512, 1059, 1311, 477, 5, 388, 325, 201, 1476, 280, 583, 15]"
187,4,5061,5336,5728,0,907,4154,"[803, 253, 604, 1277, 0, 16, 120, 1126, 114, 645, 1166, 1125, 826, 100, 1018, 1259, 313, 1134, 777, 1264, 771, 868, 698, 99, 357, 129, 188, 227]"
188,4,5321,6664,4385,0,5176,145,"[6, 29, 6, 27, 0, 28, 45, 2, 47, 2, 31, 26, 7, 41, 4, 43, 0, 0, 36, 30, 19, 44, 12, 31, 16, 7, 38, 9]"
189,4,5787,2716,7456,0,4542,1245,"[402, 275, 298, 372, 0, 135, 177, 370, 324, 63, 16, 363, 301, 174, 252, 88, 245, 144, 312, 128, 332, 128, 379, 382, 247, 165, 287, 126]"
190,4,5891,6187,7160,0,4734,1157,"[209, 370, 133, 217, 0, 84, 144, 95, 275, 384, 315, 177, 277, 294, 76, 83, 265, 154, 374, 182, 213, 207, 252, 337, 224, 0, 357, 63]"
191,4,5497,5143,7514,0,3672,1825,"[200, 174, 197, 105, 0, 299, 265, 457, 135, 114, 348, 241, 594, 515, 544, 33, 513, 430, 88, 86, 175, 44, 508, 270, 308, 349, 522, 288]"
192,4,6987,5844,8657,0,2102,4885,"[1023, 837, 544, 905, 0, 1560, 962, 1163, 1243, 441, 1497, 1240, 660, 780, 753, 893, 1077, 744, 1063, 1331, 660, 960, 1357, 683, 511, 1576, 1068, 297]"
193,4,6656,7471,7842,0,2130,4526,"[51, 238, 828, 68, 0, 1397, 980, 1360, 338, 743, 747, 811, 1096, 754, 474, 741, 1416, 926, 711, 1216, 355, 458, 1160, 414, 1383, 27, 51, 1479]"
194,4,5125,6377,6590,0,127,4998,"[1628, 115, 694, 1097, 0, 1382, 1657, 1271, 823, 1252, 956, 638, 1208, 1254, 819, 96, 398, 619, 896, 1152, 1076, 74, 1317, 536, 746, 482, 1640, 895]"
195,4,6936,7446,6080,0,4398,2538,"[436, 208, 52, 63, 0, 815, 684, 734, 390, 832, 379, 700, 210, 755, 560, 201, 590, 363, 327, 180, 5, 699, 672, 278, 358, 441, 184, 10]"
196,4,6946,6056,6970,0,6349,597,"[56, 59, 11, 21, 0, 180, 10, 32, 6, 25, 92, 175, 60, 195, 39, 115, 87, 113, 86, 99, 161, 141, 9, 86, 119, 43, 105, 166]"
197,4,5194,6419,5745,0,993,4201,"[1330, 650, 1021, 413, 0, 992, 1233, 142, 1323, 1157, 1175, 754, 1259, 1068, 665, 970, 1341, 183, 377, 1067, 558, 770, 76, 150, 1000, 41, 1262, 269]"
198,4,5991,7013,4723,0,3258,2733,"[774, 40, 367, 747, 0, 721, 66, 203, 221, 129, 895, 114, 240, 622, 226, 874, 238, 542, 358, 506, 542, 488, 871, 738, 684, 245, 484, 722]"
199,4,6000,3119,7604,0,3509,2491,"[41, 616, 791, 502, 0, 69, 526, 179, 611, 175, 788, 159, 381, 703, 656, 645, 131, 46, 144, 824, 830, 592, 505, 752, 709, 802, 766, 416]"
200,4,5061,6838,5827,0,822,4239,"[555, 1264, 215, 598, 0, 291, 1171, 1382, 685, 646, 787, 1141, 646, 1126, 400, 1002, 302, 1188, 1131, 305, 629, 1033, 316, 963, 1410, 1273, 1238, 243]"
201,4,6971,6586,6212,0,2143,4828,"[1254, 1496, 105, 954, 0, 870, 759, 1382, 1276, 999, 423, 1382, 734, 1255, 1273, 456, 1279, 663, 1082, 1574, 1048, 689, 1465, 1175, 1251, 832, 1310, 173]"
202,4,5162,5208,6166,0,3373,1789,"[127, 320, 496, 330, 0, 252, 54, 210, 520, 370, 290, 374, 446, 31, 248, 268, 313, 33, 399, 477, 29, 201, 132, 173, 339, 270, 286, 277]"
203,4,6866,6446,6586,0,2407,4459,"[68, 1195, 148, 374, 0, 1186, 333, 1091, 873, 1136, 454, 843, 1156, 489, 1149, 0, 1037, 838, 531, 1472, 79, 80, 1283, 549, 956, 1242, 1257, 1275]"
204,4,5008,7116,4478,0,3490,1518,"[405, 49, 456, 174, 0, 452, 247, 413, 103, 100, 193, 423, 308, 295, 161, 455, 150, 455, 204, 495, 228, 317, 279, 153, 235, 421, 396, 66]"
205,4,5923,1769,8632,0,4351,1572,"[407, 339, 153, 215, 0, 48, 475, 408, 137, 503, 312, 209, 3, 391, 414, 21, 186, 393, 14, 156, 62, 113, 251, 293, 273, 363, 293, 59]"
206,4,6103,6551,8184,0,1438,4665,"[977, 181, 1087, 1469, 0, 295, 783, 1086, 193, 402, 1173, 371, 799, 984, 1461, 511, 213, 822, 125, 319, 1357, 670, 1044, 1375, 888, 822, 481, 1268]"
207,4,5760,6217,7727,0,3401,2359,"[554, 235, 160, 578, 0, 628, 476, 138, 174, 685, 314, 676, 323, 657, 498, 130, 331, 336, 169, 221, 594, 420, 780, 786, 74, 699, 621, 650]"
208,4,5345,6004,7068,0,2205,3140,"[784, 644, 306, 792, 0, 549, 238, 966, 489, 699, 174, 826, 648, 105, 405, 423, 97, 387, 802, 24, 146, 855, 560, 444, 228, 705, 240, 992]"
209,4,5036,5916,6188,0,4340,696,"[193, 103, 170, 98, 0, 26, 18, 177, 127, 17, 216, 96, 137, 68, 69, 156, 86, 99, 62, 67, 231, 205, 85, 225, 179, 44, 34, 179]"
210,4,5059,6528,4719,0,3727,1332,"[412, 243, 10, 236, 0, 444, 204, 87, 10, 396, 386, 312, 6, 23, 402, 89, 93, 277, 158, 438, 2, 314, 141, 24, 151, 94, 413, 192]"
211,4,5630,4174,6175,0,75,5555,"[980, 924, 441, 388, 0, 1735, 624, 1623, 1575, 303, 455, 553, 807, 846, 1609, 1702, 1478, 1579, 1685, 292, 967, 800, 1291, 586, 652, 68, 81, 996]"
212,4,6304,6690,5789,0,3094,3210,"[766, 682, 572, 376, 0, 839, 125, 95, 137, 1026, 944, 175, 794, 617, 1070, 686, 1009, 347, 956, 999, 208, 105, 858, 365, 15, 100, 582, 956]"
213,4,6212,6388,5613,0,4995,1217,"[386, 179, 405, 334, 0, 133, 71, 281, 403, 172, 361, 32, 185, 386, 166, 106, 398, 96, 403, 173, 118, 294, 65, 233, 51, 239, 383, 37]"
214,4,6033,5293,6353,0,1510,4523,"[326, 663, 1020, 300, 0, 403, 815, 118, 552, 99, 280, 533, 1186, 1334, 224, 478, 787, 1277, 1491, 125, 1051, 677, 38, 307, 510, 622, 491, 783]"
215,4,5796,5257,6892,0,3618,2178,"[389, 436, 228, 615, 0, 382, 616, 6, 398, 130, 186, 98, 250, 368, 291, 214, 422, 189, 297, 393, 428, 79, 370, 546, 707, 160, 429, 725]"
216,4,5704,5284,7312,0,5009,695,"[176, 11, 176, 171, 0, 132, 54, 221, 13, 0, 81, 28, 185, 59, 182, 11, 221, 82, 93, 103, 143, 229, 73, 69, 13, 131, 191, 31]"
217,4,6920,7305,6927,0,666,6254,"[1664, 199, 118, 568, 0, 1237, 1021, 259, 871, 1897, 530, 1026, 786, 1111, 96, 467, 220, 934, 784, 2042, 2019, 32, 1883, 1089, 1698, 1541, 1733, 1440]"
218,4,6104,7311,5720,0,2094,4010,"[981, 98, 74, 359, 0, 465, 865, 415, 28, 1153, 648, 1035, 966, 942, 1307, 1150, 962, 1141, 700, 779, 377, 1301, 257, 1275, 782, 1238, 660, 450]"
219,4,5116,2783,8053,0,3199,1917,"[523, 79, 232, 65, 0, 483, 627, 153, 232, 40, 214, 269, 172, 222, 189, 629, 592, 198, 184, 439, 301, 37, 373, 338, 36, 148, 359, 443]"
220,4,6550,6484,8119,0,5569,981,"[168, 42, 227, 320, 0, 235, 37, 212, 263, 203, 152, 78, 114, 268, 155, 194, 80, 307, 274, 241, 115, 149, 173, 21, 265, 130, 139, 94]"
221,4,5712,6677,7154,0,2270,3442,"[947, 494, 758, 596, 0, 695, 496, 657, 513, 694, 26, 456, 219, 632, 162, 825, 636, 580, 1009, 373, 1065, 747, 608, 462, 692, 678, 595, 464]"
222,4,5296,5064,7386,0,869,4427,"[599, 1127, 138, 511, 0, 1216, 385, 1226, 411, 518, 835, 1119, 1157, 46, 667, 1009, 518, 524, 1341, 600, 171, 61, 547, 840, 199, 308, 550, 1342]"
223,4,5267,6241,6412,0,1514,3753,"[39, 59, 306, 516, 0, 418, 346, 486, 688, 225, 1045, 124, 861, 1005, 497, 1008, 656, 348, 84, 1208, 17, 7, 638, 1204, 963, 1096, 1068, 151]"
224,4,5703,7315,4800,0,4911,792,"[150, 3, 139, 127, 0, 86, 166, 76, 179, 197, 244, 84, 171, 111, 63, 25, 137, 181, 61, 187, 89, 117, 237, 59, 31, 12, 0, 68]"
225,4,5220,2105,7915,0,514,4706,"[1042, 747, 254, 1299, 0, 1183, 227, 1260, 1173, 148, 1151, 800, 674, 706, 973, 1278, 1444, 525, 332, 461, 307, 1417, 1384, 861, 836, 194, 1287, 1503]"
226,4,6357,5307,8965,0,6146,211,"[16, 61, 22, 59, 0, 51, 33, 14, 40, 56, 64, 4, 11, 30, 27, 45, 29, 42, 60, 15, 59, 7, 36, 40, 38, 10, 30, 3]"
227,4,5842,5192,9615,0,1764,4078,"[1080, 1066, 330, 119, 0, 570, 339, 119, 1318, 493, 63, 652, 1319, 129, 947, 845, 509, 484, 1353, 122, 1158, 413, 172, 254, 4, 776, 546, 1281]"
228,4,6280,5532,10000,363,4785,1495,"[182, 457, 494, 37, 0, 65, 282, 139, 202, 187, 222, 298, 298, 471, 225, 269, 133, 29, 173, 109, 44, 226, 129, 376, 5, 434, 69, 469]"
229,4,6221,5194,10000,1027,3035,3186,"[979, 222, 390, 905, 0, 237, 894, 577, 754, 78, 820, 633, 627, 949, 990, 727, 845, 92, 297, 194, 476, 1030, 98, 753, 264, 499, 352, 387]"
230,4,6207,5263,10000,944,3835,2372,"[390, 722, 166, 159, 0, 277, 735, 380, 368, 673, 729, 355, 141, 97, 241, 89, 124, 309, 711, 43, 456, 223, 515, 686, 769, 74, 579, 178]"
231,4,6435,6602,9833,0,1489,4946,"[352, 604, 797, 673, 0, 1346, 1410, 1504, 1080, 17, 639, 364, 784, 1435, 462, 943, 1532, 1604, 599, 168, 1643, 729, 394, 568, 590, 42, 841, 1635]"
232,4,5623,6619,8837,0,4702,921,"[78, 8, 81, 304, 0, 150, 229, 127, 224, 156, 239, 135, 74, 118, 162, 301, 87, 85, 219, 175, 98, 127, 275, 47, 63, 146, 8, 305]"
233,4,6863,6126,9574,0,5765,1098,"[43, 141, 303, 13, 0, 7, 33, 110, 145, 241, 83, 233, 250, 74, 316, 32, 37, 136, 119, 200, 304, 342, 358, 112, 65, 264, 239, 149]"
234,4,6677,5190,10000,1061,6026,651,"[151, 141, 17, 13, 0, 124, 155, 113, 100, 28, 36, 110, 12, 51, 200, 62, 88, 58, 211, 49, 76, 30, 1, 110, 77, 1, 129, 197]"
235,4,5023,5910,9113,0,2077,2946,"[944, 300, 90, 237, 0, 746, 103, 929, 941, 252, 721, 623, 421, 288, 135, 252, 224, 821, 323, 475, 716, 3, 318, 251, 705, 928, 822, 135]"
236,4,6979,7057,9035,0,1693,5286,"[515, 903, 156, 1622, 0, 1573, 1368, 961, 120, 665, 1348, 1531, 127, 1257, 614, 1678, 47, 1446, 558, 1174, 362, 463, 1109, 1707, 286, 352, 1489, 940]"
237,4,6039,5852,9222,0,4193,1846,"[301, 532, 196, 186, 0, 228, 194, 381, 336, 212, 447, 533, 390, 162, 501, 563, 317, 57, 226, 52, 380, 75, 70, 173, 325, 94, 124, 583]"
238,4,5013,5735,8500,0,1853,3160,"[260, 317, 584, 398, 0, 1012, 654, 910, 817, 558, 82, 966, 948, 511, 55, 34, 201, 222, 389, 590, 692, 94, 789, 490, 869, 926, 370, 782]"
239,4,5110,6211,7399,0,1937,3173,"[585, 854, 1026, 213, 0, 644, 725, 660, 589, 402, 723, 352, 347, 412, 599, 743, 671, 424, 485, 751, 988, 719, 214, 87, 850, 252, 568, 253]"
240,4,5128,6934,5593,0,4380,748,"[13, 205, 4, 211, 0, 151, 132, 87, 181, 153, 175, 114, 12, 102, 137, 140, 190, 195, 245, 244, 180, 54, 129, 70, 88, 150, 218, 60]"
241,4,5778,5647,5724,0,852,4926,"[1308, 142, 84, 1557, 0, 179, 586, 1031, 411, 743, 473, 960, 1059, 470, 496, 733, 986, 764, 49, 443, 1463, 740, 955, 1061, 223, 786, 361, 1314]"
242,4,5580,5948,5356,0,615,4965,"[1200, 939, 539, 1036, 0, 1408, 429, 1245, 56, 46, 1173, 806, 1427, 1191, 141, 1305, 1087, 157, 360, 556, 1297, 984, 1582, 593, 1081, 1646, 691, 1436]"
243,4,5535,5521,5370,0,4000,1535,"[42, 298, 201, 164, 0, 410, 6, 351, 160, 358, 127, 397, 236, 198, 116, 135, 350, 43, 445, 510, 119, 246, 300, 285, 442, 313, 1, 366]"
244,4,6861,5849,6382,0,3072,3789,"[1082, 316, 301, 1171, 0, 415, 67, 1241, 863, 1063, 244, 323, 917, 318, 757, 420, 1250, 1145, 949, 720, 1129, 1168, 321, 782, 604, 306, 780, 314]"
245,4,5970,6176,6176,0,663,5307,"[851, 198, 1241, 68, 0, 44, 921, 1460, 1632, 83, 1672, 1370, 45, 708, 84, 1520, 506, 1750, 648, 310, 693, 1414, 1449, 544, 192, 1198, 850, 1753]"
246,4,6265,5305,7136,0,11,6254,"[1991, 1574, 1287, 1437, 0, 1108, 1367, 360, 1343, 184, 515, 1083, 2069, 97, 1540, 931, 484, 286, 576, 1964, 226, 719, 983, 111, 1813, 1395, 1628, 1848]"
247,4,5960,6756,6340,0,940,5020,"[1628, 1098, 397, 1202, 0, 1371, 9, 1428, 876, 620, 904, 1088, 134, 865, 490, 1532, 879, 1543, 1424, 125, 93, 1361, 967, 926, 390, 1249, 1271, 922]"
248,4,5784,5276,6848,0,3580,2204,"[331, 251, 76, 432, 0, 295, 283, 717, 487, 386, 348, 696, 625, 593, 416, 460, 169, 495, 89, 18, 13, 590, 427, 273, 606, 59, 416, 418]"
249,4,6860,5126,8582,0,5809,1051,"[182, 170, 86, 172, 0, 42, 232, 292, 333, 71, 145, 234, 258, 29, 218, 159, 311, 187, 316, 45, 266, 127, 29, 106, 118, 246, 189, 347]"
250,4,6310,5297,9595,0,3923,2387,"[543, 131, 341, 341, 0, 26, 449, 449, 361, 185, 648, 793, 310, 309, 644, 182, 184, 643, 520, 173, 116, 540, 177, 223, 212, 262, 438, 354]"
251,4,5433,6848,8180,0,4275,1158,"[20, 318, 79, 277, 0, 245, 5, 10, 281, 42, 258, 319, 96, 251, 371, 66, 185, 296, 53, 338, 125, 156, 158, 365, 366, 289, 69, 175]"
252,4,5911,7441,6650,0,191,5720,"[45, 462, 1169, 13, 0, 806, 849, 673, 446, 863, 1258, 930, 678, 123, 1894, 872, 607, 1814, 1709, 1806, 1638, 803, 602, 364, 845, 1072, 970, 1078]"
253,4,6932,6580,7002,0,253,6679,"[2063, 1723, 486, 1579, 0, 719, 2122, 1967, 1426, 1613, 529, 636, 42, 1334, 605, 406, 1071, 713, 1449, 1288, 484, 344, 1817, 42, 1056, 1697, 2087, 732]"
254,4,5799,5826,6975,0,5614,185,"[56, 22, 57, 35, 0, 60, 0, 61, 46, 8, 29, 61, 54, 29, 1, 26, 17, 9, 22, 57, 29, 42, 57, 59, 5, 54, 5, 22]"
255,4,5859,6907,5927,0,3603,2256,"[557, 498, 329, 658, 0, 155, 362, 406, 57, 15, 530, 555, 427, 211, 74, 375, 371, 188, 58, 669, 151, 212, 745, 282, 687, 218, 723, 671]"
256,4,6248,7066,5109,0,1009,5239,"[1359, 112, 1722, 1177, 0, 1575, 171, 449, 1221, 144, 339, 388, 336, 58, 1250, 1626, 393, 603, 1273, 874, 1041, 844, 1524, 1684, 715, 296, 991, 522]"
257,4,5516,3413,7212,0,4485,1031,"[51, 290, 286, 64, 0, 61, 320, 52, 249, 327, 297, 156, 35, 202, 168, 36, 292, 47, 332, 33, 40, 181, 4, 288, 115, 135, 323, 206]"
258,4,5628,5255,7585,0,5453,175,"[51, 43, 32, 11, 0, 29, 33, 54, 3, 28, 29, 42, 10, 4, 12, 14, 49, 58, 55, 50, 28, 16, 19, 15, 55, 22, 32, 3]"
259,4,5270,6400,6455,0,4424,846,"[15, 153, 227, 53, 0, 169, 166, 228, 95, 282, 22, 194, 5, 275, 277, 260, 241, 203, 252, 17, 8, 275, 265, 270, 196, 100, 145, 212]"
260,4,6048,5067,7436,0,1240,4808,"[1329, 1384, 1000, 870, 0, 64, 1131, 1069, 1234, 1016, 690, 1495, 987, 1031, 1233, 1150, 967, 1230, 1111, 1150, 618, 606, 1177, 74, 317, 494, 900, 142]"
261,4,6413,6942,6907,0,5424,989,"[246, 48, 126, 234, 0, 115, 11, 153, 61, 278, 209, 156, 160, 105, 184, 164, 142, 110, 195, 83, 307, 25, 37, 232, 79, 22, 325, 216]"
262,4,6497,6590,6814,0,310,6187,"[1066, 1113, 85, 487, 0, 1075, 1832, 755, 1959, 1300, 1760, 179, 616, 600, 756, 877, 819, 3, 287, 1026, 1132, 405, 637, 814, 443, 5, 616, 1207]"
263,4,5542,6644,5712,0,2694,2848,"[557, 802, 937, 343, 0, 176, 426, 38, 303, 592, 308, 526, 512, 329, 595, 261, 837, 506, 55, 384, 69, 898, 572, 649, 69, 318, 139, 260]"
264,4,5129,690,10000,151,3909,1220,"[391, 172, 166, 16, 0, 8, 275, 225, 223, 326, 168, 31, 287, 399, 112, 404, 196, 193, 342, 271, 101, 150, 380, 251, 223, 363, 113, 155]"
265,4,5345,5986,9359,0,845,4500,"[843, 325, 1437, 1323, 0, 1050, 85, 92, 787, 1277, 537, 1334, 1197, 1241, 1340, 1360, 11, 309, 171, 1362, 583, 67, 1027, 1126, 1329, 1047, 814, 1482]"
266,4,5957,5466,9850,0,4226,1731,"[205, 172, 439, 61, 0, 46, 214, 130, 566, 427, 34, 408, 522, 305, 94, 167, 319, 33, 9, 175, 242, 93, 118, 472, 295, 251, 52, 383]"
267,4,6841,5713,10000,978,6786,55,"[15, 12, 5, 13, 0, 6, 5, 16, 1, 10, 14, 10, 14, 15, 9, 4, 18, 0, 5, 5, 4, 16, 17, 16, 7, 9, 12, 10]"
268,4,6357,5014,10000,1343,749,5608,"[153, 1371, 90, 1423, 0, 1286, 1714, 374, 1733, 50, 639, 592, 940, 703, 1585, 1374, 424, 1504, 811, 868, 1506, 409, 47, 1188, 1497, 1689, 1417, 959]"
269,4,6081,5283,10000,798,2544,3537,"[388, 178, 958, 894, 0, 1170, 221, 30, 793, 1098, 547, 847, 650, 298, 836, 791, 527, 1041, 428, 528, 747, 919, 1114, 754, 115, 389, 7, 318]"
270,4,5801,6189,9612,0,1514,4287,"[134, 643, 1015, 1019, 0, 1404, 562, 386, 1163, 697, 514, 1398, 845, 144, 908, 1158, 814, 1364, 905, 770, 487, 1085, 556, 143, 415, 1010, 829, 159]"
271,4,5369,5116,9865,0,4698,671,"[168, 214, 192, 222, 0, 179, 33, 9, 204, 179, 6, 1, 32, 82, 91, 113, 95, 106, 90, 87, 142, 167, 198, 50, 99, 70, 183, 48]"
272,4,5091,5434,9522,0,162,4929,"[585, 1579, 156, 1433, 0, 573, 966, 846, 1388, 399, 150, 1465, 949, 1094, 1160, 719, 464, 99, 430, 162, 444, 677, 1162, 917, 999, 895, 810, 428]"
273,4,5733,6104,9151,0,3225,2508,"[620, 526, 228, 563, 0, 584, 567, 191, 595, 332, 78, 182, 822, 28, 325, 806, 390, 630, 729, 311, 357, 290, 250, 332, 463, 82, 501, 47]"
274,4,6291,6779,8663,0,6089,202,"[49, 20, 5, 48, 0, 65, 27, 28, 56, 6, 37, 25, 21, 56, 45, 61, 16, 57, 48, 65, 10, 25, 65, 53, 31, 67, 39, 48]"
275,4,6722,5358,10000,27,4730,1992,"[64, 219, 541, 462, 0, 405, 261, 336, 331, 322, 649, 154, 292, 663, 139, 539, 222, 306, 135, 515, 89, 120, 37, 40, 449, 475, 638, 163]"
276,4,6969,5081,10000,1888,1348,5621,"[908, 1724, 171, 822, 0, 1485, 87, 1186, 1776, 1319, 1444, 230, 1662, 965, 616, 328, 1761, 734, 597, 398, 1545, 948, 1579, 1748, 484, 761, 1233, 527]"
277,4,6262,6484,9778,0,3598,2664,"[373, 448, 122, 845, 0, 420, 445, 438, 369, 871, 404, 529, 104, 468, 515, 177, 293, 536, 464, 641, 835, 652, 126, 181, 846, 329, 273, 871]"
278,4,6511,6781,9508,0,3138,3373,"[1088, 477, 829, 864, 0, 1059, 81, 746, 841, 1067, 578, 780, 1116, 67, 1072, 4, 538, 617, 33, 651, 54, 600, 1015, 446, 245, 911, 1024, 224]"
279,4,5281,6136,8653,0,4952,329,"[99, 28, 22, 98, 0, 45, 53, 91, 10, 3, 105, 60, 32, 85, 87, 65, 22, 103, 10, 48, 107, 14, 79, 9, 11, 12, 84, 48]"
280,4,6933,6828,8758,0,2001,4932,"[1468, 407, 1555, 743, 0, 356, 979, 176, 1481, 840, 1094, 768, 1599, 576, 654, 474, 1073, 43, 1027, 18, 964, 721, 469, 651, 1064, 914, 252, 1340]"
281,4,6806,5035,10000,529,3494,3312,"[779, 157, 61, 493, 0, 92, 385, 45, 1104, 151, 718, 642, 548, 103, 732, 185, 206, 1058, 802, 401, 321, 517, 707, 56, 624, 840, 1045, 1098]"
282,4,6691,7103,9588,0,5987,704,"[234, 127, 0, 78, 0, 51, 12, 172, 130, 181, 156, 224, 165, 83, 140, 212, 6, 141, 56, 126, 208, 6, 110, 64, 128, 168, 36, 208]"
283,4,5185,5700,9073,0,5054,131,"[2, 8, 43, 32, 0, 22, 3, 12, 18, 39, 5, 23, 20, 30, 12, 20, 6, 11, 2, 41, 2, 14, 39, 24, 43, 10, 43, 25]"
284,4,6869,7468,8474,0,5967,902,"[240, 263, 256, 209, 0, 17, 236, 93, 72, 160, 230, 27, 168, 215, 64, 279, 36, 177, 182, 118, 261, 80, 298, 264, 156, 64, 55, 170]"
285,4,5413,5091,8796,0,4922,491,"[96, 145, 38, 51, 0, 82, 12, 155, 6, 129, 124, 62, 150, 101, 149, 38, 51, 159, 1, 72, 18, 0, 20, 71, 10, 26, 49, 141]"
286,4,5069,7421,6444,0,3031,2038,"[183, 458, 20, 167, 0, 175, 63, 577, 566, 667, 635, 504, 310, 627, 503, 467, 260, 282, 578, 99, 43, 125, 210, 339, 291, 35, 206, 496]"
287,4,5838,6385,5897,0,5204,634,"[13, 159, 173, 152, 0, 165, 58, 43, 23, 139, 205, 103, 169, 30, 66, 19, 199, 137, 206, 80, 145, 27, 1, 4, 85, 128, 182, 142]"
288,4,6599,6596,5900,0,3231,3368,"[848, 441, 191, 316, 0, 836, 755, 1024, 982, 998, 351, 601, 335, 883, 580, 857, 1007, 722, 1009, 606, 926, 209, 434, 635, 1060, 595, 997, 121]"
289,4,5062,4448,6514,0,2322,2740,"[264, 464, 564, 663, 0, 803, 463, 227, 640, 431, 850, 429, 596, 118, 105, 393, 637, 272, 766, 493, 413, 579, 769, 189, 445, 241, 310, 408]"
290,4,6259,7420,5353,0,3524,2735,"[166, 52, 340, 76, 0, 250, 882, 747, 505, 146, 367, 828, 332, 391, 763, 717, 814, 370, 617, 306, 517, 398, 146, 631, 439, 887, 881, 644]"
291,4,6341,5245,6449,0,1934,4407,"[534, 1173, 740, 768, 0, 185, 228, 645, 100, 1437, 371, 1435, 262, 656, 1363, 339, 1449, 535, 1096, 226, 146, 1450, 528, 1100, 320, 653, 644, 498]"
292,4,6806,5589,7666,0,2546,4260,"[576, 765, 1077, 768, 0, 1130, 87, 626, 441, 809, 467, 1151, 111, 1315, 1015, 1322, 1038, 446, 258, 701, 1023, 223, 1184, 133, 166, 358, 1266, 740]"
293,4,5048,5261,7453,0,3031,2017,"[287, 604, 486, 337, 0, 29, 6, 460, 181, 284, 443, 659, 233, 252, 285, 662, 105, 118, 313, 86, 282, 240, 91, 32, 306, 304, 412, 21]"
294,4,6355,5022,8786,0,1108,5247,"[311, 314, 1005, 1453, 0, 1469, 1410, 1075, 414, 1372, 139, 1500, 1560, 220, 1213, 405, 634, 667, 123, 704, 1557, 1720, 1150, 1631, 1435, 1272, 1132, 727]"
295,4,5947,5505,9228,0,2905,3042,"[700, 915, 580, 676, 0, 796, 513, 589, 239, 683, 54, 192, 351, 190, 790, 419, 610, 673, 773, 629, 670, 656, 330, 63, 59, 469, 880, 302]"
296,4,5990,5918,9300,0,4406,1584,"[511, 198, 56, 58, 0, 223, 479, 126, 391, 263, 395, 468, 317, 310, 208, 346, 491, 209, 28, 453, 413, 519, 75, 112, 57, 468, 289, 83]"
297,4,6387,5208,10000,479,4994,1393,"[366, 337, 321, 202, 0, 241, 432, 223, 211, 451, 443, 51, 237, 386, 450, 411, 6, 399, 198, 352, 100, 350, 183, 296, 184, 187, 370, 349]"
298,4,5469,6431,9038,0,2379,3090,"[211, 115, 796, 30, 0, 978, 886, 697, 644, 477, 564, 192, 120, 705, 674, 156, 722, 39, 520, 638, 404, 361, 58, 652, 796, 332, 439, 757]"
299,4,6010,6769,8279,0,3245,2765,"[205, 874, 409, 169, 0, 410, 410, 203, 441, 519, 124, 257, 742, 252, 881, 245, 874, 123, 428, 6, 838, 633, 420, 623, 568, 191, 413, 492]"
0,5,42,0,42,0,1,41,"[6, 1, 5, 12, 10, 0, 11, 13, 0, 10, 7, 5, 6, 2, 4, 7, 0, 0, 6, 12, 0, 7, 1, 6, 4, 10, 13]"
1,5,26,10,58,0,6,20,"[6, 0, 5, 0, 4, 0, 5, 2, 4, 3, 5, 6, 0, 6, 2, 1, 3, 5, 1, 2, 2, 3, 1, 1, 2, 1, 1]"
2,5,4,0,62,0,0,4,"[1, 0, 0, 0, 0, 0, 0, 0, 0, 1, 0, 0, 1, 0, 1, 1, 0, 0, 1, 1, 1, 0, 1, 1, 0, 1, 0]"
3,5,9,7,64,0,2,7,"[0, 0, 0, 0, 0, 0, 0, 2, 1, 0, 1, 0, 0, 0, 2, 1, 0, 1, 1, 2, 1, 2, 2, 1, 2, 1, 1]"
4,5,5,0,69,0,5,0,"[0, 0, 0, 0, 0, 0, 0, 0, 0, 0, 0, 0, 0, 0, 0, 0, 0, 0, 0, 0, 0, 0, 0, 0, 0, 0, 0]"
5,5,83,70,82,0,61,22,"[6, 4, 3, 6, 6, 0, 0, 2, 3, 2, 4, 6, 3, 4, 5, 6, 5, 0, 1, 1, 4, 0, 6, 0, 4, 1, 4]"
6,5,13,5,90,0,7,6,"[1, 2, 1, 2, 0, 0, 0, 1, 1, 0, 0, 1, 2, 0, 2, 2, 1, 2, 2, 1, 1, 2, 0, 2, 1, 2, 1]"
7,5,15,2,103,0,8,7,"[0, 1, 2, 2, 1, 0, 0, 0, 0, 2, 2, 0, 0, 0, 1, 0, 0, 0, 1, 1, 1, 2, 0, 2, 0, 2, 2]"
8,5,13,9,107,0,8,5,"[0, 0, 0, 0, 1, 0, 1, 1, 1, 0, 1, 1, 0, 1, 0, 1, 1, 0, 0, 0, 1, 1, 1, 1, 0, 1, 1]"
9,5,75,63,119,0,43,32,"[7, 7, 6, 7, 5, 0, 8, 5, 2, 2, 4, 7, 3, 2, 5, 4, 4, 8, 0, 2, 4, 5, 7, 2, 2, 2, 0]"
10,5,96,10,205,0,70,26,"[0, 3, 7, 3, 0, 0, 4, 6, 4, 8, 2, 4, 0, 3, 8, 8, 7, 4, 0, 2, 8, 5, 2, 8, 5, 3, 4]"
11,5,27,2,230,0,20,7,"[2, 1, 0, 2, 0, 0, 0, 1, 1, 0, 0, 0, 1, 0, 0, 2, 2, 0, 0, 2, 2, 1, 1, 1, 1, 1, 0]"
12,5,56,8,278,0,6,50,"[6, 3, 2, 15, 9, 0, 16, 15, 11, 16, 5, 7, 1, 15, 12, 6, 4, 0, 13, 1, 4, 6, 9, 1, 13, 2, 13]"
13,5,81,10,349,0,52,29,"[3, 1, 9, 7, 1, 0, 4, 7, 0, 9, 2, 0, 2, 8, 3, 9, 7, 1, 4, 6, 8, 2, 3, 4, 3, 6, 0]"
14,5,73,71,351,0,41,32,"[10, 7, 1, 6, 5, 0, 3, 9, 10, 6, 5, 3, 3, 4, 3, 6, 0, 3, 4, 7, 10, 9, 1, 0, 2, 0, 5]"
15,5,53,33,371,0,5,48,"[1, 8, 5, 11, 15, 0, 14, 2, 1, 0, 14, 14, 15, 13, 12, 9, 3, 5, 14, 11, 8, 7, 7, 16, 3, 11, 2]"
16,5,97,64,404,0,71,26,"[2, 0, 7, 7, 2, 0, 8, 1, 3, 5, 7, 4, 4, 5, 5, 8, 7, 0, 0, 4, 4, 6, 2, 1, 0, 4, 7]"
17,5,86,55,435,0,14,72,"[11, 24, 24, 7, 17, 0, 7, 6, 10, 21, 7, 6, 3, 15, 24, 5, 14, 5, 9, 1, 7, 20, 16, 2, 5, 14, 9]"
18,5,63,56,442,0,17,46,"[7, 5, 12, 8, 12, 0, 1, 12, 12, 15, 11, 2, 12, 5, 13, 14, 3, 10, 4, 6, 12, 12, 4, 0, 3, 8, 11]"
19,5,77,5,514,0,12,65,"[13, 15, 17, 7, 18, 0, 14, 17, 12, 8, 15, 7, 16, 8, 4, 9, 16, 3, 15, 10, 15, 1, 8, 14, 21, 3, 1]"
20,5,65,7,572,0,32,33,"[5, 3, 8, 3, 9, 0, 11, 10, 5, 10, 8, 3, 7, 7, 2, 6, 5, 9, 6, 9, 5, 7, 0, 0, 6, 3, 8]"
21,5,40,18,594,0,13,27,"[2, 6, 3, 4, 0, 0, 3, 7, 2, 6, 5, 4, 0, 1, 3, 9, 3, 4, 2, 8, 3, 5, 3, 8, 3, 3, 7]"
22,5,10,1,603,0,4,6,"[2, 0, 0, 1, 1, 0, 2, 2, 0, 0, 1, 0, 0, 0, 1, 2, 1, 2, 2, 1, 2, 2, 0, 2, 2, 0, 1]"
23,5,53,35,621,0,1,52,"[13, 7, 13, 11, 6, 0, 3, 3, 6, 7, 1, 16, 2, 12, 7, 0, 10, 4, 2, 5, 1, 2, 5, 0, 7, 14, 1]"
24,5,26,6,641,0,26,0,"[0, 0, 0, 0, 0, 0, 0, 0, 0, 0, 0, 0, 0, 0, 0, 0, 0, 0, 0, 0, 0, 0, 0, 0, 0, 0, 0]"
25,5,58,49,650,0,18,40,"[5, 7, 5, 7, 7, 0, 5, 2, 6, 6, 5, 2, 3, 4, 7, 4, 1, 5, 4, 4, 6, 5, 10, 13, 9, 2, 9]"
26,5,57,19,688,0,51,6,"[0, 2, 0, 2, 0, 0, 0, 1, 1, 0, 2, 0, 0, 1, 1, 1, 0, 1, 2, 2, 0, 2, 0, 0, 2, 1, 0]"
27,5,60,40,708,0,33,27,"[0, 6, 4, 3, 9, 0, 8, 4, 2, 5, 3, 7, 7, 9, 2, 7, 0, 2, 8, 2, 4, 6, 3, 8, 4, 7, 8]"
28,5,28,27,709,0,23,5,"[1, 1, 1, 1, 0, 0, 0, 0, 0, 0, 1, 0, 0, 1, 0, 0, 1, 1, 1, 1, 1, 1, 0, 1, 1, 1, 1]"
29,5,35,32,712,0,20,15,"[4, 0, 0, 4, 2, 0, 5, 3, 1, 2, 0, 1, 0, 4, 5, 2, 1, 1, 5, 0, 4, 4, 1, 3, 5, 3, 1]"
30,5,8,3,717,0,6,2,"[0, 0, 0, 0, 0, 0, 0, 0, 0, 0, 0, 0, 0, 0, 0, 0, 0, 0, 0, 0, 0, 0, 0, 0, 0, 0, 0]"
31,5,88,68,737,0,74,14,"[0, 3, 3, 2, 1, 0, 4, 1, 4, 2, 2, 0, 3, 1, 3, 4, 3, 4, 1, 1, 1, 1, 1, 3, 0, 2, 0]"
32,5,70,63,744,0,22,48,"[9, 5, 16, 5, 8, 0, 3, 7, 13, 4, 7, 16, 13, 3, 4, 11, 9, 14, 14, 5, 0, 9, 16, 10, 6, 4, 1]"
33,5,73,61,756,0,63,10,"[3, 3, 3, 3, 2, 0, 1, 1, 0, 3, 1, 1, 0, 0, 1, 2, 2, 2, 3, 1, 2, 0, 0, 1, 1, 1, 2]"
34,5,21,7,770,0,7,14,"[4, 3, 1, 4, 1, 0, 4, 2, 0, 0, 4, 2, 4, 2, 0, 1, 0, 0, 2, 1, 4, 3, 1, 2, 3, 3, 2]"
35,5,68,4,834,0,16,52,"[15, 4, 13, 7, 12, 0, 3, 11, 13, 1, 5, 4, 6, 4, 3, 15, 1, 2, 16, 6, 6, 15, 13, 7, 9, 5, 15]"
36,5,24,4,854,0,9,15,"[3, 3, 2, 1, 1, 0, 4, 3, 5, 1, 5, 2, 5, 0, 4, 5, 2, 5, 0, 3, 4, 1, 2, 3, 3, 2, 2]"
37,5,28,6,876,0,21,7,"[2, 0, 2, 1, 0, 0, 2, 0, 0, 0, 0, 2, 0, 0, 2, 0, 0, 0, 2, 1, 1, 1, 1, 0, 0, 1, 0]"
38,5,100,8,968,0,27,73,"[3, 21, 3, 4, 10, 0, 10, 20, 8, 16, 20, 12, 4, 23, 22, 0, 7, 7, 1, 14, 1, 13, 0, 10, 2, 18, 13]"
39,5,47,45,970,0,32,15,"[2, 2, 3, 0, 1, 0, 0, 3, 4, 4, 1, 2, 4, 3, 2, 2, 4, 5, 5, 1, 1, 4, 5, 2, 4, 4, 1]"
40,5,7,7,970,0,7,0,"[0, 0, 0, 0, 0, 0, 0, 0, 0, 0, 0, 0, 0, 0, 0, 0, 0, 0, 0, 0, 0, 0, 0, 0, 0, 0, 0]"
41,5,94,81,983,0,10,84,"[22, 15, 9, 25, 22, 0, 25, 17, 5, 4, 27, 14, 13, 15, 16, 23, 10, 27, 5, 13, 26, 14, 10, 25, 27, 15, 21]"
42,5,58,18,1023,0,58,0,"[0, 0, 0, 0, 0, 0, 0, 0, 0, 0, 0, 0, 0, 0, 0, 0, 0, 0, 0, 0, 0, 0, 0, 0, 0, 0, 0]"
43,5,34,24,1033,0,33,1,"[0, 0, 0, 0, 0, 0, 0, 0, 0, 0, 0, 0, 0, 0, 0, 0, 0, 0, 0, 0, 0, 0, 0, 0, 0, 0, 0]"
44,5,14,7,1040,0,13,1,"[0, 0, 0, 0, 0, 0, 0, 0, 0, 0, 0, 0, 0, 0, 0, 0, 0, 0, 0, 0, 0, 0, 0, 0, 0, 0, 0]"
45,5,79,5,1114,0,37,42,"[11, 12, 14, 12, 1, 0, 5, 12, 13, 1, 14, 1, 12, 1, 12, 14, 6, 3, 12, 14, 6, 7, 6, 1, 12, 9, 5]"
46,5,19,12,1121,0,19,0,"[0, 0, 0, 0, 0, 0, 0, 0, 0, 0, 0, 0, 0, 0, 0, 0, 0, 0, 0, 0, 0, 0, 0, 0, 0, 0, 0]"
47,5,53,18,1156,0,40,13,"[4, 3, 3, 0, 3, 0, 3, 4, 4, 3, 0, 1, 0, 1, 2, 3, 0, 3, 1, 3, 4, 3, 4, 1, 1, 4, 0]"
48,5,10,5,1161,0,5,5,"[0, 0, 1, 0, 0, 0, 1, 1, 1, 1, 1, 0, 0, 1, 1, 0, 1, 1, 1, 1, 1, 1, 0, 0, 1, 0, 1]"
49,5,65,10,1216,0,45,20,"[5, 3, 4, 6, 0, 0, 5, 0, 6, 6, 0, 2, 4, 1, 4, 3, 3, 3, 5, 6, 1, 3, 1, 2, 5, 5, 3]"
50,5,60,41,1235,0,51,9,"[2, 2, 3, 3, 1, 0, 3, 2, 0, 1, 2, 3, 0, 1, 2, 2, 0, 3, 0, 0, 0, 3, 1, 2, 0, 1, 0]"
51,5,77,54,1258,0,49,28,"[2, 8, 1, 5, 8, 0, 2, 3, 7, 9, 0, 2, 7, 6, 3, 1, 9, 3, 8, 8, 1, 5, 7, 0, 7, 7, 9]"
52,5,55,28,1285,0,55,0,"[0, 0, 0, 0, 0, 0, 0, 0, 0, 0, 0, 0, 0, 0, 0, 0, 0, 0, 0, 0, 0, 0, 0, 0, 0, 0, 0]"
53,5,77,47,1315,0,4,73,"[9, 20, 9, 3, 19, 0, 12, 6, 16, 8, 24, 5, 4, 10, 13, 18, 10, 17, 3, 5, 18, 18, 18, 4, 7, 1, 23]"
54,5,1,0,1286,0,1,0,"[0, 0, 0, 0, 0, 0, 0, 0, 0, 0, 0, 0, 0, 0, 0, 0, 0, 0, 0, 0, 0, 0, 0, 0, 0, 0, 0]"
55,5,56,11,1331,0,49,7,"[2, 0, 0, 2, 1, 0, 2, 2, 0, 0, 1, 2, 1, 2, 2, 1, 2, 0, 1, 0, 1, 0, 2, 0, 0, 1, 0]"
56,5,73,56,1348,0,2,71,"[11, 12, 8, 15, 15, 0, 19, 6, 14, 1, 21, 5, 6, 3, 1, 0, 20, 18, 10, 17, 3, 18, 3, 5, 0, 6, 21]"
57,5,26,8,1366,0,10,16,"[1, 0, 2, 0, 3, 0, 2, 4, 4, 5, 1, 0, 4, 3, 2, 5, 2, 5, 5, 1, 2, 1, 2, 1, 1, 0, 2]"
58,5,19,3,1382,0,6,13,"[3, 2, 3, 0, 4, 0, 4, 1, 1, 2, 4, 4, 3, 1, 2, 1, 2, 2, 0, 0, 3, 2, 4, 4, 2, 1, 2]"
59,5,52,20,1414,0,47,5,"[1, 0, 1, 0, 1, 0, 0, 1, 1, 1, 0, 0, 0, 1, 1, 0, 0, 0, 0, 0, 1, 0, 1, 1, 0, 1, 1]"
60,5,97,9,1502,0,95,2,"[0, 0, 0, 0, 0, 0, 0, 0, 0, 0, 0, 0, 0, 0, 0, 0, 0, 0, 0, 0, 0, 0, 0, 0, 0, 0, 0]"
61,5,15,14,1503,0,15,0,"[0, 0, 0, 0, 0, 0, 0, 0, 0, 0, 0, 0, 0, 0, 0, 0, 0, 0, 0, 0, 0, 0, 0, 0, 0, 0, 0]"
62,5,83,74,1512,0,62,21,"[1, 2, 3, 0, 1, 0, 4, 4, 3, 3, 5, 0, 1, 4, 1, 1, 7, 7, 7, 7, 0, 5, 1, 0, 2, 0, 0]"
63,5,96,85,1523,0,48,48,"[9, 2, 6, 3, 3, 0, 2, 14, 14, 6, 8, 5, 7, 3, 14, 4, 11, 14, 7, 7, 1, 2, 11, 1, 14, 11, 3]"
64,5,64,4,1583,0,33,31,"[4, 1, 3, 4, 1, 0, 4, 9, 1, 3, 4, 0, 4, 8, 6, 4, 3, 0, 9, 3, 7, 9, 0, 5, 5, 9, 0]"
65,5,86,61,1608,0,20,66,"[17, 3, 20, 2, 10, 0, 5, 18, 2, 8, 21, 20, 7, 22, 8, 17, 2, 0, 17, 11, 13, 16, 1, 15, 15, 9, 8]"
66,5,68,10,1666,0,33,35,"[2, 0, 2, 1, 10, 0, 5, 8, 0, 4, 0, 4, 2, 6, 3, 11, 9, 8, 5, 0, 0, 10, 8, 3, 7, 1, 5]"
67,5,39,22,1683,0,4,35,"[4, 1, 8, 7, 1, 0, 0, 9, 7, 0, 6, 11, 11, 8, 4, 6, 2, 1, 0, 1, 1, 4, 8, 7, 4, 11, 8]"
68,5,37,5,1715,0,13,24,"[4, 3, 8, 7, 1, 0, 6, 5, 1, 5, 8, 7, 1, 0, 6, 7, 4, 3, 4, 5, 7, 7, 6, 4, 2, 2, 7]"
69,5,3,1,1717,0,3,0,"[0, 0, 0, 0, 0, 0, 0, 0, 0, 0, 0, 0, 0, 0, 0, 0, 0, 0, 0, 0, 0, 0, 0, 0, 0, 0, 0]"
70,5,90,77,1730,0,64,26,"[8, 5, 2, 4, 0, 0, 1, 7, 4, 2, 7, 6, 2, 0, 3, 7, 5, 2, 2, 7, 4, 7, 7, 3, 7, 4, 2]"
71,5,46,45,1731,0,32,14,"[3, 1, 4, 1, 1, 0, 4, 3, 0, 0, 2, 1, 2, 4, 3, 1, 0, 2, 3, 4, 1, 3, 4, 4, 0, 1, 0]"
72,5,37,5,1763,0,16,21,"[1, 2, 6, 5, 7, 0, 7, 4, 3, 2, 2, 6, 6, 1, 4, 6, 0, 5, 4, 2, 7, 0, 2, 7, 3, 3, 6]"
73,5,71,53,1781,0,40,31,"[6, 5, 7, 5, 4, 0, 9, 2, 3, 9, 2, 5, 3, 3, 4, 0, 7, 8, 6, 8, 2, 3, 8, 4, 2, 8, 8]"
74,5,12,2,1791,0,3,9,"[3, 2, 0, 0, 2, 0, 1, 3, 0, 2, 0, 3, 2, 2, 1, 0, 1, 3, 1, 0, 2, 2, 2, 0, 3, 2, 0]"
75,5,53,22,1822,0,28,25,"[3, 6, 6, 6, 7, 0, 3, 6, 0, 6, 3, 7, 0, 0, 7, 5, 1, 0, 4, 4, 6, 7, 4, 3, 4, 7, 6]"
76,5,87,77,1832,0,72,15,"[1, 0, 0, 1, 1, 0, 2, 4, 0, 3, 4, 5, 0, 3, 3, 0, 3, 3, 3, 3, 1, 1, 5, 3, 2, 5, 1]"
77,5,10,8,1834,0,4,6,"[2, 0, 2, 1, 0, 0, 1, 1, 2, 0, 2, 0, 0, 2, 1, 2, 0, 1, 2, 0, 2, 1, 1, 0, 1, 2, 0]"
78,5,45,27,1852,0,10,35,"[2, 8, 8, 0, 7, 0, 6, 8, 3, 2, 3, 6, 5, 2, 9, 0, 11, 6, 1, 4, 5, 4, 10, 1, 4, 5, 4]"
79,5,99,77,1874,0,21,78,"[1, 2, 24, 22, 23, 0, 6, 12, 1, 23, 25, 20, 3, 6, 23, 4, 7, 25, 17, 24, 16, 3, 4, 8, 24, 12, 2]"
80,5,72,24,1922,0,72,0,"[0, 0, 0, 0, 0, 0, 0, 0, 0, 0, 0, 0, 0, 0, 0, 0, 0, 0, 0, 0, 0, 0, 0, 0, 0, 0, 0]"
81,5,7,5,1924,0,4,3,"[1, 0, 0, 0, 1, 0, 1, 1, 1, 0, 0, 1, 1, 1, 0, 0, 0, 0, 1, 1, 0, 1, 1, 0, 1, 0, 1]"
82,5,40,36,1928,0,25,15,"[2, 3, 2, 0, 0, 0, 5, 5, 3, 3, 3, 1, 0, 3, 0, 3, 4, 3, 3, 0, 1, 1, 5, 5, 2, 3, 3]"
83,5,93,64,1957,0,74,19,"[3, 6, 0, 6, 6, 0, 4, 1, 3, 2, 1, 3, 1, 2, 6, 2, 6, 3, 3, 3, 0, 5, 4, 0, 4, 4, 4]"
84,5,41,24,1974,0,35,6,"[1, 0, 1, 2, 2, 0, 2, 0, 0, 0, 0, 2, 0, 0, 0, 2, 0, 2, 1, 2, 1, 0, 1, 1, 0, 2, 1]"
85,5,29,13,1990,0,5,24,"[6, 0, 5, 2, 6, 0, 4, 5, 0, 4, 8, 7, 2, 1, 8, 2, 4, 8, 7, 5, 3, 1, 0, 8, 7, 2, 2]"
86,5,81,79,1992,0,8,73,"[7, 10, 3, 12, 16, 0, 12, 18, 9, 2, 15, 5, 8, 17, 3, 13, 19, 5, 12, 15, 20, 2, 4, 20, 0, 23, 12]"
87,5,2,0,1994,0,1,1,"[0, 0, 0, 0, 0, 0, 0, 0, 0, 0, 0, 0, 0, 0, 0, 0, 0, 0, 0, 0, 0, 0, 0, 0, 0, 0, 0]"
88,5,64,52,2006,0,9,55,"[16, 10, 12, 3, 8, 0, 18, 5, 12, 18, 2, 9, 6, 6, 8, 4, 18, 14, 12, 0, 1, 8, 14, 15, 12, 16, 8]"
89,5,58,44,2020,0,24,34,"[0, 0, 9, 10, 3, 0, 2, 3, 5, 2, 1, 11, 0, 10, 2, 9, 10, 2, 4, 1, 5, 6, 10, 11, 6, 0, 5]"
90,5,53,53,2020,0,51,2,"[0, 0, 0, 0, 0, 0, 0, 0, 0, 0, 0, 0, 0, 0, 0, 0, 0, 0, 0, 0, 0, 0, 0, 0, 0, 0, 0]"
91,5,44,33,2031,0,14,30,"[2, 5, 2, 5, 3, 0, 10, 4, 3, 1, 7, 3, 5, 8, 0, 1, 1, 6, 9, 8, 8, 6, 1, 1, 3, 7, 4]"
92,5,7,5,2033,0,5,2,"[0, 0, 0, 0, 0, 0, 0, 0, 0, 0, 0, 0, 0, 0, 0, 0, 0, 0, 0, 0, 0, 0, 0, 0, 0, 0, 0]"
93,5,78,59,2052,0,31,47,"[15, 1, 9, 10, 10, 0, 13, 5, 10, 3, 5, 10, 6, 4, 8, 7, 1, 15, 10, 12, 12, 3, 7, 9, 13, 11, 3]"
94,5,97,24,2125,0,38,59,"[19, 9, 1, 15, 3, 0, 4, 10, 9, 12, 1, 5, 3, 1, 15, 13, 18, 17, 5, 10, 18, 4, 6, 19, 5, 12, 3]"
95,5,93,91,2127,0,85,8,"[1, 2, 2, 0, 2, 0, 2, 0, 0, 2, 1, 1, 2, 1, 1, 0, 2, 1, 1, 0, 0, 0, 2, 1, 1, 2, 1]"
96,5,15,0,2142,0,10,5,"[0, 1, 0, 0, 1, 0, 1, 1, 1, 1, 1, 1, 1, 1, 1, 1, 0, 1, 0, 0, 0, 0, 1, 1, 0, 0, 0]"
97,5,1,0,2128,0,1,0,"[0, 0, 0, 0, 0, 0, 0, 0, 0, 0, 0, 0, 0, 0, 0, 0, 0, 0, 0, 0, 0, 0, 0, 0, 0, 0, 0]"
98,5,25,20,2133,0,3,22,"[4, 2, 2, 4, 0, 0, 4, 2, 7, 0, 4, 2, 5, 0, 7, 4, 2, 7, 4, 2, 4, 4, 6, 2, 2, 1, 4]"
99,5,48,35,2146,0,23,25,"[8, 8, 3, 3, 7, 0, 8, 2, 6, 6, 7, 2, 2, 1, 7, 1, 5, 2, 1, 6, 0, 3, 2, 1, 1, 5, 5]"
100,5,16,16,2146,0,0,16,"[5, 2, 5, 3, 2, 0, 3, 2, 0, 5, 5, 2, 3, 4, 2, 3, 3, 3, 3, 4, 3, 0, 5, 4, 4, 1, 1]"
101,5,15,5,2156,0,7,8,"[0, 1, 1, 1, 1, 0, 1, 2, 1, 0, 1, 1, 2, 2, 2, 2, 1, 2, 0, 1, 1, 2, 2, 0, 2, 1, 1]"
102,5,28,4,2180,0,8,20,"[6, 6, 6, 5, 3, 0, 0, 3, 3, 6, 4, 1, 4, 0, 1, 2, 3, 5, 2, 0, 6, 1, 2, 0, 4, 4, 0]"
103,5,38,24,2194,0,34,4,"[1, 1, 0, 1, 1, 0, 1, 0, 0, 1, 1, 1, 1, 1, 1, 1, 0, 1, 0, 0, 0, 1, 1, 1, 1, 0, 1]"
104,5,99,55,2238,0,69,30,"[3, 3, 4, 3, 10, 0, 6, 4, 1, 10, 6, 3, 0, 5, 6, 6, 5, 1, 0, 3, 3, 7, 1, 4, 4, 6, 9]"
105,5,29,10,2257,0,15,14,"[4, 0, 4, 4, 2, 0, 3, 1, 3, 2, 1, 3, 1, 1, 0, 1, 1, 2, 2, 2, 3, 1, 0, 0, 2, 2, 3]"
106,5,7,5,2259,0,7,0,"[0, 0, 0, 0, 0, 0, 0, 0, 0, 0, 0, 0, 0, 0, 0, 0, 0, 0, 0, 0, 0, 0, 0, 0, 0, 0, 0]"
107,5,18,8,2269,0,13,5,"[1, 0, 1, 1, 0, 0, 1, 0, 0, 0, 0, 0, 1, 1, 0, 1, 1, 0, 0, 0, 0, 1, 1, 0, 0, 1, 1]"
108,5,75,12,2332,0,12,63,"[12, 19, 11, 5, 17, 0, 13, 12, 2, 18, 6, 12, 21, 4, 0, 4, 8, 14, 12, 13, 20, 11, 4, 19, 10, 20, 12]"
109,5,36,18,2350,0,25,11,"[3, 2, 2, 2, 0, 0, 3, 2, 3, 1, 1, 1, 3, 2, 3, 3, 3, 1, 3, 1, 2, 1, 3, 0, 1, 1, 3]"
110,5,53,10,2393,0,28,25,"[1, 7, 4, 1, 8, 0, 0, 6, 2, 5, 5, 5, 4, 3, 6, 5, 4, 3, 1, 7, 8, 6, 5, 7, 6, 5, 5]"
111,5,89,78,2404,0,75,14,"[1, 2, 2, 3, 1, 0, 0, 0, 0, 0, 0, 2, 1, 0, 0, 2, 0, 3, 0, 2, 1, 1, 0, 0, 0, 0, 0]"
112,5,43,26,2421,0,35,8,"[1, 2, 2, 0, 2, 0, 2, 0, 0, 0, 1, 0, 2, 2, 0, 0, 2, 1, 0, 2, 2, 1, 1, 0, 1, 2, 0]"
113,5,48,47,2422,0,44,4,"[0, 0, 1, 0, 1, 0, 0, 0, 1, 0, 0, 1, 1, 1, 0, 0, 0, 1, 1, 0, 1, 0, 0, 1, 1, 0, 1]"
114,5,92,81,2433,0,27,65,"[20, 9, 7, 14, 0, 0, 17, 16, 13, 18, 2, 18, 9, 6, 4, 0, 9, 0, 14, 14, 4, 17, 9, 8, 13, 19, 10]"
115,5,42,2,2473,0,29,13,"[1, 2, 4, 3, 3, 0, 3, 1, 0, 0, 0, 4, 0, 3, 3, 3, 0, 3, 2, 0, 1, 3, 3, 1, 1, 3, 0]"
116,5,34,19,2488,0,4,30,"[9, 6, 8, 1, 4, 0, 5, 0, 6, 5, 10, 0, 4, 10, 7, 3, 2, 10, 5, 8, 5, 0, 0, 8, 10, 8, 7]"
117,5,31,2,2517,0,5,26,"[8, 5, 0, 8, 3, 0, 1, 3, 1, 1, 8, 1, 6, 3, 6, 4, 0, 4, 0, 4, 6, 8, 2, 3, 4, 2, 4]"
118,5,100,70,2547,0,33,67,"[5, 14, 21, 0, 13, 0, 5, 22, 18, 9, 9, 19, 18, 4, 13, 18, 19, 5, 20, 0, 5, 1, 20, 9, 15, 1, 8]"
119,5,96,33,2610,0,68,28,"[0, 7, 6, 9, 9, 0, 6, 3, 2, 7, 1, 9, 8, 6, 5, 1, 8, 5, 2, 3, 8, 9, 5, 6, 7, 6, 3]"
120,5,50,42,2618,0,20,30,"[1, 8, 9, 5, 4, 0, 3, 0, 4, 1, 8, 9, 5, 4, 10, 2, 5, 2, 4, 8, 4, 5, 1, 9, 7, 1, 0]"
121,5,66,52,2632,0,49,17,"[0, 3, 0, 2, 0, 0, 0, 2, 1, 2, 2, 1, 2, 4, 3, 1, 3, 4, 5, 4, 5, 5, 0, 0, 2, 2, 3]"
122,5,64,50,2646,0,51,13,"[1, 1, 4, 2, 0, 0, 2, 2, 3, 2, 4, 2, 2, 4, 4, 2, 3, 1, 2, 1, 0, 2, 3, 1, 4, 2, 1]"
123,5,1,0,2633,0,1,0,"[0, 0, 0, 0, 0, 0, 0, 0, 0, 0, 0, 0, 0, 0, 0, 0, 0, 0, 0, 0, 0, 0, 0, 0, 0, 0, 0]"
124,5,81,19,2695,0,9,72,"[16, 7, 13, 4, 2, 0, 14, 5, 20, 17, 0, 18, 11, 23, 8, 2, 19, 19, 21, 5, 23, 18, 10, 3, 0, 3, 7]"
125,5,6,6,2695,0,0,6,"[0, 2, 2, 0, 0, 0, 0, 1, 1, 0, 2, 2, 0, 1, 1, 0, 0, 0, 0, 1, 2, 1, 2, 0, 1, 0, 2]"
126,5,25,9,2711,0,0,25,"[6, 3, 6, 8, 2, 0, 7, 4, 1, 7, 3, 8, 3, 8, 8, 7, 7, 1, 4, 8, 3, 1, 3, 0, 3, 7, 6]"
127,5,100,98,2713,0,32,68,"[2, 17, 10, 21, 17, 0, 14, 7, 14, 1, 20, 20, 9, 3, 3, 10, 19, 8, 21, 14, 20, 8, 3, 4, 13, 22, 12]"
128,5,55,21,2747,0,37,18,"[4, 2, 6, 3, 5, 0, 0, 2, 0, 2, 5, 3, 5, 4, 5, 2, 3, 3, 4, 6, 3, 1, 6, 6, 3, 2, 4]"
129,5,79,39,2787,0,72,7,"[0, 2, 1, 2, 1, 0, 2, 2, 1, 0, 2, 2, 2, 2, 1, 0, 1, 1, 0, 2, 0, 0, 1, 0, 0, 0, 0]"
130,5,56,7,2836,0,3,53,"[15, 8, 1, 4, 2, 0, 16, 4, 11, 3, 1, 11, 5, 13, 6, 14, 16, 0, 12, 15, 12, 5, 8, 12, 1, 11, 13]"
131,5,0,0,2836,0,0,0,"[0, 0, 0, 0, 0, 0, 0, 0, 0, 0, 0, 0, 0, 0, 0, 0, 0, 0, 0, 0, 0, 0, 0, 0, 0, 0, 0]"
132,5,16,8,2844,0,5,11,"[2, 1, 3, 0, 3, 0, 2, 3, 2, 0, 3, 1, 0, 1, 0, 1, 2, 2, 0, 1, 2, 3, 1, 3, 2, 0, 2]"
133,5,49,1,2892,0,15,34,"[10, 7, 10, 2, 1, 0, 3, 6, 0, 9, 1, 3, 1, 0, 6, 8, 10, 6, 1, 3, 9, 0, 3, 5, 11, 4, 10]"
134,5,63,63,2892,0,0,63,"[6, 15, 21, 20, 16, 0, 1, 8, 3, 13, 19, 19, 18, 19, 5, 19, 3, 16, 5, 0, 17, 20, 18, 2, 21, 2, 12]"
135,5,46,37,2901,0,36,10,"[3, 3, 2, 1, 1, 0, 2, 1, 2, 3, 0, 1, 1, 0, 1, 3, 1, 0, 1, 0, 3, 3, 2, 2, 3, 0, 2]"
136,5,66,29,2938,0,32,34,"[2, 6, 11, 3, 9, 0, 10, 8, 4, 5, 3, 0, 2, 10, 10, 3, 1, 1, 2, 6, 0, 1, 0, 3, 2, 2, 1]"
137,5,94,52,2980,0,82,12,"[3, 4, 3, 1, 4, 0, 2, 3, 0, 3, 3, 3, 3, 4, 1, 2, 1, 1, 0, 1, 3, 2, 3, 0, 0, 3, 0]"
138,5,33,30,2983,0,27,6,"[0, 1, 2, 2, 1, 0, 1, 1, 1, 2, 0, 1, 0, 1, 1, 2, 0, 2, 1, 2, 1, 2, 1, 0, 0, 2, 0]"
139,5,60,6,3037,0,0,60,"[14, 11, 11, 12, 18, 0, 5, 1, 9, 16, 7, 15, 9, 15, 17, 7, 13, 17, 18, 10, 7, 16, 19, 10, 8, 18, 18]"
140,5,50,26,3061,0,0,50,"[7, 15, 0, 1, 2, 0, 16, 12, 7, 7, 7, 10, 4, 0, 2, 13, 11, 15, 13, 1, 4, 12, 8, 3, 8, 16, 7]"
141,5,68,68,3061,0,64,4,"[0, 1, 1, 0, 0, 0, 1, 0, 0, 0, 1, 0, 1, 1, 0, 0, 0, 0, 0, 1, 1, 1, 0, 1, 0, 1, 0]"
142,5,36,27,3070,0,17,19,"[0, 1, 5, 3, 6, 0, 2, 0, 1, 5, 3, 3, 5, 0, 4, 0, 4, 0, 2, 4, 5, 0, 1, 6, 0, 0, 5]"
143,5,46,15,3101,0,38,8,"[1, 0, 1, 2, 2, 0, 2, 1, 1, 2, 0, 2, 0, 2, 0, 1, 1, 1, 1, 1, 2, 2, 2, 0, 2, 0, 2]"
144,5,15,0,3116,0,14,1,"[0, 0, 0, 0, 0, 0, 0, 0, 0, 0, 0, 0, 0, 0, 0, 0, 0, 0, 0, 0, 0, 0, 0, 0, 0, 0, 0]"
145,5,80,57,3139,0,10,70,"[16, 18, 22, 13, 20, 0, 14, 10, 8, 7, 3, 4, 14, 4, 11, 16, 19, 4, 1, 3, 18, 1, 20, 10, 20, 11, 13]"
146,5,11,9,3141,0,10,1,"[0, 0, 0, 0, 0, 0, 0, 0, 0, 0, 0, 0, 0, 0, 0, 0, 0, 0, 0, 0, 0, 0, 0, 0, 0, 0, 0]"
147,5,37,12,3166,0,9,28,"[1, 3, 4, 7, 6, 0, 9, 6, 2, 8, 3, 2, 7, 1, 8, 9, 7, 6, 8, 7, 0, 0, 3, 7, 6, 5, 6]"
148,5,44,38,3172,0,21,23,"[1, 5, 7, 0, 4, 0, 1, 6, 7, 5, 5, 4, 7, 3, 1, 3, 3, 5, 7, 4, 7, 5, 3, 2, 5, 0, 7]"
149,5,57,3,3226,0,19,38,"[2, 4, 8, 1, 9, 0, 6, 10, 7, 0, 2, 1, 5, 4, 11, 4, 6, 7, 9, 12, 0, 6, 11, 8, 11, 9, 5]"
150,5,40,5,3261,0,40,0,"[0, 0, 0, 0, 0, 0, 0, 0, 0, 0, 0, 0, 0, 0, 0, 0, 0, 0, 0, 0, 0, 0, 0, 0, 0, 0, 0]"
151,5,25,16,3270,0,3,22,"[2, 2, 7, 1, 3, 0, 6, 7, 7, 4, 0, 1, 2, 5, 2, 6, 1, 4, 7, 4, 5, 7, 4, 6, 2, 7, 4]"
152,5,42,6,3306,0,6,36,"[0, 12, 3, 3, 6, 0, 6, 3, 12, 5, 12, 8, 0, 5, 1, 12, 3, 12, 2, 5, 0, 8, 10, 7, 7, 7, 11]"
153,5,65,6,3365,0,61,4,"[1, 1, 1, 0, 1, 0, 0, 0, 1, 1, 0, 0, 0, 1, 0, 1, 0, 0, 1, 1, 1, 0, 0, 1, 1, 0, 0]"
154,5,38,21,3382,0,0,38,"[6, 2, 8, 7, 0, 0, 2, 10, 12, 7, 1, 11, 5, 10, 11, 3, 2, 7, 6, 1, 7, 8, 9, 2, 3, 4, 9]"
155,5,34,4,3412,0,23,11,"[1, 1, 1, 1, 0, 0, 2, 0, 1, 3, 1, 1, 0, 1, 3, 0, 3, 2, 2, 3, 3, 0, 1, 2, 3, 3, 0]"
156,5,82,32,3462,0,68,14,"[2, 0, 2, 4, 1, 0, 2, 2, 1, 1, 2, 2, 3, 1, 0, 0, 0, 3, 0, 4, 1, 0, 2, 2, 3, 2, 1]"
157,5,30,1,3491,0,17,13,"[4, 1, 0, 0, 3, 0, 0, 2, 2, 1, 2, 3, 0, 2, 0, 1, 3, 0, 2, 1, 4, 3, 2, 4, 0, 2, 1]"
158,5,58,34,3515,0,24,34,"[3, 7, 10, 6, 2, 0, 3, 7, 5, 9, 4, 2, 7, 9, 2, 4, 5, 0, 0, 0, 7, 0, 4, 5, 10, 11, 3]"
159,5,29,23,3521,0,27,2,"[0, 0, 0, 0, 0, 0, 0, 0, 0, 0, 0, 0, 0, 0, 0, 0, 0, 0, 0, 0, 0, 0, 0, 0, 0, 0, 0]"
160,5,66,34,3553,0,40,26,"[6, 5, 6, 4, 3, 0, 5, 7, 8, 8, 6, 7, 4, 4, 3, 0, 2, 3, 4, 1, 3, 2, 1, 6, 3, 8, 1]"
161,5,47,7,3593,0,46,1,"[0, 0, 0, 0, 0, 0, 0, 0, 0, 0, 0, 0, 0, 0, 0, 0, 0, 0, 0, 0, 0, 0, 0, 0, 0, 0, 0]"
162,5,69,20,3642,0,11,58,"[15, 15, 4, 0, 6, 0, 1, 2, 2, 19, 12, 9, 12, 3, 0, 19, 7, 17, 3, 17, 8, 7, 5, 3, 15, 11, 13]"
163,5,84,67,3659,0,77,7,"[0, 0, 0, 2, 2, 0, 2, 0, 1, 1, 2, 0, 1, 1, 0, 0, 2, 2, 1, 1, 0, 2, 2, 0, 0, 2, 1]"
164,5,56,44,3671,0,3,53,"[17, 4, 14, 4, 7, 0, 0, 1, 4, 11, 3, 4, 12, 6, 13, 11, 6, 1, 10, 10, 1, 10, 9, 3, 9, 14, 11]"
165,5,33,17,3687,0,0,33,"[0, 9, 3, 11, 2, 0, 11, 6, 8, 7, 3, 11, 11, 7, 3, 6, 10, 7, 9, 7, 5, 7, 11, 2, 6, 4, 3]"
166,5,94,73,3708,0,42,52,"[11, 4, 9, 0, 11, 0, 10, 8, 3, 9, 12, 15, 1, 2, 5, 13, 9, 4, 14, 5, 0, 11, 14, 2, 8, 2, 2]"
167,5,82,75,3715,0,9,73,"[15, 7, 8, 15, 15, 0, 24, 11, 14, 5, 9, 15, 1, 8, 22, 12, 7, 9, 9, 23, 4, 8, 20, 14, 1, 2, 14]"
168,5,33,23,3725,0,32,1,"[0, 0, 0, 0, 0, 0, 0, 0, 0, 0, 0, 0, 0, 0, 0, 0, 0, 0, 0, 0, 0, 0, 0, 0, 0, 0, 0]"
169,5,94,11,3808,0,37,57,"[12, 9, 8, 3, 5, 0, 17, 8, 9, 12, 5, 17, 18, 0, 12, 17, 15, 17, 4, 10, 9, 1, 5, 6, 7, 7, 9]"
170,5,97,79,3826,0,27,70,"[9, 4, 14, 21, 1, 0, 2, 7, 7, 16, 20, 16, 18, 7, 17, 18, 2, 13, 22, 15, 23, 22, 16, 1, 23, 14, 7]"
171,5,81,74,3833,0,73,8,"[1, 1, 2, 0, 0, 0, 2, 0, 2, 1, 1, 0, 0, 0, 0, 0, 0, 1, 2, 0, 1, 1, 0, 1, 1, 0, 0]"
172,5,49,42,3840,0,5,44,"[7, 0, 9, 13, 7, 0, 11, 1, 0, 11, 9, 3, 8, 4, 5, 11, 2, 12, 11, 3, 3, 14, 12, 1, 11, 10, 11]"
173,5,27,3,3864,0,21,6,"[1, 1, 1, 0, 1, 0, 1, 1, 1, 1, 0, 1, 2, 1, 0, 2, 0, 1, 1, 2, 1, 1, 1, 0, 0, 1, 0]"
174,5,63,26,3901,0,1,62,"[9, 7, 10, 16, 8, 0, 3, 1, 19, 1, 19, 8, 20, 10, 0, 4, 14, 17, 13, 3, 20, 19, 18, 19, 20, 18, 5]"
175,5,74,47,3928,0,17,57,"[13, 2, 8, 11, 2, 0, 9, 14, 19, 1, 15, 17, 18, 1, 19, 5, 13, 11, 12, 7, 18, 4, 14, 10, 14, 0, 5]"
176,5,7,4,3931,0,5,2,"[0, 0, 0, 0, 0, 0, 0, 0, 0, 0, 0, 0, 0, 0, 0, 0, 0, 0, 0, 0, 0, 0, 0, 0, 0, 0, 0]"
177,5,17,3,3945,0,17,0,"[0, 0, 0, 0, 0, 0, 0, 0, 0, 0, 0, 0, 0, 0, 0, 0, 0, 0, 0, 0, 0, 0, 0, 0, 0, 0, 0]"
178,5,49,24,3970,0,46,3,"[0, 1, 1, 1, 1, 0, 1, 1, 1, 1, 1, 0, 1, 0, 0, 0, 0, 0, 0, 1, 0, 1, 1, 0, 0, 0, 1]"
179,5,80,80,3970,0,54,26,"[4, 0, 8, 4, 0, 0, 4, 6, 6, 8, 0, 3, 6, 6, 4, 7, 5, 7, 4, 5, 4, 4, 0, 0, 2, 5, 0]"
180,5,13,6,3977,0,0,13,"[1, 2, 3, 2, 1, 0, 3, 0, 3, 0, 4, 1, 3, 2, 3, 1, 4, 2, 3, 0, 3, 4, 3, 4, 4, 1, 4]"
181,5,7,7,3977,0,2,5,"[0, 0, 0, 0, 1, 0, 0, 0, 0, 0, 0, 1, 0, 0, 0, 1, 1, 0, 1, 1, 0, 0, 1, 1, 1, 1, 1]"
182,5,74,58,3993,0,33,41,"[8, 4, 8, 5, 9, 0, 3, 2, 8, 1, 11, 5, 3, 1, 13, 4, 12, 10, 7, 8, 3, 4, 1, 10, 13, 8, 11]"
183,5,36,24,4005,0,19,17,"[2, 3, 0, 4, 0, 0, 4, 2, 3, 2, 2, 2, 0, 0, 5, 2, 0, 0, 0, 0, 1, 0, 0, 0, 1, 4, 0]"
184,5,26,6,4025,0,4,22,"[5, 0, 2, 4, 1, 0, 2, 4, 5, 2, 1, 1, 1, 7, 2, 0, 0, 2, 2, 5, 0, 1, 6, 1, 5, 0, 1]"
185,5,51,4,4072,0,34,17,"[2, 3, 4, 0, 2, 0, 2, 0, 2, 2, 4, 0, 1, 0, 0, 2, 0, 3, 3, 4, 0, 0, 3, 3, 4, 3, 1]"
186,5,48,6,4114,0,28,20,"[2, 0, 6, 3, 4, 0, 3, 6, 4, 1, 4, 1, 6, 6, 4, 5, 0, 2, 1, 4, 5, 6, 3, 4, 1, 1, 1]"
187,5,4,3,4115,0,2,2,"[0, 0, 0, 0, 0, 0, 0, 0, 0, 0, 0, 0, 0, 0, 0, 0, 0, 0, 0, 0, 0, 0, 0, 0, 0, 0, 0]"
188,5,97,52,4160,0,92,5,"[1, 0, 0, 1, 0, 0, 0, 1, 0, 1, 1, 1, 0, 0, 0, 1, 0, 1, 0, 0, 1, 1, 0, 0, 1, 0, 0]"
189,5,48,45,4163,0,19,29,"[0, 3, 2, 5, 3, 0, 2, 6, 1, 5, 0, 3, 3, 0, 2, 1, 3, 6, 4, 5, 3, 4, 6, 4, 3, 1, 4]"
190,5,54,53,4164,0,36,18,"[3, 0, 0, 1, 3, 0, 1, 0, 1, 2, 2, 5, 5, 0, 6, 1, 1, 2, 4, 1, 3, 2, 4, 6, 6, 0, 2]"
191,5,5,5,4164,0,3,2,"[0, 0, 0, 0, 0, 0, 0, 0, 0, 0, 0, 0, 0, 0, 0, 0, 0, 0, 0, 0, 0, 0, 0, 0, 0, 0, 0]"
192,5,88,3,4249,0,74,14,"[4, 4, 0, 0, 3, 0, 3, 4, 1, 0, 1, 1, 1, 3, 2, 0, 2, 4, 0, 2, 2, 1, 0, 2, 4, 4, 2]"
193,5,31,10,4270,0,22,9,"[1, 0, 3, 2, 0, 0, 3, 2, 1, 2, 0, 2, 1, 2, 2, 3, 3, 0, 3, 0, 3, 2, 3, 0, 2, 1, 0]"
194,5,22,12,4280,0,15,7,"[2, 1, 2, 2, 0, 0, 1, 1, 2, 2, 2, 2, 2, 2, 1, 0, 2, 0, 1, 2, 0, 2, 1, 0, 1, 2, 0]"
195,5,14,8,4286,0,13,1,"[0, 0, 0, 0, 0, 0, 0, 0, 0, 0, 0, 0, 0, 0, 0, 0, 0, 0, 0, 0, 0, 0, 0, 0, 0, 0, 0]"
196,5,38,32,4292,0,32,6,"[1, 2, 0, 0, 2, 0, 0, 1, 1, 0, 1, 0, 1, 1, 1, 1, 2, 2, 2, 0, 2, 2, 1, 2, 0, 2, 1]"
197,5,87,58,4321,0,56,31,"[1, 4, 9, 7, 3, 0, 2, 3, 2, 0, 3, 7, 2, 4, 2, 9, 0, 0, 10, 2, 8, 8, 5, 8, 5, 9, 6]"
198,5,95,33,4383,0,51,44,"[8, 3, 13, 5, 0, 0, 12, 1, 7, 14, 1, 5, 12, 4, 1, 8, 10, 14, 11, 14, 7, 4, 11, 0, 10, 10, 13]"
199,5,55,41,4397,0,3,52,"[5, 1, 10, 3, 12, 0, 17, 10, 4, 8, 12, 17, 15, 6, 17, 2, 7, 7, 7, 8, 9, 3, 13, 6, 4, 4, 14]"
200,5,1,0,4384,0,0,1,"[0, 0, 0, 0, 0, 0, 0, 0, 0, 0, 0, 0, 0, 0, 0, 0, 0, 0, 0, 0, 0, 0, 0, 0, 0, 0, 0]"
201,5,19,5,4398,0,11,8,"[2, 2, 1, 0, 0, 0, 2, 2, 1, 2, 1, 1, 0, 0, 2, 1, 1, 0, 0, 1, 0, 2, 2, 2, 2, 0, 2]"
202,5,1,0,4385,0,1,0,"[0, 0, 0, 0, 0, 0, 0, 0, 0, 0, 0, 0, 0, 0, 0, 0, 0, 0, 0, 0, 0, 0, 0, 0, 0, 0, 0]"
203,5,50,44,4391,0,21,29,"[7, 4, 9, 7, 3, 0, 3, 8, 4, 0, 1, 8, 2, 4, 7, 9, 8, 2, 8, 5, 2, 3, 2, 9, 2, 6, 0]"
204,5,77,8,4460,0,71,6,"[0, 2, 2, 2, 1, 0, 1, 0, 0, 0, 1, 0, 2, 1, 2, 0, 2, 0, 0, 1, 1, 2, 1, 0, 2, 0, 0]"
205,5,60,58,4462,0,23,37,"[3, 12, 10, 11, 3, 0, 2, 2, 1, 6, 2, 5, 9, 2, 11, 4, 2, 12, 8, 3, 5, 8, 11, 8, 11, 7, 0]"
206,5,19,16,4465,0,11,8,"[1, 0, 0, 0, 1, 0, 1, 1, 2, 2, 1, 1, 0, 0, 2, 1, 0, 1, 1, 0, 2, 1, 1, 0, 1, 0, 0]"
207,5,43,15,4493,0,13,30,"[9, 4, 9, 5, 1, 0, 1, 7, 8, 8, 7, 1, 10, 10, 9, 2, 8, 5, 0, 6, 9, 2, 2, 3, 1, 7, 4]"
208,5,70,49,4514,0,46,24,"[4, 4, 5, 7, 1, 0, 5, 2, 4, 7, 7, 4, 0, 8, 6, 5, 8, 6, 6, 8, 6, 5, 1, 8, 3, 3, 5]"
209,5,99,45,4568,0,36,63,"[9, 14, 13, 13, 1, 0, 18, 16, 8, 12, 13, 18, 13, 11, 13, 14, 8, 7, 0, 20, 9, 10, 4, 3, 8, 17, 7]"
210,5,15,14,4569,0,1,14,"[4, 3, 4, 3, 3, 0, 1, 1, 0, 1, 3, 1, 1, 1, 4, 1, 0, 4, 4, 1, 4, 1, 4, 2, 2, 0, 4]"
211,5,1,0,4569,0,1,0,"[0, 0, 0, 0, 0, 0, 0, 0, 0, 0, 0, 0, 0, 0, 0, 0, 0, 0, 0, 0, 0, 0, 0, 0, 0, 0, 0]"
212,5,73,32,4610,0,39,34,"[6, 1, 3, 2, 6, 0, 6, 6, 6, 2, 4, 10, 0, 7, 6, 9, 1, 0, 7, 6, 11, 0, 9, 11, 11, 5, 7]"
213,5,23,7,4626,0,22,1,"[0, 0, 0, 0, 0, 0, 0, 0, 0, 0, 0, 0, 0, 0, 0, 0, 0, 0, 0, 0, 0, 0, 0, 0, 0, 0, 0]"
214,5,49,8,4667,0,27,22,"[1, 2, 0, 0, 5, 0, 2, 3, 6, 7, 1, 6, 0, 7, 1, 5, 1, 4, 6, 4, 3, 7, 3, 2, 4, 0, 7]"
215,5,30,26,4671,0,24,6,"[2, 2, 2, 0, 2, 0, 0, 2, 2, 1, 0, 2, 2, 2, 0, 1, 1, 1, 0, 1, 2, 1, 1, 1, 2, 1, 1]"
216,5,31,18,4684,0,26,5,"[1, 1, 0, 0, 0, 0, 1, 1, 0, 0, 0, 0, 1, 0, 0, 0, 0, 0, 0, 0, 1, 0, 0, 0, 0, 0, 1]"
217,5,98,57,4725,0,6,92,"[3, 29, 16, 25, 17, 0, 12, 4, 0, 6, 16, 14, 8, 1, 8, 5, 12, 25, 16, 7, 20, 13, 8, 24, 21, 7, 15]"
218,5,69,18,4776,0,7,62,"[19, 17, 12, 0, 14, 0, 1, 9, 19, 12, 8, 17, 12, 15, 19, 10, 3, 13, 8, 2, 0, 1, 12, 17, 13, 0, 1]"
219,5,65,18,4823,0,1,64,"[21, 0, 5, 13, 18, 0, 19, 19, 19, 2, 17, 1, 13, 0, 0, 3, 1, 21, 11, 18, 19, 15, 7, 16, 11, 8, 9]"
220,5,66,29,4860,0,62,4,"[1, 1, 1, 0, 1, 0, 1, 0, 0, 1, 0, 0, 1, 1, 1, 1, 0, 0, 0, 1, 1, 1, 1, 1, 1, 1, 0]"
221,5,75,75,4860,0,42,33,"[4, 4, 8, 8, 7, 0, 8, 10, 1, 2, 7, 8, 3, 7, 2, 10, 4, 8, 4, 6, 7, 7, 5, 2, 1, 3, 11]"
222,5,88,15,4933,0,14,74,"[20, 2, 1, 9, 18, 0, 0, 14, 15, 12, 23, 17, 10, 18, 13, 21, 23, 2, 19, 17, 17, 1, 2, 0, 2, 17, 13]"
223,5,84,31,4986,0,7,77,"[25, 17, 7, 14, 21, 0, 7, 0, 22, 25, 24, 13, 19, 3, 14, 9, 24, 9, 11, 13, 8, 20, 11, 23, 3, 22, 10]"
224,5,9,2,4993,0,4,5,"[1, 0, 0, 0, 0, 0, 0, 1, 1, 1, 1, 1, 0, 1, 1, 1, 0, 0, 0, 0, 0, 0, 1, 0, 0, 0, 0]"
225,5,15,14,4994,0,6,9,"[0, 3, 2, 2, 3, 0, 2, 0, 2, 0, 0, 1, 0, 1, 0, 0, 3, 3, 3, 1, 2, 2, 0, 3, 0, 0, 1]"
226,5,94,11,5077,0,55,39,"[9, 0, 3, 13, 8, 0, 2, 8, 0, 3, 8, 3, 4, 1, 10, 12, 9, 5, 2, 8, 10, 4, 7, 13, 3, 7, 3]"
227,5,61,61,5077,0,14,47,"[11, 0, 15, 12, 1, 0, 9, 10, 12, 0, 6, 8, 7, 1, 8, 12, 3, 8, 5, 1, 1, 8, 7, 7, 12, 1, 5]"
228,5,28,4,5101,0,2,26,"[8, 6, 0, 7, 4, 0, 4, 8, 2, 7, 1, 0, 7, 8, 8, 6, 2, 5, 7, 1, 2, 3, 2, 3, 0, 3, 4]"
229,5,24,19,5106,0,22,2,"[0, 0, 0, 0, 0, 0, 0, 0, 0, 0, 0, 0, 0, 0, 0, 0, 0, 0, 0, 0, 0, 0, 0, 0, 0, 0, 0]"
230,5,97,24,5179,0,35,62,"[7, 14, 15, 11, 5, 0, 0, 13, 18, 7, 14, 0, 18, 7, 4, 14, 18, 1, 20, 16, 18, 7, 0, 12, 5, 12, 15]"
231,5,96,24,5251,0,74,22,"[6, 7, 3, 3, 3, 0, 6, 7, 2, 0, 3, 6, 0, 0, 3, 7, 1, 1, 0, 4, 1, 4, 3, 7, 6, 1, 6]"
232,5,54,25,5280,0,1,53,"[7, 2, 1, 5, 9, 0, 0, 1, 14, 7, 15, 14, 1, 11, 17, 16, 15, 2, 2, 1, 16, 15, 10, 14, 16, 13, 0]"
233,5,54,50,5284,0,3,51,"[10, 17, 17, 3, 3, 0, 2, 15, 11, 5, 13, 10, 10, 11, 17, 13, 14, 4, 16, 13, 17, 8, 5, 8, 5, 16, 10]"
234,5,66,59,5291,0,2,64,"[11, 4, 8, 14, 11, 0, 7, 17, 20, 4, 3, 7, 16, 15, 19, 6, 3, 21, 4, 1, 11, 8, 1, 11, 16, 3, 17]"
235,5,95,80,5306,0,39,56,"[17, 14, 11, 8, 10, 0, 7, 13, 12, 5, 13, 11, 1, 4, 15, 11, 13, 11, 5, 0, 18, 14, 15, 10, 10, 4, 11]"
236,5,94,6,5394,0,26,68,"[7, 6, 11, 22, 5, 0, 5, 20, 11, 22, 2, 9, 13, 21, 15, 4, 0, 2, 8, 11, 1, 5, 8, 19, 1, 2, 6]"
237,5,13,1,5406,0,3,10,"[3, 3, 1, 1, 1, 0, 1, 1, 0, 2, 2, 1, 2, 0, 3, 3, 0, 0, 1, 3, 3, 0, 3, 3, 3, 3, 2]"
238,5,87,55,5438,0,45,42,"[13, 3, 9, 13, 4, 0, 12, 14, 7, 11, 5, 0, 0, 8, 3, 1, 4, 7, 2, 4, 4, 5, 1, 13, 11, 8, 12]"
239,5,32,30,5440,0,31,1,"[0, 0, 0, 0, 0, 0, 0, 0, 0, 0, 0, 0, 0, 0, 0, 0, 0, 0, 0, 0, 0, 0, 0, 0, 0, 0, 0]"
240,5,99,63,5476,0,44,55,"[1, 1, 10, 10, 8, 0, 1, 2, 11, 1, 10, 14, 15, 16, 13, 17, 6, 6, 5, 18, 5, 8, 18, 14, 5, 7, 11]"
241,5,39,33,5482,0,19,20,"[3, 2, 2, 4, 6, 0, 4, 0, 2, 6, 0, 1, 5, 2, 3, 5, 3, 2, 3, 1, 2, 0, 6, 3, 2, 4, 1]"
242,5,57,25,5514,0,30,27,"[2, 9, 9, 3, 3, 0, 5, 4, 7, 1, 0, 2, 7, 1, 6, 7, 2, 2, 4, 3, 4, 2, 7, 7, 6, 9, 8]"
243,5,81,52,5543,0,15,66,"[4, 6, 10, 10, 12, 0, 5, 12, 8, 21, 7, 0, 1, 19, 3, 0, 20, 6, 0, 0, 9, 12, 17, 13, 20, 17, 6]"
244,5,76,9,5610,0,4,72,"[23, 15, 1, 9, 4, 0, 8, 6, 14, 21, 6, 20, 8, 4, 14, 21, 21, 17, 14, 3, 12, 15, 18, 3, 21, 13, 23]"
245,5,48,15,5643,0,8,40,"[10, 12, 8, 12, 5, 0, 6, 13, 11, 3, 3, 7, 6, 9, 2, 3, 7, 13, 13, 6, 4, 5, 2, 9, 3, 12, 0]"
246,5,8,5,5646,0,3,5,"[1, 0, 0, 0, 1, 0, 0, 1, 0, 1, 1, 0, 0, 1, 1, 0, 1, 1, 1, 0, 0, 1, 1, 0, 1, 0, 1]"
247,5,46,33,5659,0,12,34,"[11, 6, 10, 1, 1, 0, 7, 3, 6, 4, 7, 2, 7, 2, 8, 3, 7, 4, 10, 1, 4, 3, 2, 5, 3, 7, 7]"
248,5,97,84,5672,0,83,14,"[1, 1, 0, 0, 2, 0, 2, 3, 2, 1, 4, 0, 3, 1, 0, 0, 4, 0, 1, 2, 1, 2, 3, 1, 1, 1, 3]"
249,5,41,4,5709,0,0,41,"[0, 4, 8, 2, 3, 0, 6, 7, 11, 6, 0, 3, 0, 8, 6, 6, 2, 2, 5, 2, 10, 7, 10, 0, 3, 1, 13]"
250,5,56,24,5741,0,31,25,"[2, 2, 7, 4, 8, 0, 6, 8, 5, 7, 6, 1, 3, 0, 1, 5, 0, 4, 7, 1, 5, 7, 7, 0, 7, 4, 5]"
251,5,19,14,5746,0,16,3,"[0, 0, 1, 0, 0, 0, 1, 1, 0, 0, 0, 1, 0, 1, 0, 1, 1, 0, 0, 1, 0, 0, 0, 1, 1, 0, 0]"
252,5,97,12,5831,0,40,57,"[18, 0, 10, 5, 0, 0, 15, 14, 10, 19, 11, 16, 9, 2, 8, 4, 10, 15, 2, 19, 6, 0, 6, 14, 4, 15, 9]"
253,5,81,28,5884,0,21,60,"[18, 4, 20, 18, 11, 0, 7, 13, 5, 13, 5, 9, 0, 17, 6, 7, 4, 12, 17, 1, 14, 17, 6, 13, 9, 4, 17]"
254,5,69,12,5941,0,3,66,"[12, 3, 16, 17, 10, 0, 9, 8, 5, 9, 10, 10, 6, 0, 2, 8, 8, 2, 1, 12, 8, 8, 15, 8, 2, 11, 11]"
255,5,73,18,5996,0,37,36,"[2, 12, 11, 9, 10, 0, 5, 9, 8, 5, 4, 4, 3, 5, 0, 5, 7, 1, 9, 10, 1, 1, 8, 10, 8, 7, 10]"
256,5,92,87,6001,0,32,60,"[0, 1, 20, 5, 4, 0, 10, 12, 11, 10, 1, 5, 1, 0, 8, 19, 1, 8, 10, 1, 17, 13, 3, 20, 7, 18, 16]"
257,5,58,40,6019,0,29,29,"[6, 7, 8, 1, 7, 0, 1, 5, 7, 0, 9, 4, 3, 7, 3, 2, 4, 0, 1, 7, 7, 3, 5, 1, 2, 3, 0]"
258,5,73,21,6071,0,38,35,"[10, 11, 5, 3, 0, 0, 1, 8, 2, 5, 9, 0, 2, 1, 6, 11, 11, 10, 9, 7, 1, 1, 8, 4, 11, 9, 0]"
259,5,13,2,6082,0,3,10,"[1, 3, 1, 3, 3, 0, 3, 3, 0, 2, 2, 3, 0, 2, 1, 0, 3, 1, 2, 0, 2, 2, 3, 3, 0, 3, 1]"
260,5,82,8,6156,0,25,57,"[15, 8, 11, 0, 16, 0, 5, 18, 2, 12, 5, 4, 3, 6, 3, 11, 8, 2, 18, 18, 13, 9, 17, 3, 15, 9, 13]"
261,5,39,1,6194,0,2,37,"[2, 5, 11, 12, 11, 0, 12, 5, 10, 5, 12, 1, 2, 1, 9, 8, 7, 0, 7, 2, 9, 9, 1, 3, 6, 0, 6]"
262,5,86,17,6263,0,22,64,"[11, 10, 7, 8, 13, 0, 2, 9, 20, 18, 14, 15, 21, 2, 17, 13, 18, 15, 15, 13, 21, 7, 5, 6, 6, 15, 1]"
263,5,85,55,6293,0,67,18,"[5, 5, 1, 2, 0, 0, 1, 4, 2, 5, 6, 1, 3, 3, 4, 4, 2, 1, 2, 3, 2, 6, 4, 4, 2, 3, 2]"
264,5,76,58,6311,0,17,59,"[3, 10, 6, 6, 17, 0, 18, 4, 9, 13, 6, 9, 11, 19, 15, 11, 18, 3, 17, 18, 19, 18, 5, 12, 17, 9, 3]"
265,5,72,65,6318,0,18,54,"[12, 7, 1, 7, 0, 0, 4, 14, 9, 1, 3, 13, 7, 15, 12, 16, 11, 2, 1, 3, 9, 12, 18, 9, 5, 1, 17]"
266,5,82,34,6366,0,22,60,"[9, 1, 5, 10, 1, 0, 16, 19, 6, 18, 7, 12, 11, 4, 13, 18, 17, 20, 3, 8, 4, 8, 8, 4, 6, 6, 20]"
267,5,43,21,6388,0,29,14,"[0, 3, 3, 2, 2, 0, 4, 2, 2, 2, 3, 2, 1, 3, 4, 1, 2, 4, 0, 3, 4, 1, 4, 1, 4, 4, 0]"
268,5,72,49,6411,0,56,16,"[2, 1, 5, 1, 3, 0, 0, 5, 3, 1, 1, 3, 3, 0, 4, 4, 2, 4, 1, 0, 2, 0, 3, 0, 2, 3, 5]"
269,5,91,29,6473,0,60,31,"[5, 4, 4, 4, 6, 0, 0, 9, 6, 3, 8, 5, 7, 4, 4, 4, 8, 8, 5, 0, 9, 10, 0, 4, 4, 3, 8]"
270,5,72,12,6533,0,6,66,"[21, 20, 5, 4, 4, 0, 4, 13, 0, 12, 8, 9, 5, 0, 0, 13, 16, 13, 21, 19, 10, 16, 15, 14, 16, 0, 13]"
271,5,69,14,6588,0,62,7,"[1, 2, 2, 2, 1, 0, 1, 1, 1, 0, 2, 2, 1, 0, 1, 0, 1, 2, 1, 1, 0, 1, 1, 0, 2, 1, 2]"
272,5,66,57,6597,0,44,22,"[7, 4, 1, 3, 1, 0, 4, 4, 3, 1, 1, 5, 4, 7, 0, 0, 3, 7, 5, 1, 5, 5, 6, 6, 0, 6, 3]"
273,5,77,76,6598,0,49,28,"[0, 0, 6, 7, 1, 0, 0, 7, 6, 0, 3, 4, 1, 6, 0, 5, 3, 0, 8, 2, 9, 5, 4, 0, 0, 7, 1]"
274,5,97,46,6649,0,33,64,"[4, 6, 8, 5, 6, 0, 4, 11, 11, 18, 17, 12, 18, 2, 10, 19, 3, 9, 10, 19, 21, 13, 15, 21, 7, 7, 5]"
275,5,68,24,6693,0,1,67,"[18, 1, 12, 16, 7, 0, 4, 2, 0, 7, 17, 9, 18, 16, 8, 4, 13, 2, 13, 2, 12, 20, 8, 21, 17, 21, 11]"
276,5,46,2,6737,0,10,36,"[0, 8, 10, 0, 12, 0, 7, 3, 9, 9, 1, 6, 9, 5, 12, 10, 4, 9, 4, 1, 2, 4, 8, 1, 4, 10, 12]"
277,5,63,34,6766,0,58,5,"[0, 0, 0, 0, 1, 0, 0, 1, 1, 0, 0, 0, 1, 1, 0, 0, 1, 1, 1, 0, 0, 1, 0, 0, 0, 1, 0]"
278,5,13,1,6778,0,0,13,"[3, 2, 2, 3, 3, 0, 2, 0, 3, 2, 3, 2, 4, 1, 3, 2, 0, 2, 1, 2, 1, 0, 2, 1, 2, 0, 0]"
279,5,49,31,6796,0,1,48,"[7, 3, 5, 16, 3, 0, 13, 16, 3, 15, 0, 11, 11, 15, 2, 14, 4, 9, 3, 3, 0, 11, 3, 2, 14, 5, 11]"
280,5,95,59,6832,0,72,23,"[0, 5, 7, 6, 5, 0, 6, 3, 5, 3, 2, 1, 4, 7, 1, 3, 1, 7, 5, 6, 7, 0, 4, 2, 5, 5, 7]"
281,5,11,3,6840,0,11,0,"[0, 0, 0, 0, 0, 0, 0, 0, 0, 0, 0, 0, 0, 0, 0, 0, 0, 0, 0, 0, 0, 0, 0, 0, 0, 0, 0]"
282,5,23,17,6846,0,19,4,"[1, 0, 0, 1, 1, 0, 0, 1, 1, 0, 0, 0, 1, 1, 1, 0, 1, 1, 1, 0, 1, 1, 0, 1, 0, 1, 1]"
283,5,6,0,6852,0,3,3,"[0, 1, 1, 1, 1, 0, 0, 1, 1, 1, 1, 1, 0, 0, 1, 0, 0, 1, 0, 0, 1, 0, 0, 1, 1, 1, 0]"
284,5,25,1,6876,0,14,11,"[1, 0, 0, 2, 1, 0, 2, 3, 0, 2, 1, 3, 0, 1, 1, 1, 3, 2, 0, 2, 0, 1, 1, 1, 2, 2, 3]"
285,5,92,0,6968,0,50,42,"[5, 1, 3, 10, 7, 0, 6, 7, 0, 6, 5, 2, 0, 9, 7, 10, 10, 9, 13, 10, 5, 1, 7, 2, 2, 5, 11]"
286,5,1,0,6877,0,0,1,"[0, 0, 0, 0, 0, 0, 0, 0, 0, 0, 0, 0, 0, 0, 0, 0, 0, 0, 0, 0, 0, 0, 0, 0, 0, 0, 0]"
287,5,77,18,6936,0,52,25,"[1, 5, 5, 3, 7, 0, 0, 0, 6, 2, 3, 8, 7, 2, 2, 3, 6, 6, 3, 6, 4, 0, 8, 1, 0, 4, 8]"
288,5,8,8,6936,0,3,5,"[1, 0, 1, 0, 1, 0, 1, 0, 1, 1, 0, 1, 0, 0, 1, 0, 1, 1, 1, 0, 0, 1, 0, 1, 0, 1, 0]"
289,5,6,0,6942,0,3,3,"[0, 1, 0, 1, 1, 0, 0, 1, 0, 1, 1, 0, 1, 0, 0, 0, 0, 1, 0, 0, 1, 1, 0, 0, 0, 1, 0]"
290,5,79,51,6970,0,39,40,"[12, 10, 1, 7, 13, 0, 6, 7, 7, 9, 11, 1, 3, 13, 1, 10, 9, 9, 6, 1, 4, 9, 9, 10, 2, 4, 9]"
291,5,6,1,6975,0,3,3,"[1, 1, 1, 1, 0, 0, 1, 1, 1, 0, 1, 0, 1, 1, 1, 0, 0, 0, 1, 0, 1, 1, 1, 1, 1, 1, 1]"
292,5,40,16,6999,0,33,7,"[2, 0, 1, 2, 0, 0, 1, 2, 1, 0, 0, 1, 2, 2, 0, 0, 0, 1, 1, 0, 1, 1, 1, 2, 0, 2, 0]"
293,5,76,4,7071,0,52,24,"[5, 3, 7, 4, 7, 0, 7, 2, 0, 3, 0, 5, 1, 0, 7, 0, 8, 6, 5, 8, 7, 3, 7, 5, 1, 5, 5]"
294,5,31,22,7080,0,6,25,"[2, 6, 3, 2, 8, 0, 8, 6, 7, 8, 0, 7, 5, 7, 5, 3, 1, 6, 1, 6, 1, 4, 4, 5, 5, 3, 1]"
295,5,78,10,7148,0,55,23,"[2, 0, 7, 4, 4, 0, 0, 4, 4, 2, 5, 4, 7, 3, 5, 6, 3, 5, 7, 0, 0, 7, 4, 5, 0, 7, 0]"
296,5,54,1,7201,0,10,44,"[5, 9, 8, 6, 11, 0, 5, 6, 7, 4, 8, 11, 12, 7, 11, 13, 11, 10, 10, 1, 11, 0, 3, 9, 1, 6, 10]"
297,5,18,9,7210,0,13,5,"[1, 1, 1, 1, 1, 0, 0, 0, 1, 0, 1, 1, 0, 0, 1, 0, 1, 1, 1, 1, 0, 1, 1, 1, 0, 1, 0]"
298,5,89,6,7293,0,48,41,"[9, 8, 13, 7, 8, 0, 7, 9, 1, 1, 0, 2, 2, 10, 13, 11, 13, 3, 13, 0, 3, 3, 11, 5, 0, 6, 4]"
299,5,74,37,7330,0,48,26,"[3, 4, 5, 7, 3, 0, 6, 7, 6, 6, 6, 5, 7, 2, 2, 2, 8, 2, 5, 0, 5, 7, 6, 6, 4, 5, 0]"
0,6,5940,0,5940,0,4750,1190,"[306, 3, 340, 72, 32, 0, 315, 210, 119, 131, 324, 132, 390, 247, 40, 110, 254, 140, 192, 172, 166, 204, 181, 72, 290, 66, 267, 12]"
1,6,6087,7373,4654,0,3838,2249,"[438, 496, 12, 240, 737, 0, 736, 318, 268, 239, 582, 92, 574, 164, 690, 153, 72, 171, 145, 737, 604, 78, 472, 354, 103, 69, 27, 237]"
2,6,6848,5657,5845,0,6572,276,"[91, 36, 54, 5, 12, 0, 7, 80, 68, 83, 67, 45, 27, 63, 78, 66, 33, 57, 52, 38, 76, 19, 12, 85, 1, 82, 28, 49]"
3,6,6682,5028,7499,0,1147,5535,"[402, 1233, 537, 1324, 437, 0, 615, 223, 1568, 883, 1825, 813, 1716, 948, 929, 1162, 1359, 349, 898, 181, 107, 962, 566, 1679, 240, 1304, 745, 878]"
4,6,6664,7195,6968,0,2533,4131,"[1083, 959, 1282, 1252, 1059, 0, 99, 456, 420, 548, 513, 122, 557, 1371, 604, 1341, 766, 17, 421, 775, 911, 335, 1251, 820, 972, 1143, 31, 1283]"
5,6,6466,7230,6204,0,3246,3220,"[740, 438, 60, 828, 244, 0, 939, 818, 915, 158, 157, 876, 863, 267, 237, 534, 374, 958, 619, 997, 413, 242, 676, 356, 527, 334, 44, 160]"
6,6,6490,5715,6979,0,1560,4930,"[489, 1479, 1227, 250, 8, 0, 310, 1448, 66, 1429, 1165, 1559, 159, 791, 1460, 758, 1154, 1184, 1288, 791, 1312, 1379, 43, 70, 683, 1171, 159, 1230]"
7,6,6953,7154,6778,0,6588,365,"[11, 120, 4, 111, 71, 0, 97, 26, 8, 16, 100, 96, 41, 36, 111, 79, 13, 38, 31, 37, 77, 56, 88, 13, 98, 31, 17, 94]"
8,6,6942,6074,7646,0,5918,1024,"[332, 211, 317, 54, 318, 0, 139, 137, 112, 51, 29, 36, 154, 87, 207, 294, 54, 56, 16, 231, 224, 112, 331, 222, 314, 128, 31, 96]"
9,6,5478,5265,7859,0,5193,285,"[79, 57, 58, 62, 0, 0, 9, 86, 49, 22, 61, 89, 44, 49, 1, 48, 18, 83, 90, 15, 56, 89, 94, 41, 47, 20, 62, 49]"
10,6,5405,6911,6353,0,2713,2692,"[410, 815, 790, 522, 687, 0, 154, 268, 822, 632, 329, 716, 300, 686, 91, 395, 651, 854, 625, 481, 858, 547, 831, 778, 846, 348, 78, 286]"
11,6,6586,5231,7708,0,957,5629,"[237, 449, 1806, 406, 88, 0, 511, 107, 1489, 510, 1075, 1327, 726, 937, 1383, 1398, 1177, 147, 1058, 1096, 47, 680, 676, 693, 1406, 953, 360, 192]"
12,6,6913,5342,9279,0,1503,5410,"[272, 1281, 937, 1684, 550, 0, 1360, 142, 53, 201, 837, 762, 216, 817, 750, 181, 22, 1188, 220, 1633, 138, 1559, 1247, 1429, 764, 928, 591, 1627]"
13,6,6652,5270,10000,661,5794,858,"[165, 245, 263, 108, 133, 0, 243, 32, 150, 24, 70, 71, 176, 203, 232, 232, 161, 241, 65, 8, 275, 251, 164, 44, 241, 110, 251, 125]"
14,6,6280,5271,10000,1009,181,6099,"[514, 817, 979, 1582, 1801, 0, 560, 881, 1102, 1690, 206, 1785, 775, 1086, 1532, 750, 656, 1913, 509, 1870, 1498, 1414, 1651, 1563, 1479, 699, 673, 1715]"
15,6,5806,5944,9862,0,1125,4681,"[226, 712, 835, 1025, 1408, 0, 0, 1550, 1463, 888, 627, 166, 207, 1466, 187, 561, 416, 644, 1145, 766, 1103, 1492, 442, 798, 103, 312, 226, 776]"
16,6,6070,6184,9748,0,5385,685,"[22, 140, 123, 180, 158, 0, 163, 35, 93, 102, 16, 13, 191, 88, 153, 163, 110, 183, 120, 157, 66, 112, 24, 86, 180, 59, 171, 46]"
17,6,5075,7271,7552,0,2207,2868,"[431, 339, 651, 379, 588, 0, 297, 64, 147, 792, 236, 265, 580, 364, 895, 712, 742, 62, 661, 511, 499, 527, 468, 705, 751, 838, 394, 802]"
18,6,5165,6775,5942,0,3693,1472,"[13, 251, 473, 223, 177, 0, 464, 469, 330, 483, 164, 435, 261, 456, 176, 112, 56, 347, 9, 439, 41, 47, 93, 187, 440, 444, 151, 132]"
19,6,5121,6368,4695,0,1181,3940,"[1214, 28, 1144, 658, 1045, 0, 146, 683, 1178, 260, 602, 970, 152, 1081, 1125, 945, 281, 152, 175, 930, 631, 380, 1270, 1267, 278, 1112, 1113, 1142]"
20,6,5002,3704,5993,0,1371,3631,"[863, 272, 287, 495, 510, 0, 863, 567, 104, 1177, 465, 34, 206, 787, 1071, 961, 832, 131, 219, 277, 7, 1066, 305, 6, 1007, 591, 731, 832]"
21,6,5868,5601,6260,0,3410,2458,"[636, 610, 730, 426, 554, 0, 88, 709, 457, 115, 247, 690, 108, 489, 304, 530, 755, 489, 544, 354, 634, 392, 347, 215, 409, 105, 677, 742]"
22,6,6150,7261,5149,0,4488,1662,"[476, 190, 445, 466, 283, 0, 343, 23, 287, 48, 76, 44, 539, 138, 538, 525, 354, 105, 487, 309, 297, 240, 305, 181, 74, 168, 305, 196]"
23,6,5979,7500,3628,0,4349,1630,"[433, 506, 423, 115, 449, 0, 418, 199, 496, 141, 298, 111, 283, 422, 453, 267, 499, 204, 377, 31, 71, 374, 89, 396, 361, 17, 275, 104]"
24,6,5589,4989,4228,0,5283,306,"[35, 96, 78, 55, 64, 0, 84, 50, 41, 11, 99, 37, 83, 36, 41, 56, 5, 101, 16, 102, 57, 7, 86, 56, 80, 70, 38, 51]"
25,6,6196,4181,6243,0,1003,5193,"[385, 990, 1414, 928, 953, 0, 688, 114, 309, 411, 151, 1434, 1325, 1538, 685, 793, 741, 473, 171, 1345, 1181, 1441, 1533, 48, 106, 1615, 742, 1363]"
26,6,5471,5135,6579,0,4305,1166,"[115, 6, 119, 326, 312, 0, 304, 303, 4, 207, 261, 303, 21, 83, 113, 364, 266, 141, 165, 56, 293, 272, 307, 219, 83, 90, 320, 131]"
27,6,6126,7332,5373,0,3608,2518,"[316, 348, 595, 579, 796, 0, 704, 261, 719, 200, 570, 17, 656, 211, 130, 197, 624, 789, 189, 195, 323, 564, 304, 239, 728, 475, 283, 126]"
28,6,5678,5144,5907,0,4041,1637,"[56, 247, 79, 217, 515, 0, 532, 474, 249, 41, 488, 184, 20, 193, 4, 350, 530, 249, 63, 497, 39, 6, 194, 491, 270, 27, 180, 206]"
29,6,5437,5962,5382,0,5211,226,"[41, 8, 32, 73, 8, 0, 59, 33, 59, 31, 72, 11, 35, 11, 2, 58, 12, 8, 40, 31, 62, 62, 1, 47, 47, 50, 2, 59]"
30,6,5249,2614,8017,0,5155,94,"[27, 12, 6, 12, 2, 0, 17, 18, 14, 2, 23, 5, 11, 26, 6, 15, 3, 20, 19, 15, 26, 28, 31, 22, 19, 6, 20, 14]"
31,6,6674,7158,7533,0,902,5772,"[501, 736, 779, 1514, 1441, 0, 1290, 1726, 98, 1343, 263, 282, 1103, 1683, 1464, 1824, 1252, 1672, 1357, 1675, 1218, 1784, 51, 1164, 490, 1355, 194, 500]"
32,6,6923,7364,7092,0,2707,4216,"[788, 1331, 1366, 834, 553, 0, 69, 1355, 164, 42, 966, 1205, 496, 1301, 16, 318, 1256, 783, 153, 359, 494, 1286, 1047, 651, 266, 204, 1247, 278]"
33,6,6379,7069,6402,0,4991,1388,"[40, 8, 19, 279, 442, 0, 115, 163, 298, 197, 328, 183, 54, 380, 375, 10, 313, 383, 458, 216, 192, 87, 352, 47, 326, 189, 157, 72]"
34,6,5737,6188,5951,0,4217,1520,"[278, 444, 436, 263, 349, 0, 135, 76, 117, 93, 490, 347, 476, 371, 193, 464, 64, 20, 242, 1, 385, 358, 356, 499, 443, 97, 102, 244]"
35,6,5399,6720,4630,0,1448,3951,"[909, 435, 1303, 967, 1027, 0, 703, 107, 541, 874, 812, 464, 1284, 507, 589, 550, 211, 876, 118, 1085, 902, 245, 100, 857, 867, 524, 1070, 700]"
36,6,6049,2213,8466,0,2762,3287,"[886, 90, 775, 1058, 124, 0, 367, 643, 313, 240, 533, 1055, 426, 336, 872, 740, 136, 863, 162, 779, 691, 811, 696, 669, 628, 640, 222, 940]"
37,6,5128,6540,7054,0,1039,4089,"[806, 163, 299, 566, 757, 0, 77, 476, 86, 106, 162, 916, 649, 1051, 794, 104, 34, 809, 1188, 970, 703, 1351, 970, 296, 238, 1136, 1317, 1021]"
38,6,6000,6458,6596,0,2760,3240,"[204, 407, 1076, 585, 360, 0, 223, 804, 675, 63, 915, 82, 802, 456, 931, 350, 524, 995, 800, 897, 37, 73, 851, 570, 217, 309, 47, 832]"
39,6,6499,5896,7199,0,4633,1866,"[404, 501, 402, 90, 501, 0, 86, 18, 105, 2, 407, 339, 30, 213, 108, 33, 570, 147, 469, 481, 231, 119, 173, 387, 383, 115, 357, 221]"
40,6,5165,6815,5549,0,1186,3979,"[399, 1036, 1297, 1233, 132, 0, 1220, 214, 1194, 381, 519, 1170, 831, 660, 1134, 586, 903, 444, 1146, 1178, 1214, 880, 516, 919, 1171, 111, 1048, 527]"
41,6,6171,7449,4271,0,1898,4273,"[536, 281, 836, 930, 1263, 0, 1298, 895, 1404, 1124, 1321, 828, 28, 340, 905, 953, 918, 1337, 1095, 828, 1187, 542, 82, 1152, 1172, 1158, 433, 843]"
42,6,5329,2171,7429,0,1371,3958,"[691, 209, 1035, 1154, 522, 0, 1060, 483, 1195, 828, 186, 1004, 701, 27, 1033, 1217, 901, 745, 1042, 589, 1299, 616, 981, 1135, 1109, 151, 132, 147]"
43,6,6717,7196,6950,0,6314,403,"[128, 65, 124, 11, 47, 0, 15, 121, 10, 113, 104, 20, 123, 70, 115, 35, 34, 94, 73, 97, 117, 130, 66, 63, 86, 61, 65, 9]"
44,6,5620,7331,5239,0,1872,3748,"[758, 485, 677, 498, 483, 0, 278, 104, 820, 452, 865, 1022, 573, 902, 1103, 726, 1059, 87, 1117, 1184, 476, 1128, 20, 683, 753, 805, 469, 782]"
45,6,5355,4246,6348,0,1314,4041,"[1150, 42, 935, 358, 1206, 0, 673, 988, 1171, 742, 277, 942, 1077, 338, 9, 1200, 14, 1345, 261, 20, 719, 565, 1000, 426, 1257, 126, 452, 1209]"
46,6,6131,7339,5140,0,1153,4978,"[290, 1589, 304, 1376, 504, 0, 1617, 718, 1385, 795, 1449, 1442, 1049, 713, 424, 1212, 321, 169, 618, 1497, 351, 1438, 12, 1455, 128, 732, 1396, 253]"
47,6,5074,1624,8590,0,1442,3632,"[751, 1049, 283, 86, 792, 0, 480, 1100, 62, 506, 916, 746, 268, 14, 177, 1077, 142, 822, 495, 582, 24, 871, 191, 161, 391, 712, 823, 254]"
48,6,6506,6561,8535,0,3646,2860,"[50, 272, 133, 352, 181, 0, 76, 495, 134, 787, 57, 791, 505, 59, 854, 291, 563, 34, 428, 324, 690, 884, 932, 53, 24, 266, 498, 116]"
49,6,6013,5754,8794,0,2889,3124,"[65, 436, 1015, 756, 342, 0, 275, 695, 607, 889, 142, 777, 369, 934, 199, 519, 107, 279, 114, 902, 747, 189, 951, 903, 628, 889, 686, 831]"
50,6,5713,6651,7856,0,4,5709,"[811, 935, 1734, 151, 1002, 0, 495, 509, 1257, 251, 1801, 1463, 902, 201, 563, 1009, 1128, 1685, 296, 1706, 828, 336, 267, 746, 843, 769, 189, 1491]"
51,6,6389,7266,6979,0,4398,1991,"[571, 470, 486, 30, 285, 0, 313, 537, 89, 559, 469, 21, 309, 211, 619, 351, 115, 176, 642, 534, 289, 5, 445, 529, 241, 155, 237, 346]"
52,6,5923,5169,7733,0,1516,4407,"[275, 1053, 848, 96, 918, 0, 275, 849, 288, 300, 937, 312, 738, 134, 1157, 281, 1380, 846, 1284, 512, 1462, 196, 1169, 1454, 567, 1440, 1395, 329]"
53,6,6319,6494,7558,0,4968,1351,"[239, 109, 339, 73, 426, 0, 100, 182, 227, 316, 181, 428, 87, 287, 416, 70, 103, 339, 127, 97, 302, 323, 199, 275, 218, 234, 155, 25]"
54,6,6505,5814,8249,0,3526,2979,"[686, 358, 358, 15, 305, 0, 801, 857, 202, 87, 344, 122, 947, 128, 548, 61, 711, 704, 207, 746, 531, 655, 144, 592, 432, 29, 725, 373]"
55,6,5123,5702,7670,0,4190,933,"[68, 205, 87, 250, 219, 0, 148, 83, 113, 17, 250, 110, 4, 35, 220, 216, 42, 138, 141, 16, 45, 183, 194, 59, 50, 165, 61, 206]"
56,6,5217,6003,6884,0,2450,2767,"[585, 261, 716, 494, 916, 0, 430, 167, 885, 318, 799, 471, 628, 829, 61, 154, 295, 137, 170, 743, 451, 591, 577, 209, 557, 80, 444, 379]"
57,6,5812,6174,6522,0,2117,3695,"[245, 1072, 460, 1071, 1185, 0, 120, 939, 625, 840, 1136, 91, 1225, 387, 442, 138, 262, 1057, 1084, 536, 785, 89, 942, 567, 444, 677, 483, 611]"
58,6,6392,5132,7782,0,4845,1547,"[323, 378, 402, 329, 42, 0, 89, 50, 95, 67, 98, 34, 398, 383, 177, 439, 479, 107, 68, 46, 391, 43, 235, 337, 212, 291, 258, 372]"
59,6,6381,5259,8904,0,279,6102,"[1284, 1562, 942, 936, 1055, 0, 289, 1823, 1905, 334, 1286, 807, 1889, 1292, 51, 115, 1936, 7, 496, 1475, 1213, 638, 1909, 2007, 1521, 777, 1686, 13]"
60,6,6855,5463,10000,296,4943,1912,"[379, 606, 539, 292, 15, 0, 350, 476, 41, 600, 408, 175, 312, 584, 92, 66, 277, 276, 275, 598, 127, 173, 245, 134, 616, 158, 277, 528]"
61,6,5816,6156,9660,0,4663,1153,"[371, 156, 217, 194, 135, 0, 189, 76, 310, 130, 45, 53, 250, 297, 295, 378, 351, 15, 171, 347, 285, 69, 307, 179, 135, 85, 109, 360]"
62,6,6702,5690,10000,672,3972,2730,"[574, 653, 506, 131, 875, 0, 879, 314, 401, 140, 661, 832, 817, 349, 895, 663, 369, 485, 78, 752, 739, 863, 315, 707, 92, 820, 54, 399]"
63,6,6312,5028,10000,1284,5322,990,"[156, 118, 197, 166, 145, 0, 73, 219, 296, 94, 18, 23, 248, 235, 17, 281, 209, 164, 143, 260, 177, 172, 156, 182, 58, 126, 116, 261]"
64,6,5836,6550,9286,0,4467,1369,"[304, 0, 228, 125, 133, 0, 65, 182, 258, 57, 100, 170, 393, 395, 67, 408, 264, 198, 358, 48, 456, 282, 336, 5, 224, 240, 102, 7]"
65,6,5803,5453,9636,0,3183,2620,"[222, 606, 496, 51, 343, 0, 146, 186, 301, 830, 268, 443, 409, 197, 823, 55, 515, 817, 606, 129, 787, 96, 526, 95, 769, 775, 585, 542]"
66,6,6456,5967,10000,125,5511,945,"[169, 175, 167, 201, 187, 0, 239, 234, 146, 178, 202, 237, 153, 6, 37, 189, 20, 142, 203, 217, 275, 275, 242, 20, 310, 222, 252, 34]"
67,6,6149,6561,9588,0,5979,170,"[45, 21, 9, 27, 52, 0, 10, 49, 14, 47, 37, 18, 20, 5, 26, 2, 22, 48, 6, 11, 31, 22, 6, 28, 5, 24, 18, 35]"
68,6,6712,6518,9782,0,6525,187,"[44, 24, 22, 7, 1, 0, 46, 60, 57, 45, 28, 36, 60, 31, 5, 17, 35, 7, 4, 8, 27, 18, 44, 28, 6, 42, 20, 47]"
69,6,6577,5878,10000,481,6217,360,"[54, 102, 32, 4, 54, 0, 86, 43, 17, 6, 17, 78, 22, 69, 110, 101, 82, 22, 39, 55, 4, 26, 61, 49, 74, 2, 76, 95]"
70,6,6436,5207,10000,1229,6171,265,"[78, 29, 8, 75, 0, 0, 26, 83, 69, 74, 65, 6, 87, 34, 0, 14, 4, 31, 61, 85, 34, 73, 80, 0, 25, 4, 42, 11]"
71,6,5261,7232,8029,0,809,4452,"[337, 550, 287, 1080, 867, 0, 1244, 77, 192, 1386, 294, 981, 288, 507, 307, 1230, 740, 925, 789, 1155, 1104, 1362, 699, 381, 350, 540, 912, 1315]"
72,6,5792,6749,7072,0,4962,830,"[221, 157, 76, 121, 201, 0, 203, 146, 130, 160, 252, 276, 6, 51, 14, 210, 130, 98, 207, 220, 205, 154, 70, 107, 222, 99, 15, 75]"
73,6,5155,6449,5778,0,1234,3921,"[80, 741, 982, 856, 219, 0, 1055, 855, 971, 108, 21, 613, 66, 846, 1211, 182, 861, 215, 958, 499, 238, 1032, 287, 76, 869, 366, 1158, 716]"
74,6,5244,5028,5994,0,3101,2143,"[502, 446, 125, 229, 680, 0, 122, 455, 165, 156, 640, 45, 357, 299, 382, 298, 96, 15, 219, 126, 679, 182, 585, 80, 68, 653, 20, 246]"
75,6,6788,6292,6490,0,6494,294,"[80, 86, 5, 49, 93, 0, 57, 74, 21, 35, 55, 9, 83, 27, 0, 69, 15, 83, 35, 17, 80, 66, 97, 83, 87, 5, 48, 70]"
76,6,5209,5763,5936,0,213,4996,"[236, 1618, 405, 1030, 344, 0, 123, 1611, 1316, 557, 1026, 1157, 983, 88, 803, 1349, 936, 1136, 911, 48, 244, 1013, 1534, 1291, 257, 389, 1083, 1321]"
77,6,6905,6827,6014,0,2727,4178,"[487, 21, 1062, 574, 1081, 0, 32, 1063, 195, 52, 714, 211, 766, 1232, 4, 49, 599, 1226, 924, 434, 1004, 266, 1246, 620, 593, 1108, 1355, 770]"
78,6,5968,5238,6744,0,1211,4757,"[874, 224, 1578, 1459, 1077, 0, 557, 674, 895, 6, 64, 413, 399, 246, 754, 300, 1207, 419, 633, 1052, 1303, 1012, 647, 510, 42, 719, 173, 427]"
79,6,5184,7414,4514,0,1325,3859,"[1112, 1225, 563, 257, 268, 0, 334, 334, 120, 617, 468, 479, 51, 393, 546, 1207, 1184, 14, 991, 986, 40, 173, 867, 344, 676, 126, 987, 196]"
80,6,5032,114,9432,0,2793,2239,"[569, 38, 377, 426, 18, 0, 437, 664, 523, 301, 497, 268, 573, 347, 534, 159, 169, 569, 299, 687, 675, 497, 502, 474, 28, 181, 323, 552]"
81,6,5756,5474,9714,0,1450,4306,"[1354, 88, 978, 1367, 1362, 0, 825, 361, 1072, 1415, 10, 341, 69, 366, 1219, 989, 232, 688, 648, 1281, 866, 921, 1108, 1329, 1163, 491, 1402, 454]"
82,6,5256,5811,9159,0,2688,2568,"[309, 754, 638, 523, 782, 0, 144, 389, 227, 286, 533, 238, 544, 716, 84, 518, 361, 54, 574, 83, 513, 712, 605, 647, 797, 766, 501, 384]"
83,6,5702,5327,9534,0,2554,3148,"[187, 221, 528, 664, 266, 0, 241, 715, 1031, 766, 99, 283, 498, 570, 987, 356, 578, 787, 789, 900, 45, 511, 777, 943, 596, 976, 732, 1048]"
84,6,5620,6970,8184,0,4954,666,"[112, 148, 75, 64, 42, 0, 64, 133, 42, 150, 56, 50, 169, 117, 123, 90, 106, 25, 36, 201, 69, 5, 164, 113, 177, 110, 222, 140]"
85,6,5441,7131,6494,0,487,4954,"[679, 1456, 727, 963, 108, 0, 813, 1173, 1384, 1050, 269, 1149, 1250, 561, 1606, 1088, 1558, 1266, 440, 1302, 1563, 49, 523, 1109, 1642, 586, 1316, 1261]"
86,6,5973,7208,5259,0,4366,1607,"[514, 172, 354, 11, 229, 0, 522, 449, 183, 474, 374, 36, 64, 148, 463, 372, 101, 247, 303, 90, 339, 214, 475, 189, 379, 89, 475, 433]"
87,6,5055,442,9872,0,2927,2128,"[603, 479, 33, 394, 345, 0, 233, 486, 243, 160, 201, 323, 7, 225, 422, 675, 556, 688, 348, 343, 228, 57, 523, 613, 676, 436, 226, 155]"
88,6,6056,6794,9134,0,1803,4253,"[709, 144, 1094, 1121, 120, 0, 873, 895, 91, 1301, 343, 828, 860, 807, 968, 569, 455, 344, 380, 1410, 978, 183, 930, 373, 1080, 943, 862, 1008]"
89,6,6733,5957,9910,0,3021,3712,"[959, 249, 296, 1217, 232, 0, 221, 599, 1201, 674, 608, 1221, 1168, 277, 888, 513, 632, 88, 60, 206, 622, 1147, 999, 972, 753, 358, 478, 110]"
90,6,5387,5179,10000,118,84,5303,"[524, 507, 1334, 919, 45, 0, 1298, 655, 1058, 1547, 414, 65, 989, 1631, 1551, 1493, 1415, 501, 830, 386, 1583, 804, 1679, 1087, 609, 408, 844, 389]"
91,6,5299,5772,9527,0,4947,352,"[108, 80, 72, 23, 40, 0, 5, 94, 37, 16, 24, 7, 111, 96, 76, 30, 24, 92, 116, 110, 28, 91, 60, 29, 108, 90, 80, 92]"
92,6,5892,5026,10000,393,5512,380,"[46, 81, 70, 41, 39, 0, 78, 60, 94, 84, 57, 7, 92, 122, 87, 85, 88, 36, 84, 30, 16, 60, 125, 37, 49, 116, 47, 17]"
93,6,5134,5232,9902,0,2450,2684,"[415, 122, 649, 786, 573, 0, 793, 543, 460, 283, 222, 450, 107, 137, 313, 720, 230, 23, 815, 67, 258, 517, 328, 364, 704, 721, 40, 804]"
94,6,5690,7084,8508,0,1314,4376,"[203, 185, 1299, 859, 940, 0, 980, 1365, 285, 105, 301, 1097, 1340, 747, 910, 376, 853, 1202, 646, 947, 1217, 582, 1083, 833, 454, 801, 1435, 908]"
95,6,6023,5419,9112,0,1051,4972,"[1117, 1608, 568, 1165, 123, 0, 1218, 188, 1106, 1317, 1435, 1051, 1238, 1082, 284, 1599, 912, 118, 1424, 1582, 237, 85, 919, 1078, 879, 449, 637, 196]"
96,6,5053,5907,8258,0,3570,1483,"[486, 472, 218, 232, 181, 0, 198, 348, 344, 54, 174, 121, 414, 237, 311, 208, 422, 347, 118, 306, 19, 427, 25, 89, 192, 3, 396, 412]"
97,6,6644,5237,9665,0,4681,1963,"[470, 466, 214, 99, 314, 0, 625, 322, 385, 125, 39, 459, 68, 423, 319, 516, 100, 641, 441, 604, 527, 545, 172, 341, 506, 180, 53, 235]"
98,6,5486,6806,8345,0,4968,518,"[91, 73, 33, 13, 135, 0, 90, 60, 69, 121, 145, 56, 109, 47, 7, 120, 40, 108, 171, 102, 122, 111, 153, 159, 158, 16, 137, 130]"
99,6,5112,6786,6671,0,2645,2467,"[512, 131, 371, 118, 620, 0, 40, 121, 303, 724, 406, 58, 31, 571, 22, 660, 713, 269, 545, 396, 683, 690, 537, 34, 217, 654, 398, 394]"
100,6,5095,5793,5973,0,4343,752,"[51, 171, 55, 244, 207, 0, 172, 238, 107, 146, 235, 0, 10, 190, 211, 76, 156, 12, 208, 119, 198, 131, 144, 139, 185, 141, 168, 227]"
101,6,5751,5037,6687,0,410,5341,"[432, 517, 341, 878, 51, 0, 672, 1168, 84, 771, 80, 940, 942, 1698, 1613, 1524, 499, 617, 53, 1044, 262, 1656, 1363, 910, 724, 813, 153, 841]"
102,6,6393,6340,6740,0,6202,191,"[40, 0, 11, 50, 12, 0, 12, 44, 14, 22, 22, 59, 21, 42, 19, 0, 13, 4, 29, 24, 62, 55, 15, 50, 56, 1, 4, 36]"
103,6,6536,5588,7688,0,5220,1316,"[45, 103, 59, 75, 29, 0, 324, 212, 289, 208, 217, 208, 411, 75, 276, 103, 178, 121, 87, 38, 163, 428, 237, 107, 127, 90, 94, 178]"
104,6,5948,6775,6861,0,5717,231,"[2, 4, 52, 45, 46, 0, 22, 60, 65, 8, 8, 38, 11, 15, 19, 27, 26, 49, 18, 29, 16, 17, 6, 46, 29, 55, 23, 5]"
105,6,5672,6994,5539,0,1283,4389,"[473, 125, 1028, 481, 380, 0, 329, 131, 655, 231, 964, 1100, 1183, 1236, 331, 699, 1368, 1008, 1353, 40, 1111, 17, 314, 828, 352, 759, 211, 1178]"
106,6,5468,6410,4597,0,5453,15,"[5, 2, 2, 0, 2, 0, 0, 1, 0, 4, 5, 3, 2, 0, 3, 5, 2, 2, 5, 1, 3, 0, 1, 0, 4, 0, 4, 2]"
107,6,6969,5046,6520,0,4809,2160,"[31, 192, 183, 209, 324, 0, 271, 357, 136, 166, 451, 631, 568, 533, 34, 183, 47, 92, 183, 128, 157, 208, 567, 246, 396, 548, 439, 442]"
108,6,5923,5364,7079,0,4392,1531,"[31, 342, 161, 455, 274, 0, 261, 474, 174, 37, 341, 52, 308, 403, 106, 272, 234, 162, 190, 457, 206, 311, 60, 173, 207, 258, 240, 82]"
109,6,6925,5586,8418,0,1414,5511,"[1309, 1585, 778, 738, 335, 0, 876, 236, 921, 539, 1076, 1392, 1425, 1358, 376, 1239, 1012, 1374, 372, 213, 947, 848, 1094, 1114, 980, 1404, 1555, 969]"
110,6,6570,6342,8646,0,459,6111,"[1326, 1585, 1350, 1032, 1154, 0, 1750, 1020, 1415, 1273, 1040, 218, 839, 1868, 781, 358, 1896, 1707, 1975, 1313, 551, 143, 1974, 1460, 1943, 1912, 64, 16]"
111,6,5163,5379,8430,0,3356,1807,"[198, 122, 511, 519, 493, 0, 163, 526, 240, 366, 476, 189, 156, 163, 435, 411, 353, 236, 471, 250, 183, 107, 356, 451, 173, 409, 447, 20]"
112,6,6151,5808,8773,0,1938,4213,"[1126, 979, 940, 525, 318, 0, 88, 733, 1231, 760, 1332, 58, 124, 783, 1126, 1082, 612, 652, 197, 816, 850, 521, 1299, 700, 748, 212, 880, 1023]"
113,6,5737,6663,7847,0,5422,315,"[41, 40, 2, 65, 48, 0, 97, 19, 84, 8, 66, 83, 92, 90, 32, 54, 47, 85, 85, 103, 104, 3, 67, 102, 101, 40, 42, 50]"
114,6,5127,6568,6406,0,4211,916,"[305, 45, 72, 52, 263, 0, 284, 179, 103, 140, 280, 62, 44, 232, 288, 165, 30, 120, 206, 159, 20, 242, 299, 221, 69, 75, 264, 126]"
115,6,5623,5468,6561,0,1159,4464,"[568, 119, 1401, 557, 1102, 0, 946, 395, 1004, 147, 222, 986, 136, 1344, 1388, 49, 555, 626, 528, 715, 676, 744, 216, 1011, 841, 760, 1456, 756]"
116,6,6586,5445,7702,0,2619,3967,"[582, 180, 903, 238, 379, 0, 993, 116, 1303, 472, 832, 1280, 940, 1197, 206, 637, 1303, 914, 725, 1111, 613, 1080, 402, 155, 954, 381, 504, 808]"
117,6,5311,6828,6185,0,2370,2941,"[904, 868, 499, 192, 278, 0, 685, 438, 882, 764, 210, 823, 135, 84, 978, 642, 463, 20, 934, 792, 813, 957, 873, 937, 232, 38, 754, 882]"
118,6,5592,5889,5888,0,2302,3290,"[917, 1061, 534, 975, 900, 0, 621, 374, 678, 406, 477, 443, 557, 897, 826, 555, 429, 409, 406, 171, 90, 1062, 750, 295, 569, 1079, 367, 27]"
119,6,5655,7171,4372,0,3424,2231,"[493, 421, 264, 577, 391, 0, 72, 477, 695, 491, 99, 709, 46, 338, 261, 364, 132, 216, 291, 475, 548, 640, 280, 397, 482, 315, 409, 436]"
120,6,5520,237,9655,0,3342,2178,"[54, 149, 205, 483, 431, 0, 21, 137, 176, 357, 460, 557, 657, 578, 121, 462, 584, 708, 291, 268, 572, 603, 301, 568, 194, 236, 179, 79]"
121,6,5443,6331,8767,0,636,4807,"[1106, 1563, 1120, 594, 226, 0, 68, 1328, 530, 1119, 694, 1559, 325, 305, 609, 319, 101, 950, 772, 634, 1070, 1593, 386, 0, 695, 70, 690, 818]"
122,6,6738,6696,8809,0,439,6299,"[1645, 1306, 1670, 1865, 728, 0, 1393, 1364, 2004, 2084, 245, 287, 1237, 1819, 978, 862, 1504, 604, 971, 411, 554, 693, 981, 2039, 7, 1966, 302, 45]"
123,6,5391,5642,8558,0,2527,2864,"[83, 73, 906, 936, 128, 0, 626, 917, 294, 826, 570, 323, 664, 716, 620, 921, 89, 139, 357, 368, 719, 698, 96, 109, 589, 192, 728, 824]"
124,6,5554,5938,8174,0,5065,489,"[30, 58, 162, 8, 151, 0, 55, 134, 42, 71, 47, 88, 7, 91, 14, 121, 129, 146, 25, 88, 130, 87, 87, 76, 50, 30, 140, 96]"
125,6,6616,6981,7809,0,1482,5134,"[564, 681, 1155, 1476, 37, 0, 1164, 75, 64, 1349, 810, 1424, 169, 787, 716, 957, 1498, 1444, 1011, 494, 660, 1241, 214, 1436, 704, 660, 861, 1494]"
126,6,5335,7107,6037,0,503,4832,"[1515, 407, 1594, 1574, 783, 0, 339, 1498, 1026, 451, 185, 173, 815, 712, 522, 305, 1143, 1380, 530, 1295, 1181, 418, 557, 702, 68, 1148, 1553, 1186]"
127,6,6692,5975,6754,0,2866,3826,"[357, 565, 153, 48, 440, 0, 1131, 1098, 109, 403, 18, 278, 968, 56, 874, 236, 592, 387, 302, 866, 173, 757, 91, 1076, 1228, 922, 750, 1102]"
128,6,6898,6567,7085,0,5163,1735,"[553, 103, 514, 129, 228, 0, 135, 66, 364, 19, 392, 193, 522, 126, 55, 383, 175, 536, 437, 17, 478, 214, 392, 83, 81, 96, 60, 453]"
129,6,6670,5552,8203,0,1980,4690,"[994, 2, 473, 957, 670, 0, 1060, 623, 239, 1534, 1544, 1002, 798, 1379, 1406, 162, 737, 763, 1260, 773, 958, 1476, 592, 773, 371, 1195, 1325, 1541]"
130,6,6829,5443,9589,0,3569,3260,"[208, 114, 376, 496, 871, 0, 312, 22, 837, 942, 618, 395, 287, 549, 289, 808, 172, 866, 10, 1076, 848, 382, 230, 812, 11, 490, 930, 384]"
131,6,5795,6683,8701,0,4088,1707,"[130, 109, 548, 41, 146, 0, 23, 36, 106, 565, 308, 526, 152, 569, 132, 60, 138, 220, 244, 477, 242, 231, 514, 380, 523, 563, 142, 193]"
132,6,5876,7378,7199,0,855,5021,"[1384, 39, 95, 897, 1553, 0, 414, 758, 1410, 540, 216, 1179, 5, 13, 850, 1025, 1010, 347, 265, 197, 1423, 572, 1087, 1213, 1185, 1079, 1268, 1015]"
133,6,5175,6599,5775,0,807,4368,"[661, 1088, 1391, 672, 629, 0, 1442, 1226, 347, 1064, 466, 216, 656, 196, 1079, 1216, 117, 706, 145, 1046, 1300, 195, 1380, 48, 595, 727, 1178, 1345]"
134,6,5166,4694,6247,0,1972,3194,"[244, 307, 575, 249, 527, 0, 470, 459, 274, 993, 1059, 668, 667, 946, 140, 842, 984, 715, 793, 972, 844, 24, 121, 607, 289, 44, 142, 12]"
135,6,5903,7181,4969,0,753,5150,"[1214, 533, 1521, 750, 1201, 0, 58, 845, 921, 148, 1030, 450, 230, 1180, 487, 1645, 536, 1000, 929, 69, 231, 608, 287, 1120, 670, 1431, 1132, 1270]"
136,6,6900,6303,5566,0,4152,2748,"[680, 344, 195, 894, 634, 0, 665, 133, 735, 135, 295, 219, 273, 674, 258, 915, 346, 122, 268, 198, 720, 666, 37, 845, 16, 568, 454, 186]"
137,6,6982,5518,7030,0,6888,94,"[13, 26, 10, 12, 5, 0, 2, 1, 6, 21, 1, 10, 17, 20, 18, 28, 26, 1, 13, 17, 19, 3, 30, 27, 9, 27, 0, 26]"
138,6,5553,5042,7541,0,3536,2017,"[623, 80, 319, 281, 103, 0, 136, 78, 519, 69, 384, 645, 99, 86, 362, 497, 16, 576, 582, 374, 153, 409, 300, 280, 260, 563, 159, 107]"
139,6,5690,6940,6291,0,3158,2532,"[539, 388, 624, 423, 187, 0, 429, 138, 747, 483, 322, 239, 139, 36, 794, 381, 67, 279, 645, 107, 303, 674, 230, 169, 785, 536, 800, 636]"
140,6,6549,6440,6400,0,5648,901,"[98, 156, 7, 198, 274, 0, 67, 282, 157, 221, 118, 150, 231, 268, 156, 273, 78, 279, 270, 59, 190, 200, 154, 22, 255, 266, 62, 190]"
141,6,6961,6110,7251,0,2768,4193,"[562, 473, 21, 686, 366, 0, 692, 308, 77, 808, 857, 235, 268, 759, 814, 651, 432, 887, 93, 303, 342, 1079, 871, 777, 823, 629, 658, 570]"
142,6,5501,5977,6775,0,876,4625,"[1190, 1170, 137, 286, 77, 0, 584, 432, 1061, 1269, 557, 1529, 299, 217, 1438, 1055, 373, 1520, 17, 1476, 1223, 1170, 478, 468, 1502, 1528, 245, 476]"
143,6,6375,6540,6610,0,1709,4666,"[1176, 396, 393, 94, 497, 0, 1353, 1311, 1224, 547, 401, 1297, 489, 283, 1155, 488, 198, 429, 1323, 1139, 1, 977, 1109, 191, 294, 347, 212, 563]"
144,6,6523,6577,6556,0,4302,2221,"[119, 412, 629, 702, 95, 0, 563, 96, 35, 33, 351, 556, 260, 1, 167, 70, 683, 362, 92, 375, 175, 106, 619, 722, 129, 76, 406, 685]"
145,6,5101,6080,5577,0,3307,1794,"[577, 285, 114, 331, 303, 0, 401, 458, 448, 493, 402, 585, 515, 512, 366, 44, 544, 243, 328, 135, 87, 99, 108, 47, 271, 203, 305, 54]"
146,6,5042,604,10000,15,3773,1269,"[375, 322, 371, 310, 294, 0, 222, 385, 238, 167, 203, 226, 413, 343, 378, 106, 235, 22, 287, 141, 105, 346, 39, 36, 110, 357, 84, 117]"
147,6,6835,6625,10000,210,4034,2801,"[830, 464, 143, 840, 770, 0, 667, 152, 717, 929, 635, 582, 464, 127, 79, 363, 489, 815, 432, 7, 558, 714, 640, 924, 700, 326, 376, 535]"
148,6,6048,7219,8829,0,5861,187,"[32, 62, 22, 42, 39, 0, 13, 57, 57, 44, 18, 56, 28, 48, 40, 16, 34, 1, 47, 13, 28, 31, 14, 6, 17, 50, 29, 14]"
149,6,5550,6323,8056,0,4551,999,"[206, 92, 286, 222, 319, 0, 100, 88, 276, 27, 17, 273, 332, 323, 148, 19, 209, 81, 196, 103, 204, 0, 278, 2, 247, 258, 180, 59]"
150,6,6229,5982,8303,0,723,5506,"[202, 941, 602, 677, 1445, 0, 1010, 755, 1753, 1275, 1797, 331, 1760, 685, 1709, 643, 1066, 387, 305, 811, 958, 1036, 1529, 1156, 1612, 993, 1527, 1785]"
151,6,5732,5338,8697,0,62,5670,"[49, 1829, 844, 1736, 853, 0, 297, 996, 1574, 1235, 436, 1469, 33, 235, 1083, 1249, 478, 1579, 908, 563, 969, 721, 724, 1593, 1111, 1149, 867, 43]"
152,6,5706,5965,8438,0,90,5616,"[788, 60, 1040, 299, 1801, 0, 468, 292, 1653, 1127, 1744, 1558, 1473, 1101, 79, 222, 639, 688, 265, 380, 530, 1478, 274, 537, 20, 1314, 56, 1853]"
153,6,5740,6842,7336,0,1106,4634,"[1297, 219, 758, 1476, 1499, 0, 862, 781, 1034, 335, 548, 499, 526, 668, 1529, 1330, 1505, 1478, 900, 432, 113, 1298, 58, 208, 892, 727, 515, 1388]"
154,6,6980,6417,7899,0,3800,3180,"[778, 644, 418, 252, 923, 0, 843, 749, 282, 327, 449, 756, 2, 675, 468, 300, 211, 929, 382, 102, 982, 139, 920, 1021, 403, 69, 79, 886]"
155,6,5036,5385,7550,0,1660,3376,"[695, 992, 1069, 716, 192, 0, 758, 775, 1017, 511, 201, 509, 444, 457, 543, 737, 359, 248, 689, 37, 116, 175, 997, 260, 496, 496, 857, 368]"
156,6,6809,5704,8655,0,541,6268,"[1853, 599, 479, 166, 401, 0, 198, 1188, 1110, 1444, 1002, 1803, 51, 1472, 825, 114, 444, 1277, 247, 366, 624, 1754, 1483, 140, 1953, 384, 962, 1708]"
157,6,6793,7086,8362,0,97,6696,"[476, 1048, 1961, 2196, 895, 0, 495, 530, 1164, 307, 1849, 665, 2045, 657, 2121, 118, 710, 1418, 1434, 446, 421, 1093, 2034, 1749, 1022, 2194, 1341, 1152]"
158,6,5401,6725,7038,0,2305,3096,"[984, 731, 741, 819, 899, 0, 568, 280, 260, 494, 501, 971, 591, 76, 902, 946, 569, 211, 514, 142, 199, 724, 646, 167, 843, 203, 826, 514]"
159,6,6381,5623,7796,0,5600,781,"[166, 184, 81, 257, 225, 0, 140, 230, 51, 78, 42, 243, 44, 72, 105, 57, 54, 134, 189, 142, 162, 91, 142, 149, 40, 151, 129, 69]"
160,6,6667,6771,7692,0,5507,1160,"[308, 349, 194, 141, 4, 0, 3, 48, 126, 246, 100, 5, 71, 26, 311, 272, 319, 265, 49, 57, 343, 223, 242, 309, 55, 266, 3, 227]"
161,6,6556,6436,7812,0,4896,1660,"[502, 460, 256, 522, 276, 0, 80, 507, 5, 478, 39, 144, 71, 552, 16, 134, 445, 77, 462, 377, 256, 122, 474, 481, 27, 274, 178, 288]"
162,6,5154,6681,6285,0,27,5127,"[124, 359, 1385, 1571, 655, 0, 1223, 380, 1489, 968, 1039, 1698, 817, 981, 1239, 753, 741, 1138, 1520, 1209, 582, 1084, 698, 1132, 780, 620, 1375, 760]"
163,6,6986,6641,6630,0,5626,1360,"[170, 14, 366, 301, 71, 0, 449, 413, 272, 44, 417, 139, 99, 217, 358, 266, 204, 324, 380, 280, 435, 148, 181, 128, 173, 379, 301, 382]"
164,6,5889,6953,5566,0,1358,4531,"[805, 882, 568, 1055, 1198, 0, 993, 597, 1467, 92, 1224, 599, 293, 1148, 713, 624, 566, 284, 580, 684, 118, 1437, 1066, 1273, 1294, 1165, 1252, 1299]"
165,6,6606,6288,5884,0,2832,3774,"[465, 117, 54, 1047, 630, 0, 614, 936, 192, 212, 496, 1033, 1230, 1223, 541, 385, 791, 576, 1093, 32, 812, 401, 500, 74, 841, 381, 712, 1035]"
166,6,5095,1348,9631,0,879,4216,"[712, 518, 1311, 109, 259, 0, 666, 1135, 1127, 1359, 755, 1394, 1020, 805, 1155, 739, 1319, 225, 207, 788, 611, 1219, 410, 120, 1401, 441, 1153, 1122]"
167,6,6593,6900,9324,0,3185,3408,"[1126, 985, 812, 389, 904, 0, 5, 932, 769, 1057, 947, 248, 224, 33, 610, 285, 535, 867, 542, 1049, 839, 896, 550, 731, 340, 1009, 823, 355]"
168,6,6101,5597,9828,0,5062,1039,"[131, 205, 40, 197, 7, 0, 111, 217, 12, 184, 48, 37, 323, 3, 317, 102, 278, 248, 136, 323, 15, 219, 241, 320, 228, 8, 303, 186]"
169,6,6594,7233,9189,0,1137,5457,"[1260, 296, 395, 1790, 1286, 0, 1578, 194, 1096, 1009, 752, 150, 1613, 1702, 1660, 1584, 42, 1606, 729, 1520, 613, 1206, 369, 679, 101, 392, 1770, 1771]"
170,6,6472,5342,10000,319,3389,3083,"[191, 551, 480, 739, 179, 0, 943, 997, 816, 323, 452, 771, 1026, 821, 176, 305, 971, 149, 868, 496, 713, 730, 971, 118, 130, 979, 271, 617]"
171,6,5296,6339,8957,0,2155,3141,"[625, 52, 186, 978, 912, 0, 861, 421, 892, 82, 809, 1002, 272, 775, 331, 944, 663, 448, 969, 423, 194, 440, 403, 608, 815, 1047, 685, 992]"
172,6,6878,7278,8557,0,593,6285,"[1509, 1630, 915, 1490, 575, 0, 842, 1402, 163, 1596, 1031, 712, 1443, 1071, 1786, 1004, 939, 1735, 2055, 136, 1407, 603, 192, 898, 410, 181, 1297, 281]"
173,6,5697,5038,9216,0,1227,4470,"[968, 919, 1066, 1190, 1246, 0, 570, 953, 1055, 691, 1117, 1095, 1440, 112, 1251, 578, 623, 1263, 913, 1094, 658, 1011, 817, 1128, 506, 644, 774, 1435]"
174,6,5929,6084,9061,0,1396,4533,"[1319, 610, 302, 633, 1340, 0, 476, 492, 875, 648, 1044, 1297, 683, 1134, 910, 714, 1381, 195, 1084, 819, 232, 284, 1190, 1044, 1126, 1289, 1042, 411]"
175,6,5689,6005,8745,0,1258,4431,"[241, 128, 1308, 292, 875, 0, 149, 1101, 319, 1273, 328, 1322, 16, 454, 786, 1153, 1413, 603, 263, 508, 1229, 1216, 1019, 235, 1150, 1468, 48, 1265]"
176,6,5397,7315,6827,0,2740,2657,"[299, 374, 269, 401, 811, 0, 157, 858, 674, 12, 840, 151, 267, 686, 469, 312, 628, 450, 82, 593, 837, 591, 377, 862, 135, 588, 328, 103]"
177,6,6499,5425,7901,0,507,5992,"[337, 760, 1714, 824, 1401, 0, 1251, 1277, 1707, 1654, 656, 1592, 1928, 776, 830, 687, 1470, 315, 861, 1037, 529, 1766, 1918, 99, 1641, 162, 51, 901]"
178,6,6721,7247,7375,0,5391,1330,"[109, 201, 278, 129, 68, 0, 239, 371, 423, 385, 32, 382, 266, 215, 168, 337, 8, 398, 153, 12, 8, 314, 443, 79, 137, 240, 285, 111]"
179,6,6325,6502,7198,0,1509,4816,"[323, 774, 576, 445, 1146, 0, 454, 1513, 1035, 164, 217, 470, 178, 1054, 572, 550, 0, 998, 1505, 423, 71, 166, 1392, 180, 439, 1330, 119, 25]"
180,6,6323,5068,8453,0,16,6307,"[1963, 2021, 511, 1202, 204, 0, 873, 166, 242, 2072, 771, 431, 1488, 33, 2066, 1115, 439, 564, 232, 1878, 2076, 224, 575, 335, 1761, 1851, 1790, 1090]"
181,6,6117,6067,8503,0,4234,1883,"[102, 482, 250, 503, 611, 0, 210, 388, 539, 412, 440, 412, 521, 197, 405, 90, 109, 264, 370, 286, 440, 359, 414, 382, 453, 530, 386, 530]"
182,6,5121,6114,7510,0,527,4594,"[875, 997, 1250, 563, 1371, 0, 622, 309, 235, 992, 1496, 658, 275, 1187, 723, 844, 687, 1121, 1001, 93, 1202, 1500, 1428, 1232, 456, 1148, 1017, 818]"
183,6,6857,6622,7745,0,5041,1816,"[485, 363, 530, 388, 189, 0, 569, 120, 490, 349, 304, 166, 323, 277, 575, 223, 261, 227, 110, 425, 321, 273, 302, 138, 77, 87, 566, 444]"
184,6,5683,6163,7265,0,209,5474,"[1536, 1020, 1585, 455, 1077, 0, 166, 1458, 835, 382, 153, 1806, 1782, 263, 523, 179, 1648, 1234, 540, 870, 119, 195, 1453, 1595, 312, 671, 660, 1713]"
185,6,6001,7343,5923,0,5645,356,"[113, 87, 18, 29, 15, 0, 118, 43, 29, 73, 107, 64, 12, 103, 12, 80, 30, 37, 53, 77, 82, 118, 95, 65, 7, 79, 33, 75]"
186,6,5291,6691,4523,0,4463,828,"[67, 70, 91, 174, 265, 0, 30, 4, 209, 196, 119, 43, 90, 211, 125, 15, 108, 274, 60, 139, 12, 60, 228, 162, 147, 83, 206, 266]"
187,6,5570,282,9811,0,3364,2206,"[252, 650, 520, 513, 68, 0, 408, 526, 458, 565, 518, 389, 57, 608, 250, 398, 324, 313, 1, 442, 114, 7, 659, 77, 637, 183, 85, 549]"
188,6,5792,5955,9648,0,1740,4052,"[12, 47, 622, 1255, 704, 0, 900, 988, 1294, 1005, 844, 494, 1026, 60, 1185, 452, 596, 1301, 1121, 784, 1152, 730, 1117, 780, 379, 20, 230, 647]"
189,6,5837,5343,10000,142,765,5072,"[104, 1173, 939, 28, 1640, 0, 3, 65, 207, 961, 1, 1549, 783, 1153, 1618, 925, 66, 201, 1257, 375, 42, 47, 515, 830, 992, 998, 1585, 1046]"
190,6,6711,5361,10000,1350,4835,1876,"[108, 517, 537, 616, 197, 0, 553, 429, 73, 174, 576, 186, 625, 366, 71, 42, 179, 150, 477, 25, 322, 256, 508, 475, 256, 254, 226, 572]"
191,6,5499,6374,9125,0,3488,2011,"[516, 435, 655, 506, 228, 0, 414, 472, 558, 340, 659, 379, 257, 476, 410, 58, 211, 80, 57, 387, 314, 568, 401, 293, 398, 7, 1, 539]"
192,6,5506,6870,7761,0,1383,4123,"[1351, 1159, 117, 1098, 881, 0, 222, 927, 862, 102, 299, 972, 1351, 617, 612, 84, 244, 1346, 580, 987, 647, 483, 1366, 575, 142, 576, 311, 1059]"
193,6,6438,5058,9141,0,6404,34,"[7, 4, 8, 10, 11, 0, 7, 4, 1, 10, 9, 10, 6, 4, 9, 7, 5, 10, 0, 9, 2, 6, 2, 5, 7, 3, 2, 1]"
194,6,6771,5107,10000,805,6006,765,"[219, 243, 99, 30, 142, 0, 211, 49, 216, 33, 54, 218, 12, 11, 215, 107, 108, 234, 55, 226, 211, 114, 255, 212, 99, 214, 7, 68]"
195,6,6260,6607,9653,0,5682,578,"[29, 58, 143, 9, 187, 0, 85, 27, 3, 107, 64, 83, 149, 125, 44, 101, 141, 5, 140, 170, 9, 30, 116, 122, 147, 56, 171, 86]"
196,6,5519,6453,8719,0,1097,4422,"[644, 822, 802, 305, 252, 0, 470, 1114, 859, 1344, 841, 1188, 436, 423, 984, 252, 1204, 972, 1146, 1258, 1376, 431, 1042, 907, 201, 1441, 1278, 390]"
197,6,6461,7315,7865,0,1752,4709,"[753, 556, 1324, 220, 1322, 0, 809, 1208, 1147, 310, 197, 98, 1302, 1347, 1265, 1163, 145, 324, 265, 1223, 1525, 638, 1298, 136, 86, 1380, 1261, 1109]"
198,6,5536,5947,7454,0,4637,899,"[9, 137, 169, 237, 157, 0, 250, 202, 203, 36, 170, 12, 0, 113, 0, 127, 104, 241, 238, 246, 281, 130, 11, 2, 143, 16, 220, 70]"
199,6,6785,6927,7312,0,4471,2314,"[388, 182, 654, 4, 93, 0, 759, 408, 60, 253, 35, 392, 5, 190, 162, 479, 105, 720, 172, 54, 109, 599, 646, 65, 341, 461, 46, 360]"
200,6,6676,6666,7322,0,6340,336,"[40, 105, 102, 51, 98, 0, 50, 40, 104, 17, 27, 76, 71, 72, 44, 15, 112, 80, 9, 14, 104, 33, 31, 73, 62, 68, 49, 104]"
201,6,5292,6219,6395,0,5115,177,"[55, 15, 29, 52, 30, 0, 50, 20, 5, 52, 43, 17, 14, 4, 19, 7, 51, 12, 54, 56, 5, 26, 48, 7, 10, 46, 5, 18]"
202,6,6110,5429,7076,0,3865,2245,"[379, 694, 719, 487, 204, 0, 360, 574, 247, 622, 109, 52, 468, 325, 497, 338, 629, 529, 117, 243, 342, 515, 407, 631, 231, 674, 545, 567]"
203,6,5571,5443,7204,0,3889,1682,"[210, 540, 376, 545, 167, 0, 338, 498, 405, 469, 75, 182, 76, 446, 110, 28, 257, 116, 494, 19, 14, 381, 414, 1, 72, 306, 86, 239]"
204,6,5402,6871,5735,0,371,5031,"[580, 605, 837, 1479, 1561, 0, 873, 1180, 528, 148, 1314, 757, 1177, 1309, 240, 123, 324, 1610, 1250, 323, 1656, 306, 1464, 455, 1665, 496, 1266, 309]"
205,6,6620,7108,5247,0,990,5630,"[1757, 826, 654, 1732, 1707, 0, 1176, 1329, 1735, 55, 52, 1681, 1668, 736, 1331, 90, 327, 71, 523, 1198, 1463, 894, 896, 1557, 1214, 882, 741, 1720]"
206,6,5919,6760,4406,0,758,5161,"[343, 1475, 369, 1296, 1274, 0, 814, 352, 510, 69, 1546, 277, 1617, 300, 1430, 412, 152, 223, 434, 239, 326, 524, 1478, 768, 1698, 836, 779, 21]"
207,6,6058,4944,5520,0,2356,3702,"[546, 963, 162, 343, 526, 0, 1048, 609, 595, 657, 1145, 487, 807, 810, 189, 601, 986, 923, 1128, 1201, 605, 291, 653, 743, 445, 665, 572, 408]"
208,6,6443,5418,6545,0,1499,4944,"[1550, 244, 204, 1221, 1339, 0, 921, 1586, 75, 1255, 536, 27, 126, 385, 1601, 290, 721, 1083, 305, 388, 507, 97, 1581, 454, 508, 1572, 1331, 182]"
209,6,6658,7329,5874,0,3210,3448,"[371, 1143, 612, 413, 178, 0, 1013, 633, 1087, 712, 504, 47, 30, 779, 1014, 408, 829, 945, 1000, 791, 345, 457, 45, 369, 520, 307, 13, 774]"
210,6,5874,7065,4683,0,4310,1564,"[408, 480, 324, 208, 150, 0, 89, 169, 223, 169, 254, 342, 258, 484, 424, 140, 156, 294, 63, 257, 458, 73, 31, 24, 100, 406, 122, 76]"
211,6,5718,4552,5849,0,2765,2953,"[167, 208, 941, 166, 813, 0, 505, 829, 449, 388, 574, 593, 453, 943, 347, 413, 850, 731, 861, 278, 372, 941, 561, 914, 861, 592, 14, 680]"
212,6,6106,5280,6675,0,257,5849,"[141, 1642, 698, 1510, 1563, 0, 1267, 88, 1737, 693, 1510, 773, 418, 1663, 332, 1438, 1711, 797, 462, 1024, 373, 1637, 1355, 1791, 0, 245, 1333, 1506]"
213,6,5217,5426,6466,0,541,4676,"[1539, 56, 1439, 362, 1106, 0, 825, 34, 376, 940, 1156, 1139, 1481, 97, 1555, 1261, 969, 1556, 1437, 587, 270, 1127, 1442, 145, 1243, 960, 1511, 48]"
214,6,5542,5651,6357,0,5439,103,"[31, 5, 26, 31, 27, 0, 29, 27, 27, 12, 5, 26, 30, 5, 3, 10, 20, 20, 2, 0, 30, 22, 28, 15, 28, 13, 3, 11]"
215,6,6960,6864,6453,0,4928,2032,"[367, 475, 440, 321, 133, 0, 382, 238, 226, 118, 380, 6, 647, 8, 326, 519, 108, 281, 370, 210, 406, 179, 627, 624, 45, 2, 534, 460]"
216,6,6518,5878,7093,0,7,6511,"[1102, 288, 387, 2024, 945, 0, 64, 103, 22, 846, 859, 2080, 374, 907, 235, 1740, 481, 519, 1351, 1509, 2098, 911, 1969, 1914, 643, 1617, 797, 1693]"
217,6,5954,5766,7281,0,431,5523,"[1078, 605, 1605, 1222, 1519, 0, 1342, 1300, 1211, 164, 1023, 595, 121, 54, 249, 998, 399, 1126, 821, 1005, 1838, 622, 963, 1401, 1272, 675, 1036, 1043]"
218,6,6627,5803,8105,0,2095,4532,"[445, 519, 671, 847, 1478, 0, 240, 636, 177, 940, 528, 825, 1148, 1329, 640, 482, 598, 311, 1306, 129, 720, 185, 743, 21, 140, 958, 804, 639]"
219,6,6214,7258,7061,0,5134,1080,"[177, 331, 229, 296, 340, 0, 10, 344, 279, 251, 272, 357, 136, 209, 53, 29, 33, 287, 29, 217, 244, 24, 316, 131, 178, 153, 238, 194]"
220,6,5141,5195,7007,0,4963,178,"[58, 14, 45, 36, 41, 0, 22, 8, 52, 14, 46, 34, 17, 28, 42, 1, 46, 14, 34, 27, 50, 21, 52, 41, 27, 6, 46, 46]"
221,6,6757,6830,6934,0,1035,5722,"[1180, 484, 962, 602, 554, 0, 364, 395, 578, 1639, 1368, 972, 1564, 1318, 1767, 111, 987, 139, 856, 1067, 759, 309, 611, 312, 1269, 460, 1502, 1564]"
222,6,6643,5549,8028,0,5564,1079,"[192, 123, 33, 42, 61, 0, 56, 46, 189, 328, 36, 345, 289, 324, 123, 268, 51, 95, 343, 132, 195, 173, 80, 336, 104, 116, 303, 31]"
223,6,5326,5401,7953,0,36,5290,"[628, 1398, 824, 1633, 1437, 0, 816, 1366, 951, 470, 911, 458, 354, 525, 771, 863, 48, 1523, 566, 785, 34, 524, 1327, 518, 1017, 823, 1133, 922]"
224,6,6611,6062,8502,0,3296,3315,"[260, 466, 575, 616, 1055, 0, 844, 689, 415, 914, 842, 857, 443, 235, 530, 563, 672, 774, 178, 992, 672, 678, 1103, 928, 1033, 344, 1011, 851]"
225,6,5472,6505,7469,0,5337,135,"[33, 44, 16, 27, 16, 0, 21, 8, 25, 23, 30, 8, 27, 0, 27, 11, 35, 40, 23, 16, 4, 33, 26, 20, 22, 36, 22, 5]"
226,6,6116,5271,8314,0,1952,4164,"[806, 823, 502, 793, 877, 0, 1111, 502, 1058, 640, 868, 698, 255, 582, 1295, 988, 668, 30, 349, 574, 1103, 250, 266, 0, 784, 944, 10, 14]"
227,6,5753,6929,7138,0,3420,2333,"[113, 767, 65, 591, 758, 0, 713, 634, 465, 514, 210, 671, 193, 693, 604, 593, 742, 359, 24, 526, 123, 612, 710, 415, 93, 689, 216, 323]"
228,6,6202,7166,6174,0,5477,725,"[195, 138, 53, 100, 3, 0, 54, 53, 203, 60, 20, 65, 214, 218, 231, 90, 107, 216, 175, 154, 208, 7, 65, 198, 11, 193, 65, 238]"
229,6,5374,7125,4423,0,2709,2665,"[305, 584, 646, 201, 183, 0, 51, 446, 674, 262, 316, 349, 31, 546, 10, 546, 883, 530, 610, 698, 61, 19, 417, 587, 505, 881, 791, 460]"
230,6,5124,4466,5081,0,53,5071,"[813, 607, 1184, 1504, 1597, 0, 220, 608, 281, 1291, 429, 1351, 1598, 912, 344, 7, 1572, 406, 1114, 92, 1168, 947, 1305, 194, 1233, 353, 1534, 668]"
231,6,5063,541,9603,0,577,4486,"[455, 406, 1106, 311, 1247, 0, 654, 338, 1491, 1103, 526, 595, 936, 1039, 581, 255, 566, 878, 828, 587, 574, 1160, 1040, 203, 653, 905, 572, 556]"
232,6,5773,7413,7963,0,3125,2648,"[483, 137, 74, 656, 433, 0, 553, 204, 643, 790, 169, 116, 104, 12, 342, 827, 412, 586, 147, 551, 733, 271, 670, 389, 196, 464, 661, 728]"
233,6,5704,7293,6374,0,2276,3428,"[358, 505, 27, 160, 217, 0, 1001, 94, 780, 798, 1122, 536, 26, 777, 185, 23, 764, 1023, 624, 591, 128, 934, 666, 247, 181, 990, 199, 1053]"
234,6,6495,6438,6431,0,5427,1068,"[348, 230, 147, 9, 142, 0, 44, 291, 97, 162, 298, 252, 148, 113, 224, 297, 261, 283, 54, 287, 98, 167, 24, 198, 65, 1, 265, 240]"
235,6,5472,5675,6228,0,4402,1070,"[166, 248, 199, 94, 101, 0, 245, 52, 161, 39, 47, 299, 36, 176, 75, 118, 264, 44, 263, 115, 136, 348, 103, 229, 148, 240, 286, 2]"
236,6,5055,5903,5380,0,1329,3726,"[188, 110, 830, 35, 967, 0, 578, 159, 1142, 1204, 820, 417, 602, 808, 138, 700, 271, 809, 898, 654, 260, 562, 120, 122, 81, 163, 460, 1000]"
237,6,6674,6948,5106,0,456,6218,"[1684, 971, 836, 127, 241, 0, 1102, 581, 1811, 622, 1017, 1027, 1475, 879, 511, 556, 296, 1296, 528, 1684, 1386, 1798, 1267, 1979, 1305, 656, 1194, 1063]"
238,6,6966,6142,5930,0,4504,2462,"[497, 340, 59, 711, 300, 0, 517, 657, 95, 263, 405, 566, 355, 141, 435, 430, 676, 80, 681, 93, 684, 596, 604, 722, 630, 658, 709, 793]"
239,6,5040,1621,9349,0,108,4932,"[1159, 1622, 519, 166, 634, 0, 998, 1621, 1471, 897, 791, 1115, 102, 86, 1121, 477, 1196, 745, 1420, 115, 751, 1480, 1286, 448, 1349, 955, 670, 916]"
240,6,5162,6218,8293,0,4493,669,"[68, 202, 166, 75, 85, 0, 73, 44, 94, 168, 45, 120, 222, 60, 27, 109, 97, 124, 53, 37, 31, 150, 54, 49, 211, 192, 193, 171]"
241,6,5648,6295,7646,0,1358,4290,"[1164, 1366, 484, 970, 630, 0, 241, 1059, 21, 1078, 798, 956, 318, 627, 196, 14, 10, 168, 89, 1349, 632, 6, 949, 708, 156, 684, 576, 622]"
242,6,5548,5581,7613,0,1300,4248,"[635, 22, 1270, 342, 1121, 0, 413, 268, 1000, 1033, 76, 1383, 268, 805, 248, 1159, 1330, 851, 1219, 1152, 429, 16, 1039, 240, 137, 41, 728, 1300]"
243,6,5319,7197,5735,0,1181,4138,"[450, 398, 418, 456, 556, 0, 438, 893, 1319, 782, 534, 804, 1056, 24, 227, 1379, 724, 875, 697, 1112, 687, 941, 371, 410, 433, 1084, 669, 995]"
244,6,6746,5163,7318,0,3703,3043,"[558, 915, 459, 746, 1005, 0, 102, 596, 575, 702, 734, 267, 455, 0, 167, 474, 934, 514, 857, 295, 823, 251, 419, 466, 852, 383, 824, 256]"
245,6,5287,5984,6621,0,4903,384,"[105, 17, 43, 92, 87, 0, 23, 123, 31, 29, 124, 73, 120, 96, 69, 111, 15, 85, 63, 128, 59, 77, 115, 44, 59, 25, 101, 28]"
246,6,6868,6716,6773,0,5831,1037,"[312, 18, 33, 61, 141, 0, 207, 146, 51, 175, 264, 179, 200, 223, 125, 293, 226, 245, 317, 273, 324, 214, 273, 314, 247, 19, 215, 325]"
247,6,5259,5111,6921,0,1666,3593,"[1109, 163, 588, 228, 595, 0, 95, 821, 868, 871, 954, 1059, 127, 447, 146, 887, 951, 950, 441, 931, 136, 337, 328, 590, 620, 645, 49, 1171]"
248,6,6331,7200,6052,0,966,5365,"[1780, 994, 1071, 195, 659, 0, 1005, 252, 1758, 154, 918, 149, 1193, 483, 1138, 1710, 1247, 1029, 600, 157, 1410, 80, 1032, 136, 795, 1358, 1449, 1395]"
249,6,6272,7235,5089,0,2599,3673,"[431, 216, 244, 223, 113, 0, 764, 159, 297, 969, 1080, 48, 309, 881, 762, 434, 561, 867, 343, 651, 53, 795, 623, 408, 5, 99, 982, 238]"
250,6,5745,4177,6657,0,2792,2953,"[111, 959, 732, 934, 106, 0, 248, 373, 82, 101, 663, 394, 570, 211, 542, 843, 64, 943, 684, 695, 567, 98, 484, 951, 450, 786, 430, 324]"
251,6,6181,5885,6953,0,5946,235,"[37, 15, 46, 18, 1, 0, 46, 59, 55, 60, 70, 54, 63, 8, 53, 77, 60, 20, 46, 39, 55, 2, 25, 33, 10, 76, 63, 10]"
252,6,5322,5976,6299,0,4300,1022,"[221, 141, 223, 53, 275, 0, 77, 327, 240, 216, 278, 206, 228, 222, 180, 298, 50, 114, 101, 16, 125, 334, 200, 298, 190, 265, 20, 49]"
253,6,6685,5104,7880,0,4833,1852,"[111, 248, 323, 587, 577, 0, 216, 251, 199, 143, 512, 147, 396, 275, 367, 258, 132, 203, 558, 218, 385, 435, 34, 90, 326, 543, 62, 134]"
254,6,6811,6792,7899,0,3911,2900,"[30, 959, 718, 125, 153, 0, 624, 900, 317, 61, 593, 239, 260, 233, 157, 351, 558, 6, 907, 577, 776, 334, 105, 448, 430, 662, 688, 838]"
255,6,5246,6416,6729,0,4864,382,"[105, 36, 31, 20, 61, 0, 21, 13, 9, 86, 54, 99, 122, 10, 33, 45, 102, 83, 98, 102, 43, 6, 23, 85, 10, 74, 121, 24]"
256,6,5947,5043,7633,0,1750,4197,"[1336, 761, 102, 992, 1016, 0, 361, 718, 1373, 626, 1317, 457, 1054, 164, 703, 1228, 871, 121, 1019, 597, 182, 556, 265, 145, 1156, 1145, 402, 665]"
257,6,5175,5084,7724,0,5172,3,"[1, 1, 1, 1, 0, 0, 0, 0, 0, 1, 0, 0, 0, 0, 1, 1, 1, 0, 0, 0, 0, 1, 0, 0, 1, 1, 1, 0]"
258,6,5859,5427,8156,0,4249,1610,"[302, 459, 407, 191, 395, 0, 403, 270, 385, 21, 63, 237, 129, 198, 92, 407, 223, 142, 441, 351, 499, 489, 410, 161, 340, 343, 292, 431]"
259,6,6908,6089,8975,0,4369,2539,"[266, 372, 629, 558, 720, 0, 395, 710, 124, 210, 532, 24, 34, 242, 621, 82, 328, 497, 776, 334, 758, 10, 188, 645, 318, 1, 349, 222]"
260,6,6674,6313,9336,0,6325,349,"[104, 17, 25, 112, 67, 0, 111, 49, 16, 86, 69, 31, 62, 77, 70, 82, 59, 78, 103, 7, 23, 68, 12, 52, 113, 101, 102, 60]"
261,6,5260,5833,8763,0,4542,718,"[8, 219, 7, 95, 198, 0, 124, 124, 55, 230, 108, 125, 138, 79, 33, 99, 16, 20, 176, 144, 191, 206, 148, 112, 114, 96, 12, 68]"
262,6,5185,5253,8695,0,2851,2334,"[393, 468, 280, 470, 71, 0, 91, 764, 510, 194, 211, 405, 185, 576, 441, 516, 372, 248, 686, 649, 430, 477, 709, 400, 757, 536, 660, 59]"
263,6,6206,7453,7448,0,6194,12,"[0, 0, 1, 3, 3, 0, 2, 2, 3, 4, 2, 4, 1, 4, 1, 2, 2, 1, 2, 0, 2, 0, 4, 4, 1, 0, 1, 0]"
264,6,6851,5686,8613,0,4300,2551,"[164, 302, 671, 697, 691, 0, 539, 442, 257, 380, 613, 846, 704, 650, 332, 419, 139, 72, 28, 432, 531, 202, 594, 738, 40, 313, 754, 798]"
265,6,5422,6756,7279,0,5351,71,"[7, 11, 3, 6, 8, 0, 21, 7, 20, 20, 8, 17, 19, 15, 13, 1, 18, 3, 23, 22, 22, 23, 22, 13, 2, 11, 10, 4]"
266,6,5332,6088,6523,0,128,5204,"[790, 732, 1224, 830, 343, 0, 1007, 981, 684, 30, 805, 1562, 1318, 1052, 791, 939, 128, 331, 652, 457, 1195, 210, 296, 332, 301, 860, 26, 111]"
267,6,5440,6932,5031,0,3134,2306,"[127, 717, 2, 362, 600, 0, 471, 763, 364, 8, 645, 665, 325, 162, 291, 579, 285, 566, 413, 628, 411, 657, 523, 115, 17, 588, 528, 105]"
268,6,5174,807,9398,0,39,5135,"[1639, 706, 15, 1548, 832, 0, 1472, 853, 1620, 1664, 362, 18, 1108, 1472, 435, 555, 1610, 1371, 1195, 627, 1069, 1595, 242, 1520, 522, 410, 309, 1568]"
269,6,6896,6579,9715,0,1551,5345,"[1395, 869, 515, 1570, 1277, 0, 1185, 1548, 1676, 722, 1608, 1272, 69, 1553, 870, 918, 265, 916, 1320, 697, 1515, 1266, 1600, 1245, 1544, 310, 436, 1692]"
270,6,5878,5194,10000,399,28,5850,"[956, 648, 1436, 1046, 758, 0, 1717, 1815, 1612, 765, 743, 1498, 1942, 1741, 1308, 153, 1031, 536, 128, 57, 880, 1465, 474, 238, 1884, 1886, 214, 1725]"
271,6,5442,7370,8072,0,1138,4304,"[227, 858, 376, 564, 1388, 0, 305, 1330, 1280, 971, 691, 1321, 137, 1031, 607, 177, 105, 748, 1361, 900, 867, 267, 669, 964, 1426, 935, 599, 456]"
272,6,6610,7364,7318,0,3648,2962,"[406, 765, 369, 566, 619, 0, 951, 851, 597, 387, 770, 489, 189, 223, 584, 938, 949, 66, 118, 765, 362, 703, 243, 43, 731, 752, 264, 175]"
273,6,5494,5493,7319,0,1711,3783,"[782, 310, 625, 941, 276, 0, 22, 398, 54, 1024, 898, 686, 552, 393, 624, 1131, 594, 68, 1098, 30, 572, 976, 213, 423, 263, 731, 1176, 289]"
274,6,6777,6930,7166,0,4004,2773,"[98, 507, 856, 173, 263, 0, 891, 685, 43, 465, 837, 391, 757, 301, 690, 786, 64, 520, 195, 265, 178, 479, 245, 651, 642, 722, 388, 322]"
275,6,5289,5191,7264,0,814,4475,"[923, 1169, 320, 1146, 1130, 0, 601, 963, 228, 1085, 523, 1180, 1271, 1015, 1351, 153, 1028, 955, 121, 169, 1350, 317, 1443, 29, 596, 1358, 981, 921]"
276,6,5023,5596,6691,0,1784,3239,"[383, 326, 140, 64, 946, 0, 368, 71, 417, 158, 390, 304, 62, 1001, 41, 480, 1065, 593, 691, 944, 703, 631, 20, 365, 263, 206, 426, 118]"
277,6,6153,5214,7630,0,2492,3661,"[1073, 98, 1098, 451, 1197, 0, 865, 327, 552, 747, 122, 1106, 984, 1153, 194, 40, 495, 911, 38, 194, 697, 597, 1210, 85, 326, 1127, 748, 396]"
278,6,6334,7006,6958,0,2623,3711,"[1012, 1031, 438, 248, 92, 0, 255, 832, 871, 808, 789, 562, 622, 183, 423, 983, 350, 252, 752, 71, 501, 261, 873, 133, 651, 241, 1047, 845]"
279,6,5409,7454,4913,0,4684,725,"[211, 76, 131, 151, 230, 0, 85, 125, 21, 114, 41, 117, 42, 114, 94, 223, 123, 37, 156, 96, 237, 187, 240, 139, 128, 226, 145, 105]"
280,6,5781,5424,5270,0,4767,1014,"[27, 275, 320, 311, 239, 0, 16, 329, 307, 156, 67, 144, 235, 257, 179, 178, 319, 11, 28, 270, 184, 258, 208, 218, 77, 288, 321, 147]"
281,6,5609,929,9950,0,2974,2635,"[113, 532, 63, 245, 448, 0, 742, 491, 118, 296, 593, 645, 566, 387, 456, 582, 465, 348, 343, 395, 433, 340, 802, 422, 18, 165, 87, 486]"
282,6,6487,5542,10000,895,6071,416,"[98, 26, 137, 126, 88, 0, 37, 70, 10, 72, 105, 12, 68, 80, 7, 107, 11, 124, 81, 4, 137, 56, 7, 110, 20, 107, 93, 130]"
283,6,6515,5324,10000,1191,3897,2618,"[473, 537, 650, 355, 271, 0, 764, 306, 777, 494, 591, 526, 818, 192, 385, 124, 642, 29, 150, 419, 157, 299, 820, 551, 80, 567, 714, 447]"
284,6,5121,6082,9039,0,4371,750,"[102, 206, 102, 245, 26, 0, 164, 75, 12, 99, 221, 224, 200, 185, 231, 80, 218, 237, 118, 3, 37, 30, 197, 201, 126, 199, 8, 6]"
285,6,6540,5275,10000,304,2098,4442,"[1178, 284, 770, 1034, 163, 0, 58, 891, 1329, 366, 1245, 1308, 1449, 1372, 678, 508, 399, 254, 1082, 1103, 499, 79, 1143, 254, 277, 572, 102, 213]"
286,6,5265,6634,8631,0,16,5249,"[221, 688, 490, 1551, 384, 0, 1001, 1260, 1372, 1498, 366, 1346, 1230, 1744, 348, 426, 851, 518, 1635, 331, 1273, 605, 1402, 575, 1140, 351, 524, 386]"
287,6,6195,6714,8112,0,6162,33,"[10, 3, 8, 7, 4, 0, 5, 5, 6, 8, 11, 3, 2, 7, 5, 2, 2, 9, 3, 11, 4, 11, 6, 2, 2, 6, 7, 6]"
288,6,5266,5196,8182,0,510,4756,"[1515, 325, 883, 935, 607, 0, 674, 506, 889, 740, 1571, 550, 248, 169, 1535, 354, 819, 408, 1395, 913, 414, 1376, 1201, 136, 916, 1506, 490, 611]"
289,6,6420,5940,8662,0,3724,2696,"[820, 702, 889, 555, 502, 0, 684, 101, 852, 675, 397, 832, 654, 535, 805, 782, 222, 503, 455, 630, 93, 630, 5, 774, 72, 878, 833, 578]"
290,6,6263,7215,7710,0,5577,686,"[150, 95, 99, 10, 175, 0, 130, 44, 177, 17, 64, 54, 224, 7, 160, 75, 122, 55, 148, 185, 83, 83, 42, 61, 119, 30, 81, 84]"
291,6,6698,5284,9124,0,2681,4017,"[872, 1159, 335, 1057, 1189, 0, 697, 749, 647, 990, 250, 750, 680, 570, 172, 978, 473, 465, 1292, 570, 1293, 1300, 866, 224, 405, 827, 465, 422]"
292,6,6163,7216,8071,0,5839,324,"[83, 16, 76, 25, 82, 0, 28, 80, 73, 60, 56, 88, 61, 7, 85, 41, 35, 90, 60, 45, 101, 27, 28, 8, 91, 37, 19, 60]"
293,6,6438,5814,8695,0,2139,4299,"[169, 1323, 697, 1274, 603, 0, 99, 1014, 1099, 966, 529, 1159, 448, 1246, 1365, 4, 633, 1023, 111, 1423, 1370, 1207, 842, 159, 1143, 54, 29, 1390]"
294,6,6359,6963,8091,0,5331,1028,"[141, 133, 223, 97, 44, 0, 246, 155, 231, 304, 116, 120, 81, 132, 76, 277, 78, 39, 64, 309, 46, 120, 177, 57, 284, 297, 220, 186]"
295,6,6734,7030,7795,0,1573,5161,"[1373, 12, 1010, 698, 664, 0, 807, 255, 1443, 544, 1271, 412, 1003, 1498, 616, 786, 695, 791, 1425, 583, 379, 769, 1210, 263, 448, 348, 950, 765]"
296,6,5989,7390,6394,0,3445,2544,"[401, 569, 240, 128, 702, 0, 611, 346, 64, 171, 248, 770, 232, 331, 622, 508, 320, 115, 511, 688, 108, 157, 71, 744, 480, 624, 452, 104]"
297,6,6322,5187,7529,0,2942,3380,"[879, 323, 1033, 734, 45, 0, 343, 1015, 468, 358, 11, 9, 572, 169, 319, 290, 259, 641, 891, 320, 432, 926, 244, 575, 205, 281, 95, 1022]"
298,6,5978,6448,7059,0,3902,2076,"[472, 139, 195, 682, 135, 0, 149, 205, 453, 183, 242, 511, 658, 609, 313, 362, 108, 204, 99, 65, 99, 669, 642, 120, 162, 103, 95, 680]"
299,6,6507,6353,7213,0,5464,1043,"[242, 269, 224, 152, 293, 0, 115, 46, 12, 236, 267, 341, 5, 126, 135, 107, 169, 289, 252, 0, 47, 251, 114, 9, 264, 289, 49, 50]"
0,7,6355,0,6355,0,1605,4750,"[1461, 1443, 663, 1464, 1497, 796, 639, 0, 1499, 417, 830, 1513, 1223, 1310, 281, 764, 1049, 1466, 1125, 39, 68, 396, 854, 333, 1497, 62, 1286]"
1,7,5500,7262,4593,0,4447,1053,"[334, 168, 283, 132, 295, 270, 125, 0, 267, 251, 295, 69, 266, 281, 325, 295, 268, 34, 161, 331, 162, 119, 43, 324, 204, 140, 305]"
2,7,6896,6905,4584,0,6702,194,"[64, 27, 38, 17, 14, 41, 10, 0, 22, 7, 3, 8, 44, 55, 42, 62, 55, 26, 1, 8, 57, 53, 39, 60, 53, 0, 17]"
3,7,6297,4659,6222,0,2717,3580,"[369, 583, 626, 273, 321, 1036, 572, 0, 256, 890, 488, 577, 465, 303, 749, 966, 530, 1018, 826, 13, 803, 750, 587, 859, 191, 740, 1032]"
4,7,6884,6324,6782,0,5421,1463,"[342, 27, 88, 95, 259, 145, 47, 0, 426, 342, 435, 268, 138, 409, 436, 372, 392, 303, 449, 274, 39, 444, 158, 38, 408, 408, 485]"
5,7,5405,6806,5381,0,1256,4149,"[586, 286, 253, 882, 707, 776, 420, 0, 858, 1274, 801, 1141, 827, 908, 711, 935, 1363, 1292, 262, 1186, 465, 626, 64, 353, 740, 33, 581]"
6,7,6922,5809,6494,0,2527,4395,"[919, 1381, 726, 1226, 992, 881, 1079, 0, 964, 900, 804, 717, 44, 671, 448, 322, 1455, 187, 1457, 193, 297, 160, 1026, 245, 459, 1032, 352]"
7,7,5944,5131,7307,0,2992,2952,"[26, 254, 240, 189, 285, 721, 588, 0, 851, 13, 564, 561, 212, 464, 70, 149, 56, 109, 876, 494, 918, 228, 63, 983, 137, 784, 670]"
8,7,5532,5903,6936,0,12,5520,"[54, 1269, 1623, 1822, 733, 1184, 1654, 0, 320, 998, 651, 1562, 799, 1620, 77, 860, 866, 1578, 918, 752, 1302, 864, 1225, 445, 427, 1155, 629]"
9,7,5869,5429,7376,0,3345,2524,"[216, 470, 409, 544, 445, 348, 564, 0, 461, 778, 348, 297, 617, 542, 279, 678, 217, 0, 211, 746, 532, 202, 84, 203, 296, 371, 501]"
10,7,6198,5035,8539,0,378,5820,"[808, 894, 1167, 513, 904, 1379, 1505, 0, 1438, 1470, 211, 1099, 997, 481, 279, 444, 1598, 1034, 1448, 307, 1319, 1370, 177, 1147, 1493, 729, 904]"
11,7,5958,7091,7406,0,4895,1063,"[103, 171, 17, 238, 136, 267, 316, 0, 334, 242, 65, 5, 47, 281, 96, 216, 27, 322, 46, 256, 354, 246, 27, 153, 340, 143, 318]"
12,7,6406,7185,6627,0,1777,4629,"[763, 93, 1214, 907, 1139, 176, 952, 0, 722, 793, 114, 1461, 100, 761, 974, 1071, 1079, 571, 7, 1483, 923, 1058, 540, 1024, 1062, 1476, 1304]"
13,7,5803,5963,6467,0,2672,3131,"[702, 132, 571, 960, 280, 36, 397, 0, 821, 304, 732, 943, 240, 632, 520, 488, 47, 1009, 451, 902, 491, 290, 275, 362, 125, 952, 24]"
14,7,5753,6291,5929,0,331,5422,"[1174, 194, 625, 1559, 1446, 1396, 1489, 0, 1347, 799, 208, 945, 1029, 795, 392, 234, 1544, 773, 1383, 355, 1223, 867, 1121, 1691, 1358, 305, 455]"
15,7,5648,7013,4564,0,2076,3572,"[956, 1081, 360, 1093, 430, 991, 484, 0, 174, 236, 647, 1010, 702, 1062, 640, 418, 356, 221, 1035, 598, 428, 1021, 616, 1051, 1169, 261, 50]"
16,7,6428,2891,8101,0,1731,4697,"[978, 1523, 570, 1556, 1193, 95, 380, 0, 166, 121, 1045, 437, 714, 695, 191, 1386, 803, 1396, 151, 477, 956, 1271, 1390, 76, 1442, 1006, 1239]"
17,7,6097,5569,8629,0,736,5361,"[198, 383, 488, 1445, 1403, 1725, 321, 0, 574, 1779, 435, 1166, 406, 783, 712, 1060, 644, 1290, 317, 1233, 603, 13, 1300, 1054, 370, 776, 820]"
18,7,6082,6806,7905,0,3498,2584,"[396, 799, 693, 452, 645, 616, 235, 0, 592, 674, 199, 616, 354, 710, 43, 370, 760, 819, 574, 54, 144, 49, 241, 463, 27, 859, 377]"
19,7,5757,7377,6285,0,842,4915,"[1396, 1131, 1145, 56, 85, 1609, 1248, 0, 26, 1249, 341, 185, 843, 246, 1120, 1487, 1612, 675, 854, 27, 1217, 134, 470, 534, 875, 1196, 300]"
20,7,6829,5876,7238,0,720,6109,"[1092, 1817, 181, 596, 820, 921, 1350, 0, 178, 759, 1068, 1858, 595, 1302, 1086, 948, 94, 1892, 589, 271, 1480, 1184, 320, 1582, 1041, 822, 203]"
21,7,6632,5010,8860,0,5778,854,"[223, 96, 223, 232, 33, 139, 36, 0, 206, 249, 131, 237, 187, 44, 12, 44, 160, 217, 35, 195, 79, 279, 142, 95, 278, 156, 264]"
22,7,6666,6543,8983,0,4209,2457,"[741, 750, 354, 710, 379, 506, 256, 0, 302, 230, 795, 60, 378, 322, 374, 225, 688, 385, 435, 352, 761, 780, 723, 128, 72, 235, 79]"
23,7,5930,5058,9855,0,1994,3936,"[405, 448, 881, 68, 1016, 686, 26, 0, 27, 563, 845, 746, 809, 1089, 388, 1234, 18, 1182, 1041, 339, 181, 1032, 1282, 90, 1124, 92, 849]"
24,7,6490,6660,9685,0,4012,2478,"[487, 36, 465, 205, 262, 56, 189, 0, 427, 291, 610, 420, 562, 241, 400, 396, 615, 721, 450, 45, 168, 33, 90, 418, 541, 292, 179]"
25,7,6709,6842,9552,0,6264,445,"[78, 12, 23, 66, 128, 56, 42, 0, 140, 120, 6, 132, 17, 114, 31, 37, 69, 45, 67, 49, 27, 110, 124, 56, 75, 107, 87]"
26,7,5906,5667,9791,0,5824,82,"[10, 5, 6, 22, 14, 5, 3, 0, 8, 12, 25, 9, 10, 25, 7, 9, 6, 2, 11, 1, 10, 25, 25, 1, 11, 7, 3]"
27,7,6388,6953,9226,0,4516,1872,"[107, 39, 281, 71, 122, 530, 149, 0, 32, 383, 93, 309, 352, 519, 125, 9, 188, 257, 128, 528, 410, 241, 592, 541, 534, 256, 345]"
28,7,5713,6983,7956,0,1421,4292,"[1395, 1100, 951, 1076, 1107, 1317, 566, 0, 205, 429, 357, 679, 815, 73, 1171, 1428, 1379, 1324, 748, 1059, 530, 424, 454, 73, 640, 602, 1138]"
29,7,5058,5058,7956,0,4643,415,"[111, 72, 52, 13, 54, 91, 8, 0, 101, 20, 23, 129, 1, 97, 89, 38, 41, 66, 11, 4, 99, 36, 90, 40, 108, 92, 60]"
30,7,5425,6862,6519,0,3666,1759,"[45, 551, 258, 465, 28, 558, 583, 0, 272, 127, 568, 338, 159, 193, 154, 424, 181, 429, 307, 136, 381, 40, 152, 250, 279, 97, 201]"
31,7,6304,5024,7799,0,4135,2169,"[197, 544, 499, 305, 399, 193, 357, 0, 398, 616, 586, 388, 492, 715, 200, 314, 533, 374, 608, 658, 253, 405, 246, 400, 376, 352, 540]"
32,7,5267,5405,7661,0,2205,3062,"[862, 347, 198, 710, 213, 797, 74, 0, 289, 437, 205, 473, 972, 119, 165, 768, 208, 769, 638, 736, 772, 182, 546, 310, 507, 792, 897]"
33,7,6754,6304,8111,0,5762,992,"[29, 124, 215, 36, 309, 236, 245, 0, 31, 287, 113, 108, 90, 9, 176, 15, 301, 225, 203, 301, 284, 17, 274, 218, 176, 88, 166]"
34,7,6800,6215,8696,0,5776,1024,"[280, 119, 224, 316, 69, 122, 40, 0, 260, 47, 1, 64, 303, 255, 314, 5, 146, 340, 324, 2, 180, 263, 26, 294, 78, 255, 199]"
35,7,6376,6931,8141,0,3782,2594,"[720, 528, 407, 577, 361, 81, 265, 0, 704, 297, 497, 75, 752, 143, 397, 670, 12, 582, 70, 380, 487, 825, 647, 418, 305, 573, 571]"
36,7,5946,6288,7799,0,2674,3272,"[9, 836, 1043, 457, 799, 352, 1085, 0, 95, 358, 292, 263, 731, 1046, 944, 5, 909, 144, 1053, 133, 674, 756, 597, 719, 544, 31, 142]"
37,7,6180,7115,6864,0,616,5564,"[505, 1402, 1601, 1852, 501, 1161, 390, 0, 1784, 1806, 333, 7, 1523, 969, 415, 1556, 421, 800, 1812, 567, 794, 729, 777, 848, 535, 1804, 793]"
38,7,6314,6288,6890,0,3674,2640,"[400, 425, 431, 26, 16, 555, 173, 0, 505, 313, 851, 0, 380, 338, 229, 481, 782, 94, 82, 817, 566, 547, 476, 639, 583, 530, 851]"
39,7,6546,6102,7334,0,3654,2892,"[642, 225, 80, 722, 135, 703, 640, 0, 473, 506, 285, 765, 847, 950, 227, 585, 903, 346, 592, 98, 507, 633, 614, 83, 162, 571, 755]"
40,7,6475,6201,7608,0,4918,1557,"[326, 458, 39, 168, 104, 434, 327, 0, 70, 54, 107, 485, 241, 9, 59, 76, 316, 194, 255, 269, 198, 399, 429, 262, 377, 374, 273]"
41,7,6623,5220,9011,0,885,5738,"[591, 425, 61, 791, 956, 62, 1604, 0, 1491, 38, 1680, 465, 886, 1594, 1238, 418, 195, 904, 365, 1168, 1714, 9, 206, 1115, 205, 1181, 538]"
42,7,5021,6598,7434,0,2308,2713,"[408, 180, 135, 540, 789, 616, 792, 0, 703, 555, 863, 470, 244, 253, 389, 223, 218, 402, 589, 875, 324, 550, 509, 137, 635, 584, 730]"
43,7,5981,6147,7268,0,3409,2572,"[222, 258, 810, 338, 819, 658, 657, 0, 454, 142, 650, 610, 657, 412, 577, 328, 255, 597, 509, 500, 728, 336, 572, 787, 4, 578, 721]"
44,7,6037,5077,8228,0,662,5375,"[226, 1335, 1610, 1210, 1413, 1091, 1494, 0, 1433, 1095, 666, 1727, 668, 1358, 1271, 391, 640, 1393, 530, 274, 1521, 264, 355, 994, 115, 1004, 832]"
45,7,6043,6382,7889,0,977,5066,"[394, 1562, 101, 1082, 993, 349, 622, 0, 1139, 591, 781, 62, 490, 1232, 362, 867, 1550, 312, 1199, 183, 252, 894, 919, 5, 447, 1527, 713]"
46,7,6306,7172,7023,0,5608,698,"[134, 179, 99, 154, 16, 7, 42, 0, 123, 180, 35, 205, 164, 176, 24, 125, 50, 206, 137, 169, 122, 19, 192, 165, 32, 55, 41]"
47,7,6116,5622,7517,0,2068,4048,"[1335, 601, 1082, 855, 611, 924, 600, 0, 185, 405, 325, 623, 302, 62, 25, 815, 1132, 977, 392, 358, 1324, 528, 1033, 1322, 238, 1177, 977]"
48,7,5812,7076,6253,0,5408,404,"[42, 9, 34, 129, 123, 100, 104, 0, 113, 35, 124, 3, 46, 122, 95, 119, 66, 47, 86, 121, 59, 13, 85, 43, 33, 58, 47]"
49,7,6171,5474,6950,0,4163,2008,"[101, 372, 510, 112, 397, 273, 59, 0, 239, 483, 133, 339, 222, 648, 76, 36, 460, 605, 145, 454, 205, 644, 152, 183, 481, 473, 565]"
50,7,5995,7486,5459,0,2429,3566,"[260, 81, 889, 152, 445, 75, 672, 0, 698, 383, 201, 1020, 722, 814, 590, 418, 572, 941, 82, 232, 262, 210, 990, 196, 809, 545, 633]"
51,7,6377,7189,4647,0,4004,2373,"[110, 296, 346, 675, 514, 188, 704, 0, 644, 583, 616, 424, 413, 441, 586, 602, 541, 466, 367, 703, 419, 450, 476, 517, 606, 256, 568]"
52,7,5912,4339,6220,0,4110,1802,"[432, 492, 273, 84, 233, 170, 489, 0, 571, 497, 224, 593, 495, 436, 509, 346, 107, 491, 262, 47, 22, 202, 153, 27, 59, 549, 339]"
53,7,5331,6926,4625,0,607,4724,"[1209, 3, 1075, 1303, 217, 1337, 1420, 0, 166, 1521, 1356, 92, 39, 307, 461, 652, 1039, 1434, 1148, 833, 425, 1444, 1233, 1033, 585, 915, 237]"
54,7,5879,1741,8763,0,4665,1214,"[304, 343, 316, 191, 49, 162, 265, 0, 133, 236, 180, 339, 164, 250, 16, 206, 48, 79, 30, 34, 50, 344, 180, 248, 376, 222, 220]"
55,7,5521,5741,8543,0,4710,811,"[15, 40, 197, 64, 261, 8, 16, 0, 49, 81, 1, 136, 151, 245, 129, 78, 52, 245, 147, 101, 176, 24, 4, 136, 113, 42, 69]"
56,7,5528,6541,7530,0,5381,147,"[36, 25, 30, 11, 31, 1, 9, 0, 21, 24, 40, 17, 34, 33, 48, 49, 22, 1, 22, 6, 32, 21, 24, 1, 1, 15, 24]"
57,7,5000,6406,6124,0,4433,567,"[31, 86, 151, 66, 58, 147, 165, 0, 105, 110, 43, 119, 137, 37, 45, 45, 170, 3, 60, 168, 156, 33, 97, 61, 166, 139, 125]"
58,7,5890,6736,5278,0,4455,1435,"[378, 430, 408, 378, 179, 454, 139, 0, 226, 268, 264, 269, 352, 172, 131, 373, 421, 170, 209, 403, 84, 371, 266, 376, 224, 100, 258]"
59,7,6270,7048,4500,0,3004,3266,"[654, 549, 767, 413, 566, 343, 331, 0, 837, 486, 793, 660, 761, 523, 839, 76, 804, 878, 323, 245, 348, 954, 998, 917, 837, 1016, 50]"
60,7,6365,1615,9250,0,273,6092,"[3, 229, 1536, 1740, 1227, 1531, 98, 0, 1252, 699, 94, 873, 630, 324, 964, 1345, 2, 1662, 589, 122, 691, 1234, 1903, 1042, 697, 1772, 477]"
61,7,6995,5337,10000,908,5348,1647,"[19, 448, 420, 471, 526, 219, 264, 0, 336, 140, 32, 492, 308, 421, 281, 315, 500, 61, 310, 369, 401, 183, 110, 42, 261, 195, 347]"
62,7,5210,6922,8288,0,4179,1031,"[3, 113, 323, 101, 304, 267, 209, 0, 177, 223, 250, 230, 337, 19, 203, 262, 65, 191, 100, 194, 12, 216, 37, 87, 270, 288, 96]"
63,7,5679,6745,7222,0,338,5341,"[1304, 1204, 168, 1655, 1062, 568, 1280, 0, 1275, 1406, 174, 1080, 1393, 178, 1394, 412, 524, 674, 1236, 1208, 1082, 1121, 454, 1351, 356, 167, 1404]"
64,7,6031,7034,6219,0,1631,4400,"[1269, 1126, 1037, 551, 1464, 1081, 78, 0, 511, 1140, 1389, 786, 1041, 705, 734, 1099, 1463, 1203, 736, 698, 63, 7, 130, 613, 796, 1179, 777]"
65,7,5093,6835,4477,0,4851,242,"[4, 70, 8, 41, 55, 48, 51, 0, 76, 16, 76, 48, 0, 3, 49, 30, 38, 7, 43, 53, 47, 35, 36, 18, 67, 49, 30]"
66,7,6382,296,10000,563,2829,3553,"[72, 405, 625, 218, 1054, 309, 1167, 0, 800, 274, 476, 63, 477, 1103, 399, 1025, 873, 219, 132, 1099, 980, 603, 1160, 220, 300, 447, 656]"
67,7,5885,5708,10000,177,1520,4365,"[1310, 889, 113, 281, 790, 1285, 869, 0, 1425, 871, 1143, 1353, 755, 1303, 474, 981, 9, 1057, 379, 137, 1404, 931, 1106, 907, 1026, 846, 333]"
68,7,6518,5490,10000,1028,6421,97,"[29, 23, 19, 32, 26, 10, 17, 0, 24, 4, 10, 27, 16, 8, 19, 5, 17, 8, 25, 26, 11, 8, 6, 6, 17, 26, 32]"
69,7,5664,6018,9646,0,4107,1557,"[449, 160, 38, 419, 234, 52, 321, 0, 364, 11, 146, 300, 332, 143, 146, 379, 475, 159, 208, 256, 318, 468, 344, 120, 382, 2, 408]"
70,7,6242,7257,8631,0,2984,3258,"[987, 923, 598, 416, 523, 1014, 419, 0, 810, 200, 225, 560, 646, 752, 711, 773, 743, 1018, 1039, 994, 904, 61, 406, 711, 199, 378, 1018]"
71,7,6104,6271,8464,0,3000,3104,"[739, 582, 602, 464, 1030, 10, 59, 0, 557, 957, 925, 75, 510, 331, 889, 596, 152, 428, 612, 348, 651, 498, 597, 288, 100, 58, 422]"
72,7,5535,5171,8828,0,4169,1366,"[133, 245, 406, 165, 183, 430, 178, 0, 126, 26, 379, 388, 407, 304, 317, 52, 234, 200, 137, 72, 217, 385, 225, 270, 336, 245, 396]"
73,7,6392,6717,8503,0,6233,159,"[24, 41, 30, 8, 22, 9, 25, 0, 19, 39, 41, 46, 0, 46, 36, 27, 28, 31, 8, 17, 33, 32, 30, 47, 45, 22, 22]"
74,7,5478,6399,7582,0,2995,2483,"[824, 460, 385, 51, 7, 460, 287, 0, 283, 715, 104, 54, 612, 275, 288, 614, 63, 225, 454, 231, 121, 759, 816, 602, 677, 24, 141]"
75,7,6600,5989,8193,0,3757,2843,"[611, 267, 947, 899, 643, 613, 561, 0, 395, 835, 830, 790, 276, 160, 189, 664, 751, 633, 566, 379, 656, 196, 690, 296, 657, 905, 10]"
76,7,6635,6344,8484,0,4674,1961,"[545, 70, 250, 403, 647, 293, 82, 0, 176, 571, 469, 511, 33, 292, 286, 359, 653, 505, 72, 544, 32, 235, 260, 433, 109, 554, 344]"
77,7,6933,6399,9018,0,6904,29,"[4, 8, 2, 3, 2, 9, 8, 0, 8, 8, 7, 5, 6, 0, 4, 8, 0, 0, 8, 2, 6, 8, 7, 9, 6, 5, 1]"
78,7,5910,6235,8693,0,5448,462,"[80, 5, 152, 65, 73, 70, 87, 0, 63, 76, 113, 140, 132, 93, 15, 71, 120, 90, 49, 23, 81, 16, 101, 102, 31, 7, 62]"
79,7,5566,6687,7572,0,2555,3011,"[421, 690, 480, 249, 713, 280, 892, 0, 491, 101, 374, 578, 874, 346, 558, 23, 40, 796, 57, 907, 627, 807, 317, 460, 853, 278, 150]"
80,7,6978,6343,8207,0,701,6277,"[363, 2028, 2006, 1700, 502, 116, 882, 0, 658, 298, 275, 1737, 1204, 324, 550, 1532, 615, 68, 806, 90, 115, 660, 846, 1881, 631, 783, 406]"
81,7,5305,5210,8302,0,4800,505,"[40, 108, 4, 158, 133, 29, 86, 0, 81, 139, 62, 100, 37, 146, 65, 80, 166, 116, 139, 161, 67, 102, 1, 168, 122, 146, 98]"
82,7,5091,6412,6981,0,2903,2188,"[314, 310, 309, 366, 279, 242, 461, 0, 130, 407, 577, 162, 468, 630, 679, 652, 139, 269, 665, 466, 65, 282, 613, 449, 258, 60, 408]"
83,7,6333,5444,7870,0,4165,2168,"[688, 353, 28, 131, 76, 225, 384, 0, 684, 455, 655, 357, 618, 463, 715, 532, 678, 82, 608, 172, 626, 311, 620, 397, 389, 214, 214]"
84,7,6532,6795,7607,0,5345,1187,"[301, 390, 49, 34, 354, 380, 386, 0, 93, 106, 129, 43, 127, 377, 36, 306, 217, 122, 261, 41, 242, 367, 20, 70, 21, 384, 360]"
85,7,6499,6979,7127,0,3056,3443,"[769, 1118, 858, 1068, 894, 813, 297, 0, 366, 395, 980, 687, 693, 977, 766, 98, 1041, 659, 535, 510, 160, 743, 1031, 875, 202, 27, 876]"
86,7,6806,6843,7090,0,6694,112,"[37, 37, 30, 3, 21, 31, 4, 0, 9, 8, 6, 24, 30, 30, 33, 2, 1, 18, 29, 11, 25, 14, 28, 27, 36, 8, 12]"
87,7,6172,5691,7571,0,4097,2075,"[273, 274, 144, 678, 206, 472, 524, 0, 417, 606, 99, 238, 358, 557, 544, 660, 229, 614, 671, 66, 303, 558, 194, 664, 153, 171, 200]"
88,7,6621,5727,8465,0,6305,316,"[95, 29, 72, 59, 90, 64, 53, 0, 72, 79, 73, 2, 17, 6, 63, 88, 33, 73, 50, 99, 69, 37, 4, 50, 32, 58, 104]"
89,7,5174,5316,8323,0,1410,3764,"[1069, 616, 414, 196, 292, 377, 740, 0, 628, 1240, 1002, 124, 366, 502, 772, 564, 655, 439, 1198, 849, 345, 299, 199, 745, 317, 1244, 1113]"
90,7,5472,6190,7605,0,2107,3365,"[651, 976, 363, 316, 188, 492, 581, 0, 885, 85, 701, 721, 339, 241, 308, 570, 633, 962, 641, 568, 766, 573, 139, 80, 266, 657, 845]"
91,7,5124,6104,6625,0,3075,2049,"[674, 334, 87, 639, 671, 287, 539, 0, 104, 350, 326, 136, 493, 203, 114, 319, 530, 256, 612, 212, 385, 616, 392, 224, 243, 571, 290]"
92,7,6083,7407,5301,0,1588,4495,"[949, 173, 1452, 500, 1124, 16, 281, 0, 674, 376, 505, 430, 632, 395, 202, 1056, 817, 350, 368, 24, 297, 453, 852, 867, 1010, 319, 11]"
93,7,6344,6556,5089,0,1275,5069,"[628, 1497, 516, 244, 1285, 1049, 879, 0, 372, 255, 619, 767, 96, 1213, 973, 1115, 1333, 1626, 1088, 429, 1678, 377, 9, 1484, 1406, 415, 661]"
94,7,6129,7050,4168,0,2977,3152,"[684, 218, 429, 300, 806, 144, 113, 0, 205, 972, 354, 679, 765, 573, 230, 811, 934, 787, 329, 254, 620, 494, 335, 374, 525, 157, 399]"
95,7,5181,3409,5940,0,2719,2462,"[671, 538, 687, 387, 441, 397, 344, 0, 760, 722, 198, 349, 352, 466, 421, 402, 236, 104, 750, 368, 786, 690, 445, 179, 293, 258, 699]"
96,7,5389,6635,4694,0,82,5307,"[656, 1341, 1394, 708, 1125, 622, 540, 0, 1303, 276, 1604, 31, 1762, 1077, 1053, 1050, 495, 1414, 117, 1154, 1706, 1170, 1143, 1557, 376, 64, 1161]"
97,7,5252,3979,5967,0,1303,3949,"[18, 760, 879, 77, 880, 518, 124, 0, 266, 948, 1262, 86, 260, 906, 799, 390, 1113, 1154, 720, 811, 1201, 863, 196, 844, 139, 958, 383]"
98,7,5376,6304,5039,0,3539,1837,"[450, 312, 417, 17, 446, 581, 280, 0, 307, 192, 409, 407, 238, 353, 168, 315, 431, 322, 261, 158, 565, 338, 502, 360, 4, 386, 212]"
99,7,6255,6617,4677,0,66,6189,"[1410, 615, 1107, 1513, 1119, 1416, 272, 0, 133, 134, 1698, 159, 34, 737, 1025, 1573, 1701, 1655, 29, 1951, 1609, 763, 1623, 724, 524, 1601, 507]"
100,7,6595,5069,6203,0,2488,4107,"[1164, 634, 661, 853, 889, 916, 301, 0, 198, 297, 1114, 864, 270, 957, 476, 94, 199, 1024, 790, 880, 665, 504, 1173, 1279, 835, 51, 749]"
101,7,6376,6718,5861,0,1431,4945,"[1249, 67, 1123, 975, 1092, 1385, 1166, 0, 901, 863, 147, 72, 1466, 290, 1162, 1117, 265, 603, 1119, 1100, 1505, 1587, 534, 1506, 1111, 548, 905]"
102,7,5551,6446,4966,0,3395,2156,"[299, 122, 707, 339, 185, 715, 19, 0, 539, 669, 84, 410, 608, 514, 265, 225, 396, 444, 289, 250, 253, 433, 599, 569, 124, 369, 331]"
103,7,5727,1917,8776,0,3093,2634,"[139, 487, 699, 192, 801, 88, 324, 0, 403, 18, 143, 98, 164, 698, 292, 531, 442, 55, 829, 251, 210, 670, 213, 269, 438, 376, 502]"
104,7,5874,7299,7351,0,1956,3918,"[799, 131, 565, 848, 1204, 1136, 433, 0, 682, 398, 393, 1012, 1159, 1279, 559, 11, 193, 1167, 813, 665, 1265, 215, 1117, 307, 833, 368, 1287]"
105,7,6709,6558,7502,0,5264,1445,"[365, 475, 451, 473, 430, 278, 344, 0, 193, 201, 320, 406, 164, 8, 34, 224, 443, 270, 106, 202, 141, 241, 49, 43, 83, 151, 266]"
106,7,6458,5410,8550,0,3303,3155,"[301, 497, 559, 149, 16, 259, 926, 0, 647, 904, 179, 828, 447, 894, 490, 247, 44, 416, 469, 406, 499, 242, 134, 439, 366, 992, 227]"
107,7,5898,6030,8418,0,3908,1990,"[357, 224, 290, 332, 118, 432, 331, 0, 506, 603, 384, 327, 488, 601, 561, 456, 174, 115, 25, 600, 219, 237, 353, 391, 348, 513, 413]"
108,7,6564,5929,9053,0,2243,4321,"[1197, 387, 189, 1200, 624, 1334, 882, 0, 73, 132, 1126, 413, 943, 79, 1383, 5, 437, 1415, 1092, 304, 838, 1212, 764, 1246, 520, 691, 561]"
109,7,6404,5480,9977,0,2343,4061,"[1017, 692, 530, 267, 1189, 517, 111, 0, 822, 954, 409, 259, 296, 574, 892, 955, 179, 333, 767, 173, 1107, 379, 99, 347, 891, 463, 497]"
110,7,6918,5905,10000,990,5225,1693,"[541, 382, 479, 303, 305, 256, 42, 0, 121, 443, 423, 102, 161, 341, 302, 301, 489, 169, 539, 18, 559, 303, 117, 320, 510, 431, 488]"
111,7,6035,6003,10000,32,5879,156,"[50, 44, 22, 17, 0, 41, 15, 0, 30, 50, 33, 36, 35, 48, 3, 30, 35, 32, 45, 46, 4, 37, 6, 22, 28, 23, 34]"
112,7,5078,6273,8805,0,2887,2191,"[516, 585, 584, 272, 300, 274, 215, 0, 298, 368, 390, 36, 195, 446, 405, 194, 193, 282, 702, 1, 625, 69, 504, 262, 287, 528, 647]"
113,7,5817,5379,9243,0,183,5634,"[1603, 1236, 1485, 464, 83, 1637, 81, 0, 1460, 1013, 34, 1272, 1218, 373, 502, 1329, 275, 365, 227, 1701, 813, 406, 1826, 14, 218, 38, 807]"
114,7,6164,6450,8957,0,5229,935,"[167, 35, 193, 209, 311, 227, 85, 0, 284, 291, 271, 93, 131, 177, 147, 123, 138, 125, 131, 48, 184, 75, 91, 44, 224, 81, 303]"
115,7,6675,5266,10000,366,451,6224,"[1580, 1776, 1080, 1183, 2034, 1874, 1486, 0, 2045, 497, 1473, 1594, 1220, 165, 234, 2049, 475, 926, 1274, 379, 200, 598, 1620, 1827, 1843, 1022, 681]"
116,7,6814,6615,10000,199,2454,4360,"[363, 465, 104, 644, 459, 1081, 289, 0, 534, 1221, 1049, 601, 1318, 176, 975, 330, 532, 377, 352, 368, 880, 313, 560, 1118, 705, 935, 112]"
117,7,5942,7461,8481,0,5554,388,"[88, 23, 22, 10, 44, 118, 124, 0, 13, 129, 42, 118, 115, 56, 65, 34, 107, 109, 17, 41, 123, 78, 63, 127, 47, 50, 105]"
118,7,5306,6444,7343,0,4839,467,"[153, 51, 142, 80, 0, 130, 88, 0, 80, 150, 99, 111, 153, 9, 124, 118, 13, 154, 140, 147, 143, 107, 4, 57, 18, 26, 135]"
119,7,5392,6829,5906,0,636,4756,"[343, 1457, 784, 1568, 1579, 1495, 1040, 0, 1495, 901, 591, 1239, 434, 203, 1283, 462, 631, 142, 209, 168, 1061, 637, 1546, 1000, 21, 1261, 1206]"
120,7,5600,6118,5388,0,5163,437,"[67, 21, 36, 130, 134, 75, 19, 0, 6, 86, 66, 40, 137, 128, 106, 14, 102, 116, 128, 115, 47, 135, 99, 117, 33, 41, 139]"
121,7,6679,6559,5508,0,3112,3567,"[634, 373, 563, 776, 505, 233, 89, 0, 548, 778, 403, 1075, 1004, 332, 878, 973, 861, 65, 988, 404, 336, 126, 470, 552, 302, 918, 1026]"
122,7,5042,4165,6385,0,2691,2351,"[430, 776, 347, 676, 256, 58, 195, 0, 721, 568, 69, 27, 147, 590, 292, 680, 684, 83, 367, 564, 45, 659, 188, 449, 527, 686, 580]"
123,7,6407,5721,7071,0,3757,2650,"[419, 750, 775, 512, 755, 883, 287, 0, 19, 318, 786, 530, 682, 276, 861, 510, 689, 240, 862, 247, 193, 619, 504, 69, 205, 187, 222]"
124,7,6736,6713,7094,0,4971,1765,"[553, 151, 266, 516, 244, 224, 541, 0, 244, 329, 33, 375, 302, 385, 459, 114, 308, 257, 430, 223, 481, 446, 102, 302, 131, 472, 210]"
125,7,6067,6604,6557,0,1008,5059,"[135, 1469, 1283, 1224, 1287, 283, 549, 0, 312, 15, 811, 288, 45, 885, 1346, 677, 373, 975, 1116, 587, 1386, 1672, 265, 997, 600, 205, 839]"
126,7,6607,6885,6279,0,3300,3307,"[135, 131, 930, 879, 963, 624, 158, 0, 1028, 982, 649, 126, 346, 819, 873, 876, 253, 603, 430, 557, 298, 402, 26, 627, 953, 1064, 225]"
127,7,6768,5316,7731,0,2897,3871,"[556, 830, 667, 811, 262, 209, 1153, 0, 317, 236, 1169, 70, 295, 933, 565, 417, 214, 1181, 278, 414, 1166, 938, 812, 523, 1066, 195, 1]"
128,7,6427,6471,7687,0,1373,5054,"[1662, 1459, 1435, 1628, 1395, 1355, 1266, 0, 295, 21, 1296, 874, 26, 1684, 1045, 1520, 622, 1431, 1600, 136, 985, 146, 1083, 3, 741, 1531, 646]"
129,7,6933,6598,8022,0,5142,1791,"[46, 61, 93, 128, 564, 386, 596, 0, 545, 563, 537, 271, 479, 402, 577, 141, 140, 596, 587, 177, 365, 291, 460, 483, 139, 563, 308]"
130,7,6448,7016,7454,0,3304,3144,"[348, 938, 988, 250, 613, 8, 102, 0, 935, 786, 373, 1003, 963, 706, 800, 476, 467, 360, 1012, 937, 911, 153, 895, 76, 113, 423, 576]"
131,7,5636,5204,7886,0,1666,3970,"[486, 841, 686, 648, 681, 598, 680, 0, 369, 981, 1254, 665, 802, 915, 149, 746, 976, 544, 379, 267, 913, 1020, 346, 1091, 806, 326, 705]"
132,7,5157,5117,7926,0,997,4160,"[921, 1244, 1288, 946, 654, 815, 314, 0, 1377, 594, 548, 1016, 526, 504, 583, 23, 989, 674, 548, 750, 711, 236, 27, 1362, 469, 935, 1190]"
133,7,5410,7421,5915,0,754,4656,"[156, 134, 153, 1315, 674, 547, 189, 0, 418, 177, 1016, 78, 597, 1057, 583, 420, 730, 1083, 177, 1253, 147, 214, 704, 89, 1461, 613, 1489]"
134,7,6940,5086,7769,0,6123,817,"[61, 196, 28, 118, 110, 18, 131, 0, 219, 7, 91, 97, 253, 40, 107, 86, 157, 167, 167, 226, 126, 193, 140, 258, 89, 53, 178]"
135,7,5434,6830,6373,0,4177,1257,"[172, 59, 285, 105, 204, 219, 375, 0, 321, 315, 3, 171, 168, 8, 338, 144, 364, 22, 32, 313, 268, 216, 205, 368, 5, 2, 28]"
136,7,6366,5915,6824,0,2079,4287,"[1104, 166, 298, 509, 1298, 960, 91, 0, 842, 521, 848, 1166, 1302, 859, 1343, 506, 238, 38, 1395, 1363, 1124, 33, 369, 860, 1134, 403, 605]"
137,7,5019,5893,5950,0,537,4482,"[408, 1421, 451, 1199, 74, 435, 607, 0, 609, 1477, 475, 1295, 282, 561, 1469, 947, 424, 544, 523, 259, 592, 105, 554, 701, 754, 134, 190]"
138,7,5888,6285,5553,0,979,4909,"[386, 579, 318, 232, 976, 276, 203, 0, 419, 1418, 103, 52, 1388, 921, 620, 807, 764, 1576, 780, 151, 40, 943, 1332, 51, 1014, 491, 29]"
139,7,5678,5322,5909,0,2403,3275,"[693, 473, 161, 1000, 702, 550, 428, 0, 692, 515, 700, 872, 138, 757, 362, 162, 272, 329, 873, 236, 760, 1018, 310, 481, 926, 280, 735]"
140,7,5142,5635,5416,0,4453,689,"[92, 57, 81, 181, 132, 147, 127, 0, 139, 94, 168, 71, 109, 29, 27, 51, 58, 33, 77, 105, 136, 40, 60, 191, 140, 29, 188]"
141,7,5804,6098,5122,0,838,4966,"[907, 1493, 972, 1395, 785, 263, 280, 0, 1111, 1633, 924, 488, 216, 1142, 1396, 678, 386, 616, 947, 1379, 189, 286, 736, 365, 1627, 1430, 1238]"
142,7,6361,5771,5712,0,2377,3984,"[303, 1309, 502, 529, 1008, 549, 582, 0, 305, 561, 96, 540, 6, 630, 264, 937, 459, 1252, 951, 234, 523, 1089, 430, 1150, 982, 416, 1281]"
143,7,6241,5491,6462,0,3995,2246,"[365, 92, 367, 565, 99, 348, 186, 0, 748, 394, 642, 519, 667, 734, 569, 429, 580, 441, 250, 628, 347, 209, 604, 241, 14, 495, 710]"
144,7,6465,5246,7681,0,6151,314,"[62, 97, 13, 2, 93, 49, 70, 0, 88, 66, 80, 86, 45, 39, 86, 9, 47, 0, 60, 86, 102, 88, 36, 47, 94, 0, 16]"
145,7,5455,6502,6634,0,4415,1040,"[81, 66, 65, 182, 136, 326, 52, 0, 39, 244, 166, 343, 70, 20, 251, 248, 63, 21, 22, 151, 59, 177, 66, 276, 241, 33, 57]"
146,7,6835,6491,6978,0,568,6267,"[204, 255, 879, 1789, 794, 2043, 1565, 0, 50, 663, 373, 1872, 939, 1885, 1866, 772, 375, 693, 1961, 1984, 2006, 1094, 1125, 898, 803, 1216, 617]"
147,7,5405,5186,7197,0,2136,3269,"[311, 657, 483, 550, 865, 559, 248, 0, 72, 806, 223, 641, 303, 1034, 13, 399, 608, 1085, 1024, 715, 338, 247, 176, 318, 851, 593, 211]"
148,7,5196,5026,7367,0,2052,3144,"[922, 247, 841, 976, 1010, 966, 693, 0, 767, 905, 349, 333, 505, 802, 282, 1037, 267, 669, 861, 1008, 716, 504, 50, 551, 203, 663, 887]"
149,7,5581,7419,5529,0,2862,2719,"[12, 458, 127, 452, 478, 766, 623, 0, 613, 56, 10, 496, 102, 887, 69, 552, 883, 9, 873, 609, 818, 139, 509, 163, 264, 295, 534]"
150,7,6191,5993,5727,0,3430,2761,"[443, 549, 825, 391, 61, 632, 774, 0, 173, 148, 501, 618, 101, 657, 704, 850, 468, 493, 325, 266, 581, 458, 745, 592, 101, 56, 858]"
151,7,6088,6664,5151,0,3922,2166,"[74, 429, 290, 177, 167, 2, 622, 0, 152, 281, 371, 399, 385, 708, 181, 335, 425, 556, 294, 632, 471, 593, 563, 277, 313, 473, 21]"
152,7,6914,7012,5053,0,561,6353,"[353, 1088, 589, 1731, 535, 2100, 1859, 0, 1057, 575, 213, 1658, 1515, 1284, 1150, 79, 235, 606, 1406, 1677, 1941, 1240, 948, 1706, 1218, 1168, 1807]"
153,7,5573,2092,8534,0,3265,2308,"[556, 293, 694, 442, 414, 54, 261, 0, 421, 617, 272, 256, 265, 120, 361, 665, 66, 623, 454, 575, 572, 678, 383, 328, 518, 269, 393]"
154,7,6665,5270,9929,0,3467,3198,"[411, 297, 581, 568, 1033, 1054, 640, 0, 952, 333, 990, 616, 488, 189, 552, 781, 928, 213, 791, 646, 95, 518, 91, 675, 426, 909, 695]"
155,7,6201,7174,8956,0,2269,3932,"[242, 171, 33, 979, 541, 680, 834, 0, 215, 1194, 1138, 1057, 267, 328, 430, 115, 1221, 254, 681, 792, 315, 643, 779, 478, 906, 854, 788]"
156,7,6206,7020,8142,0,442,5764,"[587, 214, 729, 1135, 74, 1357, 741, 0, 1813, 827, 962, 232, 108, 22, 969, 1334, 1094, 1878, 1106, 15, 560, 23, 1392, 1463, 1905, 265, 535]"
157,7,6600,6914,7828,0,6300,300,"[11, 54, 85, 71, 26, 9, 0, 0, 17, 97, 4, 40, 100, 79, 71, 68, 29, 61, 91, 64, 82, 73, 6, 14, 64, 85, 66]"
158,7,6198,7031,6995,0,3327,2871,"[365, 443, 73, 656, 133, 384, 836, 0, 879, 88, 486, 255, 100, 931, 540, 933, 105, 723, 751, 358, 570, 47, 579, 912, 835, 818, 174]"
159,7,6943,5494,8444,0,6908,35,"[3, 7, 6, 1, 6, 5, 8, 0, 4, 10, 11, 8, 0, 6, 9, 4, 1, 8, 9, 3, 9, 3, 9, 2, 11, 3, 2]"
160,7,6833,6543,8734,0,5879,954,"[100, 13, 210, 55, 234, 91, 173, 0, 175, 208, 6, 83, 175, 149, 290, 18, 82, 51, 211, 17, 247, 13, 34, 285, 204, 281, 280]"
161,7,5241,5698,8277,0,429,4812,"[823, 1005, 787, 779, 97, 932, 1201, 0, 1206, 1594, 1213, 544, 1274, 567, 1389, 1431, 1562, 1569, 1308, 799, 1440, 65, 30, 354, 1403, 1539, 184]"
162,7,5519,6457,7339,0,4035,1484,"[446, 343, 312, 366, 68, 410, 223, 0, 34, 13, 446, 279, 244, 272, 323, 434, 318, 17, 190, 261, 38, 306, 126, 438, 491, 369, 102]"
163,7,5968,7112,6195,0,3978,1990,"[308, 7, 277, 223, 4, 265, 357, 0, 623, 236, 447, 237, 112, 460, 267, 95, 495, 331, 327, 125, 263, 366, 77, 233, 542, 223, 479]"
164,7,6185,5080,7300,0,778,5407,"[1793, 789, 1595, 71, 881, 268, 1490, 0, 667, 100, 1801, 1159, 574, 1125, 435, 1028, 474, 1567, 775, 831, 1640, 1184, 1290, 1367, 861, 1520, 1541]"
165,7,5938,6058,7180,0,5545,393,"[74, 98, 3, 104, 53, 88, 130, 0, 30, 88, 80, 64, 131, 125, 106, 62, 74, 76, 7, 48, 8, 104, 97, 72, 59, 13, 89]"
166,7,6059,6472,6767,0,5102,957,"[163, 319, 56, 194, 135, 0, 222, 0, 45, 105, 256, 5, 277, 207, 66, 33, 96, 265, 253, 211, 1, 141, 60, 173, 134, 98, 172]"
167,7,6312,6955,6124,0,5178,1134,"[190, 90, 371, 125, 286, 338, 208, 0, 292, 295, 235, 108, 32, 181, 203, 106, 108, 196, 343, 197, 353, 325, 115, 65, 325, 64, 366]"
168,7,5545,5946,5723,0,3789,1756,"[419, 431, 199, 288, 577, 516, 484, 0, 548, 169, 226, 535, 552, 114, 384, 428, 151, 479, 379, 118, 242, 95, 99, 584, 20, 373, 569]"
169,7,6043,6914,4852,0,3328,2715,"[58, 591, 440, 298, 872, 780, 696, 0, 861, 552, 239, 531, 650, 322, 852, 416, 638, 73, 369, 780, 863, 442, 112, 674, 851, 689, 276]"
170,7,5126,999,8979,0,1012,4114,"[71, 965, 1276, 882, 453, 1180, 525, 0, 1133, 205, 901, 258, 1325, 1082, 713, 220, 312, 890, 99, 1141, 237, 288, 218, 1217, 344, 1112, 1064]"
171,7,6928,5031,10000,876,1056,5872,"[1033, 276, 169, 1910, 665, 1512, 562, 0, 282, 211, 236, 1521, 484, 497, 1692, 585, 534, 1931, 1518, 148, 1357, 148, 740, 1851, 610, 1162, 27]"
172,7,6958,6171,10000,787,1859,5099,"[1205, 943, 730, 1391, 1665, 1320, 725, 0, 621, 1042, 1259, 932, 877, 1264, 635, 1306, 781, 671, 1508, 823, 859, 813, 1552, 304, 859, 1643, 1434]"
173,7,5012,5097,9915,0,2989,2023,"[111, 125, 60, 219, 112, 54, 599, 0, 615, 422, 113, 322, 22, 372, 662, 471, 634, 317, 4, 224, 116, 73, 179, 578, 555, 652, 50]"
174,7,6943,6611,10000,247,270,6673,"[641, 113, 417, 1628, 622, 324, 1345, 0, 493, 499, 1851, 1373, 2155, 977, 1300, 58, 645, 27, 1411, 830, 957, 808, 1512, 188, 931, 1611, 1075]"
175,7,5405,5078,10000,327,941,4464,"[16, 914, 922, 52, 599, 618, 1410, 0, 129, 245, 79, 707, 1131, 424, 1029, 915, 437, 428, 1221, 375, 434, 143, 949, 1224, 415, 751, 1152]"
176,7,5899,7483,8416,0,5447,452,"[147, 104, 100, 0, 136, 89, 109, 0, 135, 136, 89, 105, 110, 1, 140, 8, 144, 97, 139, 145, 103, 26, 49, 137, 118, 139, 143]"
177,7,6866,7250,8032,0,4000,2866,"[934, 570, 314, 29, 211, 531, 135, 0, 784, 237, 901, 881, 725, 577, 754, 745, 874, 259, 589, 856, 714, 764, 453, 562, 306, 433, 535]"
178,7,6187,5579,8640,0,6148,39,"[4, 12, 4, 10, 3, 8, 8, 0, 1, 10, 5, 0, 5, 6, 4, 4, 6, 7, 8, 12, 10, 3, 1, 8, 7, 5, 6]"
179,7,6930,6261,9309,0,2403,4527,"[1088, 861, 511, 438, 363, 1418, 1170, 0, 105, 382, 840, 202, 100, 1147, 662, 126, 1127, 404, 306, 1138, 528, 920, 668, 403, 1403, 1407, 924]"
180,7,5554,6891,7972,0,4086,1468,"[172, 340, 392, 424, 116, 439, 145, 0, 251, 411, 381, 15, 24, 350, 427, 240, 407, 30, 143, 435, 323, 245, 392, 471, 467, 418, 174]"
181,7,6019,7013,6978,0,153,5866,"[839, 492, 1928, 624, 320, 442, 955, 0, 724, 394, 109, 894, 1033, 1158, 790, 68, 1537, 243, 1408, 1454, 1551, 742, 517, 1260, 1067, 556, 839]"
182,7,5589,6763,5804,0,4857,732,"[69, 169, 197, 227, 93, 61, 152, 0, 235, 35, 215, 118, 175, 13, 67, 46, 206, 223, 176, 125, 196, 126, 3, 87, 4, 98, 220]"
183,7,5747,6480,5071,0,1692,4055,"[125, 3, 238, 1048, 1115, 38, 88, 0, 90, 1139, 697, 630, 301, 472, 1292, 1238, 1290, 1084, 167, 67, 1147, 241, 1161, 575, 741, 1136, 1351]"
184,7,5387,4634,5824,0,4194,1193,"[280, 148, 216, 127, 91, 391, 221, 0, 149, 261, 104, 68, 257, 91, 298, 45, 274, 243, 229, 125, 22, 268, 363, 239, 181, 200, 49]"
185,7,5866,5295,6395,0,4154,1712,"[562, 484, 365, 27, 348, 474, 105, 0, 256, 293, 174, 19, 32, 185, 66, 292, 496, 464, 446, 544, 316, 362, 123, 364, 36, 308, 213]"
186,7,5000,5376,6019,0,3935,1065,"[62, 221, 83, 147, 16, 15, 7, 0, 305, 194, 225, 209, 43, 0, 192, 82, 112, 238, 295, 226, 5, 34, 95, 337, 96, 121, 298]"
187,7,6861,6170,6710,0,3881,2980,"[537, 892, 644, 767, 838, 159, 734, 0, 287, 875, 873, 948, 570, 937, 120, 847, 16, 929, 45, 294, 655, 678, 979, 73, 141, 279, 393]"
188,7,5099,7340,4469,0,435,4664,"[237, 1209, 1349, 1124, 147, 1223, 1479, 0, 2, 98, 463, 1539, 843, 849, 1284, 1409, 125, 458, 1155, 1459, 1118, 749, 196, 223, 1290, 538, 339]"
189,7,6900,5611,5758,0,3196,3704,"[904, 136, 193, 701, 838, 631, 732, 0, 854, 1119, 184, 956, 338, 892, 651, 1105, 654, 101, 681, 385, 95, 828, 978, 572, 878, 450, 633]"
190,7,6309,7319,4748,0,5118,1191,"[313, 344, 300, 75, 19, 236, 29, 0, 50, 360, 350, 36, 277, 288, 166, 364, 84, 3, 41, 290, 83, 62, 305, 374, 319, 181, 265]"
191,7,5620,1317,9051,0,1129,4491,"[75, 718, 1026, 121, 441, 99, 602, 0, 140, 1006, 1015, 905, 1084, 485, 202, 679, 376, 863, 1408, 1379, 799, 157, 426, 1417, 58, 230, 620]"
192,7,6510,6698,8863,0,828,5682,"[503, 769, 1721, 180, 1648, 754, 1506, 0, 448, 464, 1824, 304, 1544, 564, 802, 780, 264, 589, 329, 1197, 880, 1492, 1664, 1173, 1408, 1101, 1459]"
193,7,5447,6242,8068,0,3444,2003,"[478, 235, 630, 662, 76, 385, 649, 0, 283, 343, 496, 41, 498, 227, 270, 421, 420, 340, 113, 292, 233, 72, 48, 621, 250, 191, 45]"
194,7,6854,7006,7916,0,6097,757,"[139, 206, 83, 21, 168, 112, 246, 0, 16, 144, 210, 242, 174, 239, 247, 219, 148, 79, 25, 219, 52, 135, 37, 109, 99, 99, 58]"
195,7,6730,7443,7203,0,3691,3039,"[995, 471, 838, 887, 578, 133, 978, 0, 821, 942, 240, 15, 329, 596, 929, 209, 548, 837, 254, 654, 803, 517, 437, 758, 482, 421, 602]"
196,7,6718,6705,7216,0,2489,4229,"[1373, 355, 58, 1345, 1282, 734, 220, 0, 440, 449, 967, 572, 139, 919, 479, 581, 1001, 1258, 616, 201, 230, 1158, 349, 307, 860, 1144, 581]"
197,7,6435,5475,8176,0,1795,4640,"[231, 915, 1061, 1161, 1219, 1467, 348, 0, 1341, 600, 189, 956, 1232, 355, 1394, 705, 1207, 422, 604, 1220, 991, 175, 1148, 621, 1345, 1425, 237]"
198,7,5921,7446,6651,0,1290,4631,"[379, 1227, 800, 265, 1137, 1268, 768, 0, 768, 1142, 687, 1347, 1255, 735, 578, 433, 1202, 817, 297, 814, 460, 1089, 180, 1386, 847, 937, 911]"
199,7,5829,5804,6676,0,4308,1521,"[498, 122, 399, 1, 190, 211, 116, 0, 53, 300, 259, 293, 335, 39, 72, 137, 297, 395, 267, 413, 146, 104, 202, 16, 349, 234, 237]"
200,7,6124,6560,6240,0,791,5333,"[403, 309, 1723, 1709, 496, 1543, 145, 0, 773, 1732, 597, 1094, 356, 133, 1651, 1371, 1024, 1307, 755, 60, 1618, 153, 393, 1475, 52, 27, 1599]"
201,7,5402,5253,6389,0,681,4721,"[611, 323, 1525, 1069, 1512, 1160, 1291, 0, 1241, 1046, 503, 1042, 311, 635, 1573, 1249, 834, 1183, 727, 1382, 487, 852, 587, 413, 876, 251, 71]"
202,7,5570,7201,4758,0,903,4667,"[101, 296, 816, 427, 811, 900, 569, 0, 918, 494, 1430, 1345, 909, 748, 404, 277, 827, 689, 782, 578, 1484, 439, 263, 937, 1066, 1148, 1447]"
203,7,6053,4803,6008,0,160,5893,"[1454, 1097, 1111, 272, 6, 805, 1807, 0, 1861, 296, 1765, 704, 1644, 1267, 1647, 381, 1316, 1371, 1248, 1665, 1522, 1940, 78, 1867, 656, 264, 1800]"
204,7,5585,6174,5419,0,5552,33,"[8, 10, 0, 7, 0, 10, 5, 0, 2, 4, 10, 9, 4, 2, 6, 7, 3, 11, 3, 6, 4, 8, 0, 5, 11, 6, 6]"
205,7,5296,660,10000,55,4084,1212,"[260, 195, 373, 162, 198, 158, 298, 0, 306, 169, 278, 220, 144, 302, 262, 106, 19, 400, 152, 151, 123, 285, 147, 58, 188, 181, 355]"
206,7,5650,7361,8289,0,1404,4246,"[120, 1200, 506, 583, 449, 1320, 1043, 0, 784, 251, 413, 1282, 4, 963, 685, 1327, 111, 457, 106, 913, 832, 906, 75, 310, 184, 865, 200]"
207,7,6024,5997,8316,0,4303,1721,"[282, 118, 350, 363, 119, 391, 276, 0, 298, 112, 269, 438, 119, 214, 244, 394, 489, 555, 184, 6, 480, 411, 57, 31, 121, 421, 501]"
208,7,6095,7030,7381,0,6,6089,"[1630, 538, 1428, 118, 1928, 606, 296, 0, 527, 876, 1808, 1883, 1804, 116, 373, 1252, 1611, 1680, 749, 1511, 1234, 1680, 1025, 1648, 1535, 1356, 261]"
209,7,6447,6053,7775,0,957,5490,"[885, 1076, 546, 558, 1476, 1085, 990, 0, 756, 1436, 515, 1634, 599, 294, 1755, 1795, 326, 1210, 628, 1708, 800, 1100, 1753, 1603, 663, 1102, 169]"
210,7,5729,6083,7421,0,5656,73,"[12, 15, 14, 11, 22, 6, 15, 0, 7, 22, 23, 24, 5, 10, 13, 1, 15, 16, 9, 12, 19, 13, 8, 10, 18, 7, 5]"
211,7,6126,6018,7529,0,1749,4377,"[394, 82, 1360, 830, 1362, 1265, 473, 0, 1450, 1440, 1392, 800, 2, 1260, 1122, 1110, 872, 1027, 1381, 528, 70, 652, 1231, 1344, 317, 64, 700]"
212,7,6622,7047,7104,0,886,5736,"[67, 43, 396, 699, 1482, 189, 578, 0, 441, 872, 217, 650, 1878, 550, 576, 75, 1870, 708, 1665, 1203, 1178, 100, 1169, 311, 1110, 196, 1158]"
213,7,5322,7092,5334,0,888,4434,"[934, 1188, 263, 49, 1195, 545, 861, 0, 1220, 240, 906, 1291, 782, 286, 1348, 465, 746, 1072, 1153, 1218, 1336, 985, 57, 234, 1257, 382, 1070]"
214,7,5873,7356,3851,0,4342,1531,"[410, 399, 435, 337, 169, 245, 387, 0, 39, 412, 219, 340, 92, 73, 0, 103, 204, 153, 121, 88, 54, 334, 74, 79, 223, 246, 104]"
215,7,5561,4475,4937,0,3731,1830,"[281, 4, 26, 218, 581, 217, 195, 0, 218, 547, 329, 457, 598, 219, 305, 124, 5, 432, 467, 413, 32, 418, 335, 100, 592, 20, 547]"
216,7,5280,834,9383,0,3383,1897,"[571, 406, 189, 271, 115, 345, 137, 0, 350, 319, 341, 252, 173, 353, 285, 43, 627, 516, 569, 143, 291, 53, 481, 587, 308, 593, 381]"
217,7,6940,7416,8907,0,2865,4075,"[298, 227, 1272, 587, 850, 356, 855, 0, 22, 734, 868, 811, 777, 851, 63, 6, 705, 529, 664, 1325, 570, 949, 237, 770, 1181, 591, 994]"
218,7,5632,7026,7513,0,5070,562,"[90, 19, 132, 66, 19, 143, 104, 0, 180, 12, 22, 60, 88, 87, 71, 78, 13, 16, 159, 105, 136, 126, 36, 75, 6, 39, 51]"
219,7,5065,6876,5702,0,4477,588,"[135, 19, 77, 49, 87, 180, 111, 0, 146, 162, 184, 2, 94, 119, 50, 169, 177, 162, 21, 52, 173, 133, 182, 165, 30, 105, 26]"
220,7,6194,5561,6335,0,5957,237,"[35, 12, 62, 70, 53, 37, 17, 0, 69, 62, 23, 45, 36, 51, 26, 3, 2, 9, 29, 29, 16, 67, 38, 40, 39, 7, 54]"
221,7,5479,7131,4683,0,2058,3421,"[2, 1136, 659, 1128, 272, 321, 84, 0, 115, 107, 1049, 75, 781, 705, 530, 181, 551, 1072, 1117, 807, 108, 239, 754, 644, 823, 438, 62]"
222,7,5094,1652,8125,0,3217,1877,"[238, 80, 339, 52, 120, 320, 89, 0, 518, 573, 160, 203, 23, 501, 4, 43, 127, 248, 461, 160, 191, 432, 536, 185, 409, 441, 204]"
223,7,5303,5757,7671,0,2097,3206,"[119, 326, 1006, 216, 887, 715, 527, 0, 843, 310, 130, 229, 570, 746, 663, 251, 637, 339, 737, 892, 583, 808, 19, 424, 428, 692, 295]"
224,7,5682,5846,7507,0,1753,3929,"[1118, 545, 1035, 1307, 771, 184, 1259, 0, 451, 1206, 735, 866, 56, 442, 280, 365, 702, 133, 845, 1233, 760, 1012, 1267, 1240, 381, 946, 19]"
225,7,5612,6752,6367,0,5188,424,"[13, 112, 43, 126, 29, 138, 41, 0, 24, 9, 25, 58, 99, 77, 18, 23, 111, 28, 34, 57, 121, 100, 59, 23, 94, 46, 35]"
226,7,5832,6087,6112,0,64,5768,"[1785, 1039, 1194, 817, 1126, 394, 475, 0, 807, 342, 1, 1322, 626, 1569, 776, 1220, 1307, 17, 1073, 254, 143, 312, 1041, 556, 189, 1036, 348]"
227,7,5278,5197,6193,0,932,4346,"[861, 851, 1424, 724, 409, 794, 533, 0, 296, 416, 258, 467, 1244, 1255, 579, 125, 1103, 312, 368, 1344, 534, 866, 794, 289, 584, 1007, 1316]"
228,7,5890,7031,5052,0,1993,3897,"[919, 794, 1108, 1036, 284, 1001, 810, 0, 210, 937, 970, 1177, 126, 100, 1087, 155, 521, 429, 207, 1148, 993, 615, 1053, 366, 1226, 1296, 1156]"
229,7,6581,6777,4856,0,1293,5288,"[486, 658, 112, 316, 1611, 1254, 1696, 0, 1443, 113, 1307, 453, 1480, 919, 1382, 1264, 1340, 1732, 78, 975, 213, 780, 1700, 190, 1703, 1197, 150]"
230,7,6229,6044,5041,0,3642,2587,"[37, 380, 44, 516, 597, 241, 231, 0, 365, 165, 342, 790, 833, 280, 574, 455, 607, 482, 320, 799, 347, 778, 95, 150, 651, 75, 116]"
231,7,6425,6821,4645,0,1435,4990,"[239, 394, 421, 765, 434, 11, 896, 0, 1342, 1280, 795, 171, 799, 578, 435, 238, 766, 970, 164, 402, 716, 824, 1271, 1186, 1008, 965, 506]"
232,7,5751,1167,9229,0,2036,3715,"[519, 610, 159, 745, 7, 1117, 502, 0, 1203, 503, 229, 876, 1064, 595, 490, 578, 683, 813, 65, 1027, 261, 201, 1027, 1158, 391, 1010, 749]"
233,7,5662,5727,9164,0,3868,1794,"[182, 179, 36, 539, 153, 253, 578, 0, 261, 555, 8, 398, 103, 166, 59, 317, 454, 338, 228, 34, 62, 296, 568, 147, 233, 552, 382]"
234,7,6897,7427,8634,0,4474,2423,"[108, 471, 230, 39, 99, 563, 204, 0, 604, 585, 582, 294, 432, 156, 489, 333, 695, 552, 728, 289, 471, 702, 461, 340, 704, 706, 339]"
235,7,6852,5399,10000,87,2402,4450,"[1167, 124, 347, 1437, 435, 83, 1372, 0, 516, 760, 1242, 1294, 1329, 803, 52, 829, 1207, 929, 383, 771, 1380, 1207, 1127, 1181, 923, 615, 324]"
236,7,6220,5504,10000,716,4151,2069,"[134, 335, 643, 96, 620, 679, 445, 0, 145, 2, 74, 85, 514, 118, 449, 269, 47, 494, 410, 157, 41, 589, 130, 208, 529, 531, 426]"
237,7,5571,5639,9932,0,1712,3859,"[121, 82, 1168, 60, 509, 1088, 436, 0, 983, 808, 798, 1202, 1236, 398, 552, 582, 1071, 741, 136, 140, 525, 1207, 120, 778, 1283, 911, 49]"
238,7,6656,7280,9308,0,997,5659,"[1799, 925, 904, 1298, 1736, 397, 157, 0, 803, 556, 690, 983, 838, 337, 1328, 1068, 771, 1733, 265, 94, 570, 23, 1016, 960, 803, 1482, 1832]"
239,7,5446,5280,9474,0,365,5081,"[55, 96, 184, 31, 776, 32, 707, 0, 748, 36, 399, 991, 1637, 1052, 876, 207, 1637, 993, 1044, 945, 264, 1270, 548, 788, 343, 296, 89]"
240,7,5744,5256,9962,0,2768,2976,"[126, 488, 394, 441, 477, 506, 919, 0, 700, 283, 740, 966, 192, 630, 188, 978, 848, 913, 947, 336, 221, 819, 489, 289, 405, 222, 127]"
241,7,6412,5917,10000,457,3507,2905,"[805, 648, 87, 330, 153, 85, 637, 0, 193, 310, 649, 275, 497, 700, 42, 758, 936, 475, 468, 322, 325, 357, 526, 232, 474, 26, 705]"
242,7,6372,6269,10000,103,2628,3744,"[654, 624, 1224, 871, 542, 88, 1213, 0, 696, 418, 987, 328, 123, 739, 1054, 374, 441, 709, 602, 714, 708, 1075, 255, 1040, 114, 33, 1109]"
243,7,6920,7371,9549,0,4730,2190,"[122, 312, 432, 367, 475, 708, 446, 0, 654, 443, 251, 149, 600, 181, 459, 429, 511, 148, 82, 86, 499, 202, 146, 37, 542, 501, 445]"
244,7,5006,6398,8157,0,4898,108,"[2, 9, 16, 8, 29, 3, 16, 0, 29, 12, 4, 12, 34, 9, 23, 2, 12, 34, 2, 25, 18, 28, 5, 1, 26, 13, 22]"
245,7,5719,6907,6969,0,3042,2677,"[842, 851, 329, 34, 152, 2, 706, 0, 300, 406, 195, 477, 539, 159, 716, 246, 273, 890, 756, 339, 442, 768, 238, 830, 113, 389, 512]"
246,7,6306,6524,6751,0,4619,1687,"[237, 109, 459, 518, 406, 38, 335, 0, 467, 527, 372, 303, 85, 496, 117, 507, 370, 372, 444, 228, 479, 227, 363, 456, 9, 451, 269]"
247,7,5289,6182,5858,0,3371,1918,"[2, 61, 368, 556, 548, 503, 112, 0, 309, 598, 126, 106, 612, 206, 178, 369, 197, 564, 490, 69, 282, 121, 544, 234, 268, 135, 291]"
248,7,5068,76,10000,850,2572,2496,"[494, 229, 516, 482, 225, 189, 419, 0, 712, 491, 334, 451, 497, 672, 298, 501, 38, 0, 235, 784, 747, 494, 82, 313, 767, 719, 415]"
249,7,6939,7109,9830,0,5853,1086,"[243, 307, 170, 354, 42, 221, 286, 0, 350, 245, 73, 305, 24, 241, 8, 118, 87, 165, 129, 306, 153, 121, 327, 335, 343, 203, 63]"
250,7,6462,6875,9417,0,1313,5149,"[1208, 18, 173, 1697, 776, 757, 349, 0, 383, 429, 1416, 1641, 945, 641, 1347, 406, 1574, 1378, 1128, 1159, 892, 1537, 945, 1419, 1434, 1536, 1250]"
251,7,5227,6932,7712,0,3514,1713,"[25, 552, 280, 444, 223, 485, 80, 0, 313, 461, 435, 272, 464, 237, 450, 415, 435, 266, 273, 446, 231, 525, 341, 489, 535, 402, 253]"
252,7,6506,7022,7196,0,4572,1934,"[67, 80, 94, 184, 448, 205, 260, 0, 352, 26, 395, 194, 613, 184, 244, 521, 523, 150, 267, 190, 32, 143, 102, 232, 597, 224, 416]"
253,7,6936,6157,7975,0,620,6316,"[1430, 13, 1199, 1607, 261, 1509, 550, 0, 1484, 1445, 1500, 1409, 268, 912, 1387, 1490, 17, 1357, 1594, 1692, 1196, 756, 1363, 1343, 1164, 2097, 962]"
254,7,6427,6443,7959,0,3910,2517,"[722, 229, 246, 418, 237, 438, 765, 0, 657, 151, 765, 371, 795, 172, 213, 16, 197, 652, 734, 480, 301, 535, 388, 686, 400, 26, 490]"
255,7,5683,5333,8309,0,1589,4094,"[445, 245, 557, 182, 334, 437, 281, 0, 380, 350, 855, 130, 879, 225, 662, 119, 561, 1186, 445, 732, 720, 336, 58, 348, 183, 1075, 933]"
256,7,6197,5586,8920,0,2802,3395,"[63, 1104, 378, 1069, 516, 901, 553, 0, 457, 17, 181, 526, 873, 753, 757, 956, 467, 642, 1110, 939, 55, 794, 816, 488, 1038, 71, 631]"
257,7,5142,6908,7154,0,1857,3285,"[409, 657, 365, 185, 525, 914, 105, 0, 526, 91, 337, 363, 130, 957, 70, 970, 1028, 461, 567, 711, 1063, 177, 267, 492, 199, 331, 788]"
258,7,5626,7001,5779,0,2627,2999,"[211, 428, 125, 877, 33, 484, 24, 0, 809, 452, 785, 404, 223, 956, 644, 500, 761, 219, 441, 141, 228, 884, 148, 782, 204, 348, 268]"
259,7,6328,5895,6212,0,5481,847,"[247, 63, 109, 25, 248, 238, 196, 0, 32, 139, 19, 42, 180, 235, 141, 238, 90, 141, 258, 49, 19, 243, 81, 140, 158, 87, 39]"
260,7,6411,5458,7165,0,1347,5064,"[222, 53, 477, 396, 1210, 1571, 600, 0, 1117, 29, 789, 1547, 1546, 79, 166, 425, 1196, 444, 1039, 1532, 1316, 928, 318, 655, 640, 179, 531]"
261,7,6951,6652,7464,0,4516,2435,"[334, 66, 249, 320, 734, 352, 224, 0, 243, 509, 75, 251, 30, 200, 794, 278, 606, 97, 9, 54, 370, 242, 625, 589, 401, 358, 202]"
262,7,5551,7064,5951,0,5477,74,"[12, 14, 1, 23, 15, 18, 13, 0, 11, 20, 1, 20, 10, 24, 8, 20, 20, 0, 2, 5, 6, 3, 15, 14, 14, 0, 19]"
263,7,5387,6998,4340,0,4132,1255,"[305, 99, 259, 109, 247, 96, 329, 0, 20, 383, 84, 131, 225, 106, 249, 388, 306, 395, 131, 24, 366, 298, 401, 313, 397, 118, 70]"
264,7,6400,879,9861,0,5277,1123,"[336, 332, 168, 196, 138, 307, 229, 0, 301, 29, 243, 49, 299, 347, 57, 85, 77, 41, 339, 204, 280, 267, 316, 344, 171, 217, 14]"
265,7,5512,7105,8268,0,782,4730,"[1116, 216, 553, 461, 932, 1001, 1171, 0, 1171, 1538, 253, 1404, 193, 395, 579, 791, 224, 909, 880, 210, 1420, 375, 697, 360, 865, 1329, 662]"
266,7,6000,7069,7199,0,5289,711,"[26, 164, 118, 181, 123, 115, 1, 0, 141, 58, 176, 75, 153, 3, 128, 178, 144, 59, 121, 100, 223, 43, 218, 125, 119, 94, 135]"
267,7,5567,6500,6266,0,1506,4061,"[308, 290, 769, 1061, 306, 1340, 826, 0, 371, 904, 7, 1335, 1343, 851, 1076, 853, 130, 112, 1081, 92, 1096, 280, 831, 848, 282, 1216, 1294]"
268,7,6390,5216,7440,0,4775,1615,"[61, 225, 349, 281, 170, 245, 452, 0, 330, 111, 98, 439, 228, 189, 201, 283, 388, 159, 477, 316, 274, 190, 516, 89, 294, 47, 145]"
269,7,6127,6432,7135,0,1728,4399,"[46, 1405, 1417, 811, 310, 1377, 1128, 0, 250, 409, 1024, 694, 1204, 218, 947, 15, 1153, 1105, 537, 100, 1393, 489, 300, 233, 797, 191, 1466]"
270,7,5763,5979,6919,0,239,5524,"[495, 249, 1028, 629, 616, 331, 1519, 0, 309, 1654, 1661, 1095, 1271, 317, 820, 658, 1065, 1592, 1678, 813, 890, 1026, 1568, 1376, 243, 713, 399]"
271,7,5915,7315,5519,0,824,5091,"[1408, 534, 1128, 610, 491, 1188, 135, 0, 947, 999, 548, 1388, 37, 373, 1385, 785, 1026, 1167, 1232, 1509, 1568, 1234, 1056, 1688, 1133, 78, 63]"
272,7,5986,7243,4262,0,4337,1649,"[481, 463, 42, 412, 511, 508, 527, 0, 473, 191, 504, 60, 67, 14, 10, 368, 172, 295, 357, 241, 136, 373, 408, 399, 240, 113, 129]"
273,7,5029,3206,6085,0,1165,3864,"[449, 902, 73, 626, 944, 987, 1216, 0, 799, 2, 236, 742, 645, 1114, 995, 854, 415, 734, 355, 174, 1163, 958, 695, 217, 491, 29, 809]"
274,7,5130,5864,5351,0,1837,3293,"[727, 413, 434, 1017, 746, 982, 1023, 0, 484, 809, 163, 100, 477, 264, 1033, 857, 759, 103, 542, 167, 63, 238, 547, 608, 720, 1002, 131]"
275,7,5573,591,10000,333,1611,3962,"[1305, 642, 205, 990, 958, 850, 732, 0, 711, 930, 758, 719, 764, 1235, 427, 1272, 667, 1083, 1275, 984, 59, 1268, 22, 976, 628, 22, 1183]"
276,7,6959,6745,10000,214,1827,5132,"[951, 796, 1648, 731, 1571, 1496, 1295, 0, 1278, 1059, 1515, 1165, 600, 1565, 719, 594, 292, 695, 1449, 1346, 525, 284, 677, 428, 1457, 526, 515]"
277,7,6950,5168,10000,1782,6481,469,"[15, 125, 17, 39, 0, 91, 24, 0, 128, 56, 79, 121, 93, 101, 20, 76, 38, 81, 0, 45, 23, 40, 53, 57, 11, 149, 113]"
278,7,6305,6602,9703,0,112,6193,"[598, 1495, 1038, 328, 962, 61, 260, 0, 1065, 1840, 333, 280, 595, 1697, 253, 1137, 1018, 7, 143, 1593, 589, 1456, 989, 1842, 592, 1421, 1730]"
279,7,6353,5487,10000,569,5327,1026,"[156, 113, 96, 3, 2, 197, 199, 0, 270, 56, 178, 9, 245, 223, 223, 296, 86, 331, 138, 134, 310, 95, 295, 287, 336, 104, 168]"
280,7,5842,7226,8616,0,1650,4192,"[68, 909, 1045, 92, 982, 924, 394, 0, 64, 634, 1330, 1279, 943, 1010, 345, 1085, 567, 914, 1360, 1120, 158, 1218, 630, 1263, 1029, 242, 7]"
281,7,5216,6944,6888,0,3490,1726,"[531, 377, 466, 302, 242, 21, 121, 0, 213, 297, 387, 278, 123, 471, 498, 552, 380, 396, 200, 549, 484, 381, 325, 511, 533, 516, 315]"
282,7,5815,7097,5606,0,2207,3608,"[1153, 928, 1000, 171, 822, 362, 713, 0, 430, 690, 674, 1094, 671, 281, 978, 804, 238, 7, 606, 1048, 153, 4, 55, 171, 637, 128, 363]"
283,7,6206,5148,6664,0,4676,1530,"[49, 346, 328, 296, 183, 397, 36, 0, 5, 475, 507, 351, 372, 334, 383, 489, 115, 131, 128, 254, 35, 422, 365, 418, 278, 183, 99]"
284,7,6939,6996,6607,0,2003,4936,"[376, 541, 909, 1231, 1022, 1222, 818, 0, 1053, 1075, 863, 566, 1051, 1530, 1389, 971, 1030, 808, 489, 193, 339, 716, 1205, 446, 1536, 599, 632]"
285,7,6527,5922,7212,0,3277,3250,"[899, 170, 630, 318, 126, 342, 657, 0, 9, 955, 529, 769, 1003, 625, 632, 370, 885, 444, 1035, 621, 275, 440, 511, 443, 611, 203, 469]"
286,7,6234,5077,8369,0,3543,2691,"[257, 2, 167, 247, 509, 265, 432, 0, 515, 155, 586, 213, 700, 18, 716, 518, 355, 859, 29, 839, 556, 851, 557, 233, 339, 213, 867]"
287,7,5169,5202,8336,0,3638,1531,"[174, 74, 177, 3, 432, 187, 129, 0, 156, 415, 372, 220, 102, 284, 248, 326, 71, 295, 258, 486, 184, 197, 491, 97, 192, 423, 482]"
288,7,5706,5639,8403,0,5412,294,"[34, 27, 19, 69, 83, 50, 3, 0, 33, 44, 12, 40, 38, 26, 50, 57, 18, 41, 60, 34, 40, 25, 76, 59, 67, 63, 5]"
289,7,6053,6306,8150,0,4435,1618,"[244, 380, 266, 237, 381, 298, 174, 0, 147, 533, 83, 51, 393, 114, 127, 431, 317, 341, 449, 497, 165, 41, 356, 321, 200, 203, 208]"
290,7,5086,5148,8088,0,1808,3278,"[542, 831, 629, 912, 740, 834, 714, 0, 903, 669, 1078, 961, 1088, 195, 921, 999, 946, 766, 926, 500, 286, 809, 1011, 507, 972, 740, 514]"
291,7,5619,6046,7661,0,553,5066,"[1581, 1149, 1302, 1295, 1489, 823, 278, 0, 1314, 1375, 305, 203, 1543, 651, 1243, 230, 258, 1289, 826, 251, 917, 1261, 1397, 955, 1077, 616, 1467]"
292,7,5441,6345,6757,0,2552,2889,"[872, 467, 495, 804, 232, 503, 313, 0, 539, 711, 15, 589, 516, 812, 105, 594, 109, 314, 812, 711, 498, 445, 373, 312, 113, 754, 928]"
293,7,6082,7265,5574,0,4699,1383,"[276, 42, 37, 256, 224, 61, 45, 0, 211, 412, 210, 112, 263, 155, 58, 130, 102, 35, 95, 267, 445, 175, 103, 84, 446, 383, 103]"
294,7,6912,7258,5228,0,1106,5806,"[77, 1642, 179, 281, 5, 689, 1405, 0, 220, 1149, 608, 1885, 487, 419, 1153, 176, 1187, 1917, 451, 1317, 1038, 1572, 378, 1640, 441, 328, 277]"
295,7,5711,2979,7960,0,3579,2132,"[661, 598, 439, 480, 144, 486, 115, 0, 614, 384, 343, 4, 571, 441, 238, 241, 103, 557, 119, 581, 590, 154, 660, 359, 523, 77, 302]"
296,7,5737,5004,8693,0,1550,4187,"[204, 610, 104, 763, 1171, 990, 494, 0, 688, 61, 654, 1153, 515, 291, 613, 1335, 544, 574, 717, 962, 1078, 801, 1340, 674, 394, 135, 1125]"
297,7,6289,5483,9499,0,4458,1831,"[286, 5, 454, 316, 45, 407, 438, 0, 458, 319, 505, 365, 440, 603, 438, 298, 37, 121, 149, 537, 71, 454, 272, 347, 459, 602, 126]"
298,7,6605,7477,8627,0,3622,2983,"[864, 513, 703, 14, 951, 108, 471, 0, 121, 411, 32, 102, 980, 614, 515, 486, 72, 577, 642, 46, 325, 139, 39, 746, 494, 460, 822]"
299,7,6956,5178,10000,405,5327,1629,"[277, 144, 237, 144, 176, 218, 393, 0, 159, 146, 343, 92, 475, 453, 378, 189, 413, 409, 401, 0, 353, 160, 296, 184, 486, 347, 75]"
0,8,5258,0,5258,0,1801,3457,"[394, 844, 595, 651, 1142, 1050, 591, 0, 54, 1105, 267, 1025, 908, 14, 262, 374, 903, 665, 1084, 452, 1120, 1010, 909, 367, 1001, 74, 718]"
1,8,6985,5133,7110,0,15,6970,"[1474, 1895, 1385, 2020, 508, 663, 939, 0, 860, 1364, 1293, 97, 1000, 841, 573, 1855, 820, 1087, 1447, 2087, 2235, 1907, 649, 472, 388, 1079, 1554]"
2,8,5182,6833,5459,0,4465,717,"[152, 178, 18, 93, 97, 201, 235, 0, 214, 87, 71, 173, 89, 2, 96, 154, 164, 66, 86, 89, 235, 49, 132, 19, 128, 226, 99]"
3,8,5967,5628,5798,0,3258,2709,"[575, 866, 507, 766, 144, 6, 533, 0, 18, 742, 268, 303, 779, 682, 547, 350, 173, 370, 695, 527, 29, 690, 656, 572, 705, 520, 689]"
4,8,6116,6252,5662,0,4895,1221,"[253, 26, 307, 118, 333, 95, 260, 0, 255, 361, 325, 300, 223, 405, 292, 99, 265, 132, 1, 182, 114, 150, 73, 384, 158, 83, 282]"
5,8,6433,5316,6779,0,1879,4554,"[808, 1503, 1345, 530, 281, 917, 1179, 0, 1460, 587, 695, 489, 1474, 622, 1150, 160, 22, 288, 1184, 1323, 693, 712, 729, 350, 91, 121, 1259]"
6,8,5295,5476,6598,0,537,4758,"[1570, 472, 968, 524, 71, 1248, 1434, 0, 1571, 920, 1083, 1059, 185, 602, 666, 1545, 519, 314, 1456, 698, 1067, 1134, 966, 186, 1103, 920, 471]"
7,8,6026,6656,5968,0,126,5900,"[899, 238, 410, 1297, 1422, 1773, 585, 0, 1005, 1100, 1033, 810, 1531, 1644, 132, 792, 1606, 593, 1955, 1341, 1166, 1140, 1675, 927, 643, 661, 833]"
8,8,5318,6429,4857,0,175,5143,"[1287, 1116, 1632, 0, 1286, 1603, 877, 0, 328, 1017, 954, 506, 1198, 549, 1190, 220, 958, 477, 900, 318, 127, 1369, 1052, 665, 1355, 135, 1121]"
9,8,6284,5971,5170,0,1824,4460,"[97, 626, 1108, 49, 1036, 543, 706, 0, 2, 778, 1438, 642, 922, 1450, 314, 1390, 930, 1149, 450, 313, 250, 187, 92, 810, 690, 83, 1430]"
10,8,6894,5365,6699,0,5619,1275,"[88, 85, 146, 194, 323, 266, 139, 0, 315, 34, 105, 1, 415, 14, 190, 168, 176, 386, 425, 158, 189, 354, 394, 224, 259, 424, 214]"
11,8,5789,5404,7084,0,828,4961,"[877, 1588, 1128, 589, 1021, 721, 1546, 0, 364, 664, 1105, 913, 793, 810, 598, 600, 550, 1546, 843, 944, 735, 1307, 1480, 905, 375, 830, 258]"
12,8,6470,5540,8014,0,1937,4533,"[507, 1044, 30, 1463, 1242, 642, 902, 0, 1373, 789, 639, 1166, 350, 1079, 91, 645, 832, 714, 731, 1369, 759, 659, 1098, 805, 866, 276, 682]"
13,8,5366,5236,8144,0,479,4887,"[1251, 775, 672, 1417, 118, 121, 1380, 0, 240, 274, 491, 1321, 648, 33, 69, 325, 1474, 580, 52, 318, 1521, 303, 1327, 165, 1263, 243, 842]"
14,8,5272,7124,6292,0,1129,4143,"[1357, 998, 598, 236, 581, 1145, 937, 0, 480, 250, 836, 1223, 291, 705, 186, 789, 893, 112, 28, 213, 1057, 776, 673, 395, 191, 502, 794]"
15,8,5266,6455,5103,0,1164,4102,"[1337, 1360, 724, 583, 1250, 441, 847, 0, 629, 436, 1225, 1224, 827, 680, 1021, 66, 438, 25, 469, 119, 290, 632, 493, 720, 914, 467, 240]"
16,8,6283,6054,5332,0,1410,4873,"[1478, 743, 1073, 252, 852, 918, 1135, 0, 490, 137, 919, 32, 566, 310, 541, 917, 660, 617, 188, 321, 958, 157, 4, 507, 785, 191, 229]"
17,8,6138,6154,5316,0,2866,3272,"[474, 346, 380, 696, 675, 991, 252, 0, 517, 501, 835, 364, 1060, 612, 671, 673, 549, 103, 596, 205, 342, 790, 136, 295, 729, 1068, 154]"
18,8,5274,2876,7714,0,1211,4063,"[815, 281, 64, 1019, 943, 1138, 658, 0, 1183, 1002, 1210, 568, 532, 206, 1263, 714, 415, 717, 1264, 178, 206, 1256, 839, 866, 213, 548, 1066]"
19,8,6427,5657,8484,0,1229,5198,"[1216, 612, 1697, 1257, 1264, 294, 1571, 0, 1171, 732, 645, 1237, 1475, 1321, 574, 936, 945, 439, 524, 983, 837, 773, 687, 1603, 1182, 1731, 1633]"
20,8,5558,6004,8038,0,749,4809,"[225, 466, 124, 1531, 1127, 1395, 203, 0, 970, 770, 1560, 70, 75, 39, 1336, 252, 91, 1252, 1312, 832, 1276, 1347, 767, 611, 402, 1186, 878]"
21,8,5063,7173,5928,0,3108,1955,"[380, 19, 125, 165, 124, 363, 565, 0, 434, 103, 105, 456, 357, 613, 143, 624, 211, 521, 292, 333, 146, 495, 387, 265, 162, 123, 53]"
22,8,5312,5388,5852,0,3070,2242,"[711, 691, 579, 499, 107, 55, 626, 0, 654, 325, 173, 360, 96, 401, 683, 731, 148, 198, 75, 452, 687, 385, 563, 124, 406, 441, 577]"
23,8,6572,5202,7222,0,553,6019,"[146, 83, 815, 123, 1740, 485, 1132, 0, 1129, 1902, 447, 703, 1216, 52, 1718, 1531, 1360, 1028, 378, 1785, 678, 670, 1685, 685, 1095, 1142, 517]"
24,8,6283,5597,7908,0,663,5620,"[956, 424, 133, 196, 260, 373, 1008, 0, 870, 815, 1638, 1370, 138, 923, 1832, 80, 1095, 1680, 1559, 29, 628, 81, 9, 829, 525, 1492, 455]"
25,8,6314,6855,7367,0,4217,2097,"[138, 193, 251, 223, 113, 634, 435, 0, 647, 176, 50, 469, 216, 13, 195, 350, 546, 159, 28, 529, 543, 589, 16, 280, 307, 39, 611]"
26,8,5542,5087,7822,0,1995,3547,"[1071, 346, 366, 1131, 970, 233, 759, 0, 645, 677, 530, 943, 801, 730, 291, 681, 10, 551, 1157, 1027, 758, 219, 1125, 490, 1080, 972, 583]"
27,8,6871,5078,9615,0,2426,4445,"[849, 851, 266, 397, 741, 1254, 1117, 0, 1345, 1406, 427, 402, 827, 495, 195, 282, 1209, 249, 54, 826, 119, 340, 565, 886, 1312, 393, 1172]"
28,8,6252,6261,9606,0,5820,432,"[65, 116, 111, 51, 109, 52, 49, 0, 19, 115, 115, 46, 71, 25, 17, 8, 132, 54, 81, 45, 29, 142, 137, 29, 138, 123, 45]"
29,8,5725,5345,9986,0,322,5403,"[282, 1164, 636, 244, 1467, 1304, 754, 0, 305, 1158, 38, 136, 1797, 22, 1151, 228, 346, 1170, 908, 1277, 800, 750, 922, 203, 864, 524, 1028]"
30,8,6657,5993,10000,650,3793,2864,"[88, 566, 681, 239, 115, 175, 729, 0, 318, 228, 440, 689, 250, 898, 123, 327, 940, 642, 34, 601, 8, 157, 844, 526, 335, 194, 504]"
31,8,5983,5226,10000,757,1199,4784,"[1428, 488, 1263, 557, 1054, 1183, 543, 0, 647, 307, 410, 310, 448, 484, 77, 482, 616, 920, 1119, 1506, 188, 1403, 783, 147, 333, 569, 759]"
32,8,5494,6198,9296,0,1805,3689,"[602, 584, 53, 566, 806, 900, 975, 0, 860, 481, 1059, 137, 909, 793, 727, 1034, 853, 356, 951, 117, 453, 1064, 1180, 273, 901, 809, 495]"
33,8,5513,7123,7686,0,4906,607,"[17, 10, 49, 103, 177, 122, 5, 0, 66, 39, 117, 35, 63, 138, 101, 104, 80, 119, 186, 126, 67, 127, 92, 96, 142, 12, 200]"
34,8,6327,5672,8341,0,72,6255,"[1886, 1601, 2001, 802, 1288, 1669, 1759, 0, 440, 658, 1600, 218, 1609, 1453, 1494, 783, 1286, 874, 1761, 869, 412, 1774, 1908, 1556, 174, 1433, 843]"
35,8,5211,7327,6225,0,4705,506,"[110, 73, 55, 133, 1, 88, 55, 0, 168, 19, 156, 41, 10, 62, 162, 77, 84, 147, 111, 75, 14, 138, 13, 77, 114, 29, 10]"
36,8,5047,7289,3983,0,476,4571,"[194, 663, 1399, 1317, 1448, 734, 157, 0, 777, 563, 598, 705, 336, 1392, 930, 119, 648, 1082, 1313, 134, 1318, 1172, 1081, 734, 1139, 1143, 884]"
37,8,5058,1501,7540,0,534,4524,"[1110, 612, 1078, 546, 660, 1066, 1019, 0, 1374, 562, 1001, 326, 350, 8, 910, 1099, 610, 813, 159, 1337, 754, 285, 1493, 1463, 1479, 297, 293]"
38,8,5877,5447,7970,0,4343,1534,"[317, 439, 63, 17, 133, 3, 168, 0, 283, 233, 500, 359, 460, 122, 64, 319, 489, 458, 419, 510, 335, 260, 278, 430, 80, 417, 362]"
39,8,5339,6310,6999,0,2634,2705,"[189, 816, 844, 9, 485, 49, 861, 0, 109, 878, 160, 427, 283, 484, 198, 143, 372, 668, 798, 326, 454, 580, 576, 325, 649, 61, 212]"
40,8,5695,6023,6671,0,1473,4222,"[233, 831, 1368, 591, 601, 200, 672, 0, 1186, 382, 832, 728, 1130, 970, 436, 970, 193, 607, 1381, 988, 929, 412, 1384, 746, 1173, 15, 109]"
41,8,5235,5683,6223,0,5108,127,"[41, 0, 32, 22, 34, 15, 41, 0, 38, 5, 25, 13, 28, 10, 34, 40, 41, 15, 7, 39, 32, 10, 18, 17, 5, 33, 1]"
42,8,5680,7433,4470,0,1055,4625,"[142, 288, 692, 594, 1032, 1224, 787, 0, 865, 1360, 1505, 925, 1106, 590, 1073, 610, 743, 547, 1217, 1303, 219, 159, 1278, 323, 1068, 341, 1154]"
43,8,6390,869,9991,0,3619,2771,"[671, 54, 581, 605, 374, 508, 218, 0, 818, 512, 671, 566, 708, 676, 105, 401, 826, 197, 867, 207, 671, 465, 159, 491, 185, 429, 415]"
44,8,6799,5179,10000,1611,5133,1666,"[492, 28, 226, 224, 74, 80, 267, 0, 328, 253, 183, 393, 2, 191, 531, 395, 341, 329, 37, 511, 283, 198, 43, 554, 214, 538, 64]"
45,8,6166,7114,9052,0,3158,3008,"[631, 219, 534, 743, 355, 75, 205, 0, 225, 862, 549, 524, 639, 937, 893, 810, 618, 465, 106, 933, 376, 387, 523, 259, 814, 875, 411]"
46,8,6455,6197,9310,0,3744,2711,"[443, 102, 97, 337, 331, 831, 451, 0, 863, 727, 756, 106, 647, 517, 158, 701, 220, 849, 796, 814, 442, 245, 590, 386, 488, 242, 889]"
47,8,6303,6737,8876,0,503,5800,"[1008, 211, 332, 1570, 308, 282, 1103, 0, 1101, 1497, 315, 819, 1344, 1722, 775, 758, 541, 1143, 1821, 144, 1535, 26, 1424, 178, 1218, 1225, 1486]"
48,8,5299,7417,6758,0,1240,4059,"[459, 848, 868, 792, 291, 985, 971, 0, 607, 499, 105, 1171, 1177, 319, 600, 418, 21, 1003, 351, 1206, 1328, 332, 439, 1234, 535, 202, 1007]"
49,8,6982,5732,8008,0,1832,5150,"[870, 158, 198, 534, 120, 736, 1365, 0, 813, 1220, 592, 99, 1179, 1692, 1689, 1695, 1261, 1481, 9, 31, 243, 682, 1350, 1111, 1637, 286, 1120]"
50,8,6960,5244,9724,0,451,6509,"[1573, 1729, 618, 327, 880, 822, 1481, 0, 383, 1470, 883, 1358, 359, 684, 2093, 102, 1521, 1474, 548, 139, 1674, 984, 759, 1915, 33, 965, 1395]"
51,8,5761,5066,10000,419,1413,4348,"[1111, 1233, 1209, 449, 756, 189, 541, 0, 565, 201, 1311, 841, 343, 5, 1125, 801, 1396, 511, 1442, 560, 431, 519, 1056, 257, 689, 1183, 1056]"
52,8,5108,5880,9228,0,1091,4017,"[1013, 281, 225, 315, 254, 703, 1050, 0, 476, 737, 566, 717, 719, 588, 891, 1056, 773, 132, 1315, 342, 889, 743, 767, 480, 449, 622, 109]"
53,8,6305,7231,8302,0,1655,4650,"[928, 35, 1088, 151, 565, 258, 522, 0, 59, 446, 1220, 1130, 601, 1351, 618, 364, 287, 551, 1509, 1027, 710, 1421, 172, 82, 1417, 619, 908]"
54,8,5424,7248,6478,0,4082,1342,"[136, 345, 280, 120, 394, 392, 440, 0, 380, 83, 43, 305, 379, 241, 200, 158, 390, 1, 145, 363, 276, 240, 225, 312, 416, 48, 398]"
55,8,6700,7148,6030,0,3403,3297,"[588, 512, 689, 478, 962, 713, 957, 0, 228, 163, 512, 386, 557, 641, 91, 85, 524, 529, 237, 174, 408, 855, 613, 767, 983, 835, 1066]"
56,8,6502,6446,6086,0,501,6001,"[1769, 898, 275, 796, 695, 1404, 1068, 0, 887, 1254, 905, 1801, 521, 6, 384, 668, 517, 1718, 1400, 758, 450, 819, 1822, 807, 1311, 867, 604]"
57,8,6753,7250,5589,0,4568,2185,"[331, 440, 248, 413, 671, 652, 262, 0, 677, 444, 700, 239, 699, 695, 640, 48, 263, 200, 143, 66, 124, 73, 151, 181, 450, 452, 448]"
58,8,5304,3873,7020,0,396,4908,"[139, 157, 1528, 189, 598, 933, 1493, 0, 566, 376, 672, 1043, 1048, 696, 1520, 1144, 1082, 576, 1138, 1328, 1191, 985, 1280, 132, 1421, 1411, 849]"
59,8,6669,5947,7742,0,6652,17,"[1, 4, 2, 3, 5, 3, 3, 0, 4, 0, 0, 0, 1, 2, 2, 4, 5, 1, 2, 2, 5, 0, 3, 4, 0, 3, 1]"
60,8,5778,5554,7966,0,2173,3605,"[921, 368, 197, 14, 250, 1200, 985, 0, 247, 5, 406, 205, 182, 643, 982, 193, 438, 389, 105, 946, 330, 224, 2, 940, 480, 851, 71]"
61,8,5352,6204,7114,0,4218,1134,"[53, 280, 45, 27, 329, 166, 126, 0, 104, 132, 362, 183, 304, 134, 101, 179, 150, 291, 42, 6, 189, 67, 344, 72, 203, 225, 266]"
62,8,6583,6083,7614,0,5792,791,"[160, 231, 206, 147, 92, 62, 165, 0, 97, 171, 35, 213, 48, 167, 31, 259, 63, 62, 222, 145, 51, 254, 156, 225, 41, 135, 194]"
63,8,5906,6417,7103,0,5364,542,"[24, 21, 89, 83, 25, 7, 52, 0, 161, 65, 88, 149, 129, 142, 107, 86, 109, 174, 26, 108, 128, 140, 66, 172, 174, 21, 142]"
64,8,5986,7215,5874,0,3556,2430,"[323, 785, 174, 474, 267, 557, 579, 0, 508, 396, 257, 231, 13, 807, 201, 323, 103, 629, 209, 410, 514, 324, 198, 736, 504, 735, 338]"
65,8,5584,6629,4829,0,4309,1275,"[230, 271, 423, 268, 298, 90, 239, 0, 35, 183, 394, 5, 114, 354, 354, 140, 77, 306, 258, 423, 78, 400, 69, 304, 258, 245, 74]"
66,8,5825,1570,9084,0,5131,694,"[5, 200, 122, 73, 202, 14, 80, 0, 91, 51, 189, 214, 182, 162, 181, 132, 166, 14, 62, 46, 131, 203, 182, 191, 12, 31, 72]"
67,8,6239,5709,9614,0,3534,2705,"[511, 102, 604, 64, 364, 70, 411, 0, 891, 363, 863, 174, 311, 831, 644, 42, 396, 443, 823, 650, 761, 367, 508, 351, 511, 423, 539]"
68,8,6326,6351,9589,0,210,6116,"[1505, 478, 551, 1813, 1989, 1775, 269, 0, 869, 1428, 12, 1173, 2008, 1277, 790, 262, 817, 1898, 1524, 10, 1562, 611, 277, 246, 904, 490, 1337]"
69,8,5649,7173,8065,0,4901,748,"[83, 52, 130, 94, 198, 191, 154, 0, 230, 236, 14, 185, 70, 89, 218, 239, 233, 168, 136, 179, 72, 204, 71, 14, 90, 200, 140]"
70,8,5197,5730,7532,0,1182,4015,"[1184, 479, 1292, 50, 1248, 1328, 201, 0, 385, 679, 908, 221, 389, 1238, 1301, 625, 145, 1017, 1315, 74, 131, 878, 788, 1335, 515, 1146, 681]"
71,8,5098,6618,6012,0,4054,1044,"[87, 21, 213, 197, 261, 227, 286, 0, 19, 261, 199, 147, 27, 274, 278, 29, 136, 136, 96, 341, 331, 42, 142, 223, 255, 230, 74]"
72,8,5130,6864,4278,0,4994,136,"[36, 23, 41, 36, 18, 23, 31, 0, 45, 16, 37, 12, 0, 21, 29, 20, 0, 31, 34, 6, 43, 1, 34, 4, 12, 17, 20]"
73,8,6966,6031,5213,0,3572,3394,"[662, 287, 438, 589, 658, 1028, 1006, 0, 201, 1053, 696, 1062, 885, 533, 477, 667, 182, 910, 122, 345, 358, 986, 225, 419, 275, 822, 233]"
74,8,5152,602,9763,0,1337,3815,"[227, 1073, 303, 1015, 629, 1189, 647, 0, 279, 64, 879, 516, 78, 994, 884, 191, 1244, 122, 84, 1017, 125, 500, 528, 729, 1233, 708, 1210]"
75,8,5353,6090,9026,0,2729,2624,"[278, 727, 522, 785, 222, 607, 608, 0, 448, 208, 752, 353, 141, 337, 581, 619, 451, 698, 769, 542, 186, 465, 308, 800, 583, 849, 5]"
76,8,6550,5975,9601,0,3611,2939,"[342, 438, 896, 217, 340, 843, 297, 0, 282, 368, 806, 295, 80, 690, 116, 393, 175, 767, 820, 540, 364, 319, 79, 550, 89, 51, 976]"
77,8,5810,5988,9423,0,2262,3548,"[734, 943, 158, 578, 261, 57, 348, 0, 784, 177, 785, 359, 167, 453, 889, 105, 184, 1062, 303, 162, 918, 735, 1034, 197, 467, 1089, 1133]"
78,8,6528,6375,9576,0,1625,4903,"[354, 714, 1286, 374, 383, 1367, 87, 0, 699, 865, 931, 204, 1360, 566, 111, 1188, 358, 414, 314, 64, 276, 858, 698, 325, 1238, 556, 917]"
79,8,6137,5705,10000,8,563,5574,"[1723, 230, 390, 163, 1779, 1513, 347, 0, 1429, 590, 595, 1615, 1170, 1610, 313, 182, 1068, 67, 981, 1714, 1525, 624, 111, 349, 1197, 1035, 1316]"
80,8,5559,5608,9951,0,3777,1782,"[505, 515, 342, 557, 296, 5, 28, 0, 147, 47, 330, 236, 249, 342, 223, 357, 314, 432, 349, 212, 572, 571, 353, 533, 57, 122, 89]"
81,8,6890,6095,10000,746,3670,3220,"[448, 815, 574, 422, 577, 189, 91, 0, 920, 602, 453, 586, 729, 848, 911, 385, 843, 179, 577, 1038, 578, 889, 312, 969, 536, 337, 769]"
82,8,5478,7206,8272,0,15,5463,"[1662, 873, 889, 780, 1457, 741, 514, 0, 98, 1613, 1772, 1353, 460, 531, 762, 393, 1707, 1286, 1000, 1560, 1749, 543, 1522, 1685, 557, 39, 1559]"
83,8,5026,6010,7288,0,4709,317,"[3, 14, 77, 15, 80, 69, 43, 0, 88, 94, 58, 102, 69, 69, 22, 66, 83, 78, 95, 56, 100, 60, 60, 70, 13, 48, 55]"
84,8,5504,6585,6207,0,1166,4338,"[1069, 129, 1352, 1053, 514, 1065, 1170, 0, 984, 108, 975, 628, 425, 211, 834, 793, 834, 1412, 597, 72, 773, 145, 502, 872, 289, 515, 521]"
85,8,5533,7405,4335,0,1209,4324,"[1357, 629, 191, 689, 1391, 548, 923, 0, 342, 587, 339, 13, 1267, 1226, 802, 1310, 833, 612, 654, 476, 646, 55, 1028, 616, 868, 113, 1389]"
86,8,5561,4654,5242,0,1392,4169,"[1266, 119, 163, 216, 1016, 872, 103, 0, 175, 830, 490, 396, 145, 801, 1045, 856, 37, 1275, 303, 1036, 718, 886, 468, 799, 831, 1193, 1154]"
87,8,6959,6026,6175,0,4557,2402,"[13, 360, 59, 194, 138, 0, 530, 0, 118, 620, 20, 733, 51, 487, 635, 765, 347, 240, 730, 615, 397, 553, 354, 536, 218, 85, 765]"
88,8,5048,6293,4930,0,4900,148,"[4, 10, 41, 27, 45, 30, 44, 0, 5, 14, 25, 19, 45, 31, 43, 27, 15, 37, 46, 21, 24, 36, 27, 10, 2, 7, 49]"
89,8,5470,4093,6307,0,3489,1981,"[260, 320, 100, 114, 128, 214, 39, 0, 568, 205, 134, 91, 46, 522, 11, 587, 425, 428, 323, 265, 127, 214, 455, 512, 239, 11, 426]"
90,8,5440,7162,4585,0,3217,2223,"[525, 207, 363, 324, 97, 269, 732, 0, 286, 294, 154, 255, 432, 693, 446, 117, 547, 590, 14, 347, 282, 482, 603, 374, 498, 9, 643]"
91,8,5512,5091,5006,0,5460,52,"[6, 11, 1, 10, 16, 12, 11, 0, 15, 11, 0, 10, 11, 11, 7, 5, 13, 0, 16, 14, 15, 0, 6, 17, 2, 16, 0]"
92,8,5379,1017,9368,0,928,4451,"[1352, 817, 145, 1434, 98, 1324, 155, 0, 378, 937, 185, 1325, 1109, 1365, 238, 813, 1310, 826, 713, 1292, 502, 154, 962, 506, 1346, 101, 91]"
93,8,6191,5056,10000,503,4039,2152,"[58, 15, 446, 231, 138, 430, 307, 0, 343, 313, 618, 640, 682, 307, 399, 315, 132, 45, 28, 439, 446, 474, 318, 178, 476, 324, 486]"
94,8,5379,7159,8220,0,237,5142,"[206, 1518, 574, 968, 26, 1633, 1224, 0, 943, 412, 165, 1566, 246, 1117, 164, 1434, 1433, 327, 1514, 926, 343, 471, 15, 1438, 1629, 1067, 1482]"
95,8,5803,5702,8321,0,998,4805,"[548, 1236, 725, 500, 627, 1404, 1409, 0, 245, 377, 1573, 0, 502, 614, 7, 78, 706, 453, 1331, 670, 598, 723, 590, 535, 411, 1585, 1102]"
96,8,6040,5277,9084,0,1509,4531,"[335, 678, 836, 871, 988, 1032, 756, 0, 1127, 1498, 63, 49, 1079, 152, 289, 329, 391, 1172, 1392, 1424, 309, 206, 585, 1168, 641, 227, 369]"
97,8,6543,5792,9835,0,1399,5144,"[1134, 46, 210, 1590, 1484, 282, 439, 0, 80, 466, 1624, 708, 1059, 1525, 1698, 875, 1507, 1011, 1267, 1448, 1708, 1063, 1371, 943, 1119, 981, 1550]"
98,8,6292,5503,10000,624,3841,2451,"[395, 444, 742, 347, 457, 491, 523, 0, 218, 649, 549, 94, 679, 325, 128, 774, 104, 465, 101, 295, 433, 574, 772, 634, 213, 105, 781]"
99,8,6243,5393,10000,850,3278,2965,"[780, 315, 69, 123, 143, 256, 81, 0, 347, 68, 657, 793, 177, 196, 126, 722, 377, 806, 545, 669, 108, 716, 119, 475, 581, 114, 795]"
100,8,6959,5888,10000,1071,4022,2937,"[678, 21, 148, 549, 248, 638, 489, 0, 557, 171, 682, 790, 211, 186, 566, 533, 554, 669, 140, 803, 702, 968, 144, 166, 380, 892, 901]"
101,8,5765,6750,9015,0,4194,1571,"[51, 283, 236, 518, 394, 53, 265, 0, 43, 473, 379, 419, 311, 44, 91, 447, 257, 294, 359, 343, 145, 337, 190, 461, 86, 262, 185]"
102,8,6873,7270,8618,0,1530,5343,"[78, 423, 576, 1337, 1629, 1178, 1767, 0, 27, 363, 501, 524, 913, 1525, 687, 674, 1162, 494, 2, 1738, 128, 728, 158, 517, 560, 1226, 1106]"
103,8,6162,7411,7369,0,5477,685,"[94, 199, 69, 57, 202, 44, 66, 0, 39, 26, 101, 182, 140, 49, 93, 200, 213, 143, 171, 113, 103, 88, 192, 203, 208, 127, 203]"
104,8,6246,6718,6897,0,4203,2043,"[367, 295, 370, 142, 286, 1, 433, 0, 62, 427, 101, 523, 40, 474, 240, 433, 30, 361, 186, 504, 470, 537, 414, 592, 230, 318, 412]"
105,8,6316,5180,8033,0,3141,3175,"[172, 737, 547, 488, 778, 225, 323, 0, 1003, 79, 327, 913, 841, 269, 127, 397, 602, 148, 277, 205, 248, 142, 921, 1043, 361, 574, 1008]"
106,8,5535,6497,7071,0,302,5233,"[813, 71, 1099, 1635, 427, 1664, 1370, 0, 1583, 166, 949, 515, 1061, 1674, 223, 311, 1523, 430, 670, 80, 567, 1394, 720, 1172, 600, 1264, 573]"
107,8,5161,6763,5469,0,436,4725,"[1095, 208, 1093, 884, 1111, 820, 1471, 0, 757, 268, 99, 1561, 1077, 696, 128, 1321, 1229, 811, 83, 1534, 1153, 43, 146, 221, 1138, 1035, 1012]"
108,8,5569,6842,4196,0,2508,3061,"[342, 151, 811, 515, 774, 823, 795, 0, 95, 665, 188, 44, 47, 665, 943, 1007, 255, 638, 592, 261, 446, 892, 1003, 508, 439, 609, 912]"
109,8,5554,2193,7557,0,996,4558,"[261, 77, 164, 1277, 626, 446, 654, 0, 341, 773, 387, 603, 1415, 519, 205, 613, 534, 446, 884, 1282, 618, 805, 1076, 978, 778, 526, 1101]"
110,8,5198,6162,6593,0,1657,3541,"[952, 250, 86, 233, 764, 941, 329, 0, 1019, 1062, 85, 9, 461, 184, 1094, 989, 467, 19, 974, 975, 962, 291, 1023, 1111, 413, 1016, 23]"
111,8,5373,5496,6470,0,2827,2546,"[450, 840, 781, 749, 431, 49, 846, 0, 128, 423, 66, 339, 364, 839, 487, 314, 134, 689, 144, 725, 42, 723, 294, 664, 196, 336, 307]"
112,8,5958,6247,6181,0,4411,1547,"[66, 210, 162, 311, 223, 157, 157, 0, 248, 394, 211, 234, 186, 432, 244, 479, 353, 3, 202, 247, 178, 95, 247, 133, 317, 381, 72]"
113,8,5758,7197,4742,0,1665,4093,"[772, 888, 1067, 1034, 1147, 463, 85, 0, 826, 558, 831, 213, 574, 1129, 712, 157, 489, 1001, 941, 1171, 871, 1003, 830, 575, 410, 1250, 1114]"
114,8,6356,5575,5523,0,2042,4314,"[1365, 766, 171, 82, 519, 648, 70, 0, 294, 274, 875, 1384, 745, 1218, 1419, 1406, 188, 1358, 1051, 505, 405, 1396, 502, 935, 1351, 1207, 1067]"
115,8,6881,5166,7238,0,2332,4549,"[386, 1340, 227, 1122, 829, 17, 174, 0, 686, 243, 57, 210, 1473, 834, 1025, 8, 170, 645, 192, 611, 569, 895, 362, 639, 819, 1346, 665]"
116,8,5499,6413,6324,0,1019,4480,"[1424, 490, 324, 51, 1001, 645, 1096, 0, 70, 1007, 42, 95, 591, 663, 1222, 543, 890, 378, 4, 592, 1487, 120, 1231, 347, 369, 52, 953]"
117,8,6857,6280,6901,0,6740,117,"[22, 7, 28, 22, 11, 13, 12, 0, 19, 16, 35, 7, 10, 9, 31, 10, 19, 18, 19, 23, 3, 13, 5, 20, 27, 24, 25]"
118,8,5133,6451,5583,0,4531,602,"[143, 18, 65, 87, 181, 50, 101, 0, 151, 138, 22, 15, 99, 200, 140, 82, 173, 14, 74, 73, 133, 17, 151, 159, 118, 183, 77]"
119,8,6307,6203,5687,0,95,6212,"[1358, 938, 586, 1174, 264, 1731, 1010, 0, 177, 1801, 1749, 202, 1955, 326, 155, 220, 1706, 116, 772, 79, 1194, 464, 1256, 1300, 1695, 1950, 1059]"
120,8,5871,5096,6462,0,88,5783,"[149, 1108, 126, 1739, 783, 1165, 168, 0, 1223, 831, 1242, 1361, 1207, 1374, 1159, 245, 1539, 105, 416, 1898, 1610, 696, 162, 925, 1648, 1002, 356]"
121,8,6545,6872,6135,0,4237,2308,"[700, 84, 726, 739, 754, 288, 295, 0, 727, 625, 463, 363, 483, 115, 719, 226, 258, 94, 510, 309, 303, 379, 269, 660, 334, 634, 344]"
122,8,5210,5934,5411,0,316,4894,"[480, 1176, 1396, 659, 341, 170, 519, 0, 2, 658, 1435, 1340, 1006, 1255, 1459, 414, 1251, 161, 1007, 109, 279, 485, 1178, 442, 1287, 1180, 173]"
123,8,6196,6397,5210,0,2663,3533,"[369, 588, 827, 320, 570, 28, 640, 0, 131, 807, 249, 423, 177, 825, 922, 660, 167, 662, 941, 1017, 92, 152, 342, 804, 227, 822, 384]"
124,8,5382,1765,8827,0,1650,3732,"[188, 794, 1029, 1199, 223, 263, 370, 0, 617, 628, 1175, 1048, 162, 646, 731, 552, 161, 843, 20, 442, 1160, 913, 675, 87, 1141, 168, 1006]"
125,8,6079,5022,9884,0,735,5344,"[627, 783, 1397, 597, 374, 133, 412, 0, 636, 42, 587, 1200, 1454, 234, 1119, 1506, 251, 1240, 1427, 341, 154, 1076, 518, 1274, 221, 915, 1539]"
126,8,6948,5763,10000,1069,498,6450,"[1328, 1104, 888, 544, 1993, 289, 675, 0, 361, 1639, 2074, 1329, 317, 1329, 1023, 518, 1062, 1354, 1800, 395, 1802, 1784, 1393, 28, 725, 1752, 58]"
127,8,6205,5314,10000,891,5474,731,"[234, 105, 115, 130, 157, 116, 51, 0, 5, 152, 104, 193, 182, 144, 56, 224, 191, 230, 24, 179, 148, 129, 182, 189, 139, 212, 110]"
128,8,5557,6999,8558,0,5318,239,"[76, 34, 40, 74, 17, 0, 21, 0, 76, 21, 31, 54, 27, 9, 49, 28, 15, 71, 49, 28, 10, 57, 63, 9, 54, 33, 78]"
129,8,5203,6499,7262,0,2420,2783,"[776, 899, 841, 576, 12, 670, 444, 0, 761, 746, 626, 539, 828, 880, 552, 781, 809, 783, 541, 492, 203, 280, 280, 466, 258, 18, 799]"
130,8,5268,5577,6953,0,3487,1781,"[292, 152, 3, 524, 51, 496, 370, 0, 98, 548, 446, 3, 336, 541, 409, 369, 107, 541, 334, 325, 324, 108, 246, 204, 177, 246, 522]"
131,8,5193,5475,6671,0,4567,626,"[74, 114, 205, 11, 97, 193, 31, 0, 59, 7, 36, 31, 49, 12, 13, 164, 169, 134, 43, 54, 88, 44, 141, 56, 156, 34, 1]"
132,8,5312,7331,4652,0,2510,2802,"[621, 87, 802, 297, 282, 220, 324, 0, 467, 43, 150, 820, 742, 710, 441, 324, 58, 454, 859, 224, 129, 222, 475, 869, 210, 399, 839]"
133,8,6211,3348,7515,0,3031,3180,"[104, 830, 89, 648, 574, 211, 344, 0, 299, 974, 913, 129, 101, 784, 578, 182, 668, 57, 26, 526, 1020, 762, 601, 695, 683, 128, 378]"
134,8,6938,6464,7989,0,3311,3627,"[900, 927, 137, 956, 787, 352, 1150, 0, 1191, 588, 1033, 1120, 414, 182, 601, 926, 105, 758, 63, 19, 382, 139, 746, 316, 177, 437, 791]"
135,8,5048,6856,6181,0,694,4354,"[951, 139, 1268, 794, 568, 1112, 1234, 0, 1322, 1401, 187, 542, 922, 205, 439, 542, 498, 97, 120, 586, 221, 1077, 394, 941, 1048, 67, 818]"
136,8,5313,5668,5826,0,1749,3564,"[207, 657, 2, 708, 1153, 897, 833, 0, 699, 92, 178, 554, 1087, 1080, 1168, 697, 428, 733, 658, 318, 1008, 911, 1114, 424, 105, 855, 514]"
137,8,5064,5015,5875,0,2054,3010,"[771, 288, 935, 411, 343, 658, 51, 0, 466, 80, 37, 954, 793, 935, 125, 329, 274, 881, 203, 174, 961, 485, 768, 855, 876, 74, 426]"
138,8,6301,6526,5650,0,1526,4775,"[1395, 758, 1569, 1243, 1009, 95, 7, 0, 685, 1277, 1233, 765, 242, 183, 800, 1405, 1534, 25, 345, 1197, 626, 650, 275, 339, 633, 93, 838]"
139,8,5436,6584,4502,0,379,5057,"[928, 326, 721, 252, 1000, 589, 1415, 0, 1228, 894, 1146, 1413, 350, 593, 1567, 309, 1655, 1357, 495, 682, 1408, 1382, 861, 718, 281, 1685, 1071]"
140,8,6958,5146,6314,0,241,6717,"[1062, 574, 2093, 826, 1960, 329, 1391, 0, 1608, 392, 1235, 202, 2123, 662, 1981, 1394, 1580, 517, 460, 2127, 2231, 444, 2053, 1979, 274, 592, 404]"
141,8,6936,5458,7792,0,2569,4367,"[423, 470, 156, 685, 238, 12, 788, 0, 1449, 1080, 0, 339, 924, 1107, 84, 746, 940, 1108, 267, 418, 914, 63, 448, 950, 1248, 796, 208]"
142,8,5327,6351,6768,0,2578,2749,"[759, 402, 614, 684, 636, 555, 261, 0, 696, 680, 914, 109, 730, 654, 373, 417, 750, 391, 616, 117, 44, 712, 772, 572, 671, 650, 148]"
143,8,5085,5416,6437,0,4738,347,"[40, 98, 49, 18, 7, 39, 71, 0, 108, 106, 97, 86, 36, 85, 24, 36, 48, 17, 88, 99, 16, 10, 73, 10, 40, 8, 7]"
144,8,5810,5205,7042,0,4231,1579,"[495, 82, 509, 110, 473, 455, 244, 0, 338, 365, 57, 169, 197, 308, 169, 316, 223, 243, 469, 504, 336, 28, 447, 364, 284, 219, 311]"
145,8,6041,7434,5649,0,2898,3143,"[330, 622, 525, 296, 677, 239, 216, 0, 474, 102, 202, 1030, 941, 245, 126, 285, 56, 1035, 330, 114, 653, 634, 892, 933, 572, 476, 947]"
146,8,5426,5354,5721,0,4951,475,"[23, 74, 17, 80, 111, 65, 7, 0, 102, 36, 87, 12, 130, 144, 42, 149, 77, 31, 124, 135, 33, 38, 128, 29, 90, 86, 13]"
147,8,5647,5906,5462,0,3776,1871,"[314, 45, 157, 64, 206, 399, 61, 0, 158, 137, 9, 355, 2, 253, 290, 82, 621, 416, 33, 354, 464, 378, 14, 205, 372, 614, 380]"
148,8,6576,6006,6032,0,1357,5219,"[1708, 5, 1540, 1362, 993, 1706, 183, 0, 132, 601, 1348, 1241, 1140, 1159, 859, 886, 1665, 1472, 363, 232, 387, 12, 1358, 68, 63, 1464, 575]"
149,8,6491,6741,5782,0,681,5810,"[965, 1769, 927, 950, 715, 1014, 290, 0, 1840, 577, 1295, 163, 1496, 811, 1479, 986, 1175, 131, 1287, 550, 174, 985, 160, 70, 1343, 324, 1079]"
150,8,5948,5150,6580,0,3696,2252,"[309, 102, 410, 45, 660, 642, 261, 0, 712, 541, 253, 709, 125, 569, 128, 712, 745, 699, 604, 684, 116, 84, 644, 251, 350, 508, 572]"
151,8,6531,5078,8033,0,1052,5479,"[1555, 792, 347, 986, 314, 919, 323, 0, 491, 1710, 373, 1797, 1191, 363, 1824, 288, 20, 799, 1175, 1143, 890, 851, 218, 1569, 1660, 170, 355]"
152,8,6077,5069,9041,0,5153,924,"[214, 281, 146, 14, 164, 234, 47, 0, 121, 132, 224, 158, 276, 1, 7, 252, 172, 40, 150, 100, 198, 264, 87, 194, 236, 115, 50]"
153,8,6642,5539,10000,144,4821,1821,"[532, 312, 6, 238, 275, 554, 463, 0, 238, 49, 45, 600, 25, 278, 442, 183, 128, 535, 552, 178, 130, 488, 229, 359, 39, 28, 147]"
154,8,6473,6674,9799,0,202,6271,"[796, 732, 301, 1835, 1416, 1313, 1006, 0, 434, 1793, 205, 874, 2001, 603, 970, 1433, 1054, 35, 1400, 1496, 1860, 1852, 813, 865, 229, 604, 1910]"
155,8,5090,5836,9053,0,4803,287,"[44, 52, 55, 46, 92, 58, 25, 0, 30, 78, 1, 24, 73, 41, 40, 18, 31, 37, 72, 0, 51, 81, 19, 44, 28, 42, 53]"
156,8,5653,6464,8242,0,3444,2209,"[160, 552, 521, 571, 664, 410, 283, 0, 366, 180, 410, 166, 31, 520, 528, 177, 484, 504, 614, 100, 160, 130, 446, 586, 101, 258, 721]"
157,8,6683,6213,8712,0,5626,1057,"[161, 148, 109, 312, 85, 280, 196, 0, 83, 290, 218, 27, 154, 137, 4, 164, 308, 320, 335, 3, 177, 26, 94, 42, 313, 309, 108]"
158,8,6987,5896,9803,0,3508,3479,"[721, 217, 1061, 143, 689, 327, 1087, 0, 1100, 322, 83, 853, 502, 344, 115, 207, 765, 851, 130, 945, 710, 301, 724, 182, 250, 418, 1025]"
159,8,6416,6483,9736,0,1611,4805,"[752, 826, 1111, 1358, 337, 932, 906, 0, 1405, 555, 647, 1007, 157, 334, 620, 673, 1140, 235, 628, 468, 1127, 141, 295, 69, 1135, 1054, 103]"
160,8,5926,6787,8875,0,1215,4711,"[1100, 1262, 761, 1390, 714, 972, 381, 0, 454, 368, 1254, 846, 120, 1452, 1118, 1063, 719, 969, 730, 796, 1490, 641, 1054, 605, 1300, 1288, 761]"
161,8,6331,6929,8277,0,4293,2038,"[13, 464, 640, 617, 157, 456, 163, 0, 270, 243, 137, 533, 326, 427, 662, 449, 414, 582, 349, 425, 241, 642, 328, 106, 537, 121, 509]"
162,8,6777,6953,8101,0,3339,3438,"[403, 714, 179, 1028, 174, 734, 999, 0, 837, 110, 259, 479, 904, 541, 124, 734, 265, 206, 936, 986, 279, 674, 170, 90, 671, 1123, 505]"
163,8,5595,6910,6786,0,773,4822,"[1295, 679, 632, 1473, 14, 1036, 667, 0, 688, 217, 976, 1148, 595, 1406, 1213, 79, 326, 787, 734, 1598, 1572, 1038, 264, 399, 3, 969, 1341]"
164,8,5298,5608,6476,0,2517,2781,"[157, 245, 268, 729, 103, 814, 121, 0, 353, 907, 142, 494, 566, 267, 614, 193, 458, 806, 136, 215, 379, 768, 262, 457, 46, 435, 468]"
165,8,6371,6351,6496,0,5623,748,"[191, 155, 105, 157, 167, 29, 60, 0, 219, 216, 131, 91, 56, 15, 241, 240, 4, 66, 161, 194, 240, 168, 86, 96, 158, 159, 48]"
166,8,6988,5725,7759,0,3163,3825,"[755, 1275, 1095, 600, 268, 667, 873, 0, 1192, 1256, 1239, 10, 746, 1170, 1017, 1122, 254, 251, 853, 258, 428, 242, 591, 688, 1009, 295, 193]"
167,8,5808,5394,8173,0,280,5528,"[689, 842, 510, 658, 220, 336, 940, 0, 369, 679, 1642, 939, 141, 63, 1739, 1074, 1486, 488, 1278, 497, 1806, 705, 1354, 302, 976, 545, 903]"
168,8,5712,6066,7819,0,3270,2442,"[389, 54, 208, 17, 760, 740, 600, 0, 342, 733, 149, 263, 514, 364, 429, 256, 573, 378, 475, 263, 340, 694, 418, 376, 109, 576, 655]"
169,8,6076,7215,6680,0,38,6038,"[205, 2000, 10, 1256, 84, 338, 190, 0, 1636, 1426, 1859, 213, 1361, 1464, 641, 55, 1933, 33, 1651, 68, 240, 1384, 812, 1918, 1658, 811, 364]"
170,8,5151,7461,4370,0,2541,2610,"[850, 134, 423, 279, 743, 167, 158, 0, 585, 568, 732, 763, 655, 25, 702, 693, 301, 48, 13, 418, 713, 46, 807, 483, 204, 378, 76]"
171,8,6805,7240,3935,0,3395,3410,"[918, 481, 1091, 128, 173, 610, 562, 0, 73, 304, 883, 960, 45, 442, 381, 789, 346, 158, 78, 165, 22, 846, 433, 266, 273, 305, 178]"
172,8,5756,3864,5827,0,1327,4429,"[1244, 1101, 1035, 1002, 826, 584, 1048, 0, 105, 1147, 1380, 1354, 500, 1426, 516, 473, 1155, 800, 1012, 1055, 472, 257, 902, 1163, 1232, 774, 433]"
173,8,6442,6638,5631,0,313,6129,"[1704, 1999, 1176, 1546, 1981, 349, 1198, 0, 745, 52, 270, 905, 1742, 1517, 946, 0, 466, 1997, 982, 2011, 1411, 735, 1994, 1688, 735, 1702, 415]"
174,8,6053,5077,6607,0,4896,1157,"[20, 328, 210, 313, 217, 115, 338, 0, 271, 131, 56, 176, 131, 41, 108, 366, 304, 296, 259, 109, 385, 128, 228, 296, 136, 121, 354]"
175,8,5482,5714,6375,0,3785,1697,"[269, 551, 319, 489, 261, 33, 396, 0, 486, 0, 523, 31, 358, 463, 2, 77, 479, 435, 389, 371, 215, 193, 253, 268, 356, 453, 75]"
176,8,6488,5900,6963,0,4241,2247,"[56, 176, 325, 231, 615, 487, 744, 0, 162, 739, 491, 270, 536, 630, 308, 574, 543, 412, 423, 228, 732, 558, 325, 310, 85, 29, 460]"
177,8,6713,5760,7916,0,5084,1629,"[467, 415, 45, 357, 497, 333, 130, 0, 514, 45, 96, 384, 218, 107, 344, 364, 160, 288, 202, 244, 225, 330, 181, 437, 439, 272, 425]"
178,8,5171,7039,6048,0,4119,1052,"[92, 135, 13, 333, 15, 12, 339, 0, 32, 289, 30, 174, 216, 273, 31, 323, 192, 94, 281, 99, 232, 324, 86, 18, 240, 105, 190]"
179,8,5606,6312,5342,0,3574,2032,"[629, 327, 478, 150, 490, 607, 528, 0, 331, 33, 114, 665, 187, 270, 93, 297, 310, 645, 95, 225, 466, 398, 467, 393, 281, 469, 334]"
180,8,6544,6224,5662,0,2303,4241,"[116, 1170, 982, 701, 780, 292, 1047, 0, 310, 470, 685, 1057, 199, 1089, 690, 580, 215, 640, 441, 1409, 940, 521, 1390, 1168, 642, 1378, 626]"
181,8,5670,6103,5229,0,3938,1732,"[222, 181, 136, 191, 306, 9, 66, 0, 235, 557, 49, 43, 464, 354, 184, 454, 23, 404, 110, 241, 94, 140, 241, 495, 30, 573, 389]"
182,8,5771,1361,9639,0,3093,2678,"[103, 637, 333, 319, 22, 594, 148, 0, 36, 578, 235, 621, 174, 818, 598, 803, 372, 799, 880, 174, 293, 801, 300, 614, 784, 508, 32]"
183,8,5193,5924,8908,0,836,4357,"[423, 22, 1195, 151, 135, 890, 73, 0, 229, 322, 425, 1439, 119, 1165, 1328, 977, 1390, 920, 1298, 1102, 370, 1145, 647, 191, 190, 1027, 1179]"
184,8,5705,6340,8273,0,1511,4194,"[911, 75, 1071, 170, 435, 1004, 1130, 0, 1394, 8, 407, 554, 476, 35, 238, 61, 531, 1279, 1036, 1035, 50, 637, 827, 1127, 1349, 1155, 1250]"
185,8,6107,5015,9365,0,4900,1207,"[98, 215, 290, 144, 256, 210, 97, 0, 356, 184, 110, 28, 212, 296, 43, 362, 327, 393, 74, 84, 1, 92, 21, 15, 230, 7, 397]"
186,8,5129,6612,7882,0,999,4130,"[736, 712, 61, 733, 754, 620, 1241, 0, 762, 536, 661, 1107, 1354, 772, 695, 606, 663, 750, 1154, 512, 1166, 1061, 1349, 274, 190, 986, 563]"
187,8,6810,5908,8784,0,275,6535,"[1497, 1828, 468, 1045, 720, 2160, 1655, 0, 1719, 1767, 1699, 1589, 300, 271, 1270, 818, 745, 918, 1640, 1993, 1134, 533, 49, 538, 2170, 1157, 358]"
188,8,5072,7166,6690,0,4856,216,"[69, 64, 14, 71, 14, 3, 36, 0, 60, 35, 7, 8, 41, 23, 5, 3, 21, 12, 32, 46, 41, 62, 44, 61, 24, 19, 56]"
189,8,6432,7422,5700,0,966,5466,"[588, 732, 1584, 22, 1596, 1745, 782, 0, 58, 650, 1657, 799, 1536, 368, 525, 1442, 223, 1126, 1596, 1090, 1453, 799, 1244, 814, 991, 1817, 746]"
190,8,6058,7205,4553,0,147,5911,"[758, 1940, 345, 1776, 1122, 1419, 421, 0, 1489, 1630, 1241, 259, 1815, 1700, 1358, 112, 915, 1875, 1379, 317, 316, 15, 174, 1614, 1006, 1020, 1071]"
191,8,5123,459,9217,0,961,4162,"[653, 282, 708, 793, 55, 1293, 351, 0, 630, 817, 480, 502, 466, 393, 500, 1249, 31, 1196, 1251, 248, 154, 993, 182, 291, 1243, 603, 814]"
192,8,6397,5500,10000,114,624,5773,"[1581, 478, 685, 1215, 1646, 881, 795, 0, 1188, 991, 1903, 1757, 114, 1728, 679, 1292, 1086, 1415, 168, 1920, 1187, 546, 1280, 95, 42, 86, 1237]"
193,8,6792,7442,9350,0,4396,2396,"[373, 688, 373, 219, 581, 33, 501, 0, 217, 387, 256, 447, 575, 27, 564, 702, 504, 137, 255, 407, 41, 549, 32, 208, 669, 119, 135]"
194,8,6317,5775,9892,0,1097,5220,"[537, 273, 398, 248, 553, 751, 901, 0, 490, 1639, 302, 456, 1676, 297, 1650, 1316, 358, 777, 1463, 452, 1638, 632, 141, 1717, 1578, 1281, 300]"
195,8,6800,7106,9586,0,1028,5772,"[1446, 1722, 739, 200, 1719, 1207, 659, 0, 442, 1696, 856, 115, 416, 1418, 734, 1494, 1229, 1675, 1708, 646, 1398, 19, 951, 1315, 946, 584, 560]"
196,8,6073,6584,9075,0,4293,1780,"[305, 585, 143, 151, 269, 207, 91, 0, 132, 339, 293, 236, 149, 205, 468, 501, 312, 441, 33, 30, 366, 441, 432, 240, 15, 13, 452]"
197,8,5096,5789,8382,0,4370,726,"[113, 24, 170, 32, 185, 92, 164, 0, 222, 228, 91, 145, 20, 12, 39, 128, 130, 75, 107, 90, 154, 94, 123, 12, 143, 96, 192]"
198,8,6024,5851,8555,0,4208,1816,"[30, 525, 52, 275, 304, 127, 278, 0, 579, 486, 114, 356, 88, 28, 210, 95, 262, 115, 249, 207, 414, 511, 169, 442, 151, 540, 301]"
199,8,5966,6851,7670,0,5630,336,"[62, 85, 84, 32, 80, 59, 81, 0, 87, 100, 43, 111, 12, 97, 67, 36, 24, 62, 6, 45, 12, 7, 40, 100, 104, 15, 27]"
200,8,6692,5933,8429,0,2290,4402,"[1366, 1306, 1309, 324, 968, 546, 720, 0, 120, 749, 817, 1453, 1104, 933, 226, 727, 297, 1285, 1054, 1227, 1159, 1294, 729, 1186, 433, 642, 543]"
201,8,5650,6897,7182,0,4091,1559,"[59, 486, 65, 104, 64, 234, 467, 0, 425, 278, 54, 7, 377, 356, 336, 104, 351, 115, 165, 210, 365, 111, 215, 479, 241, 118, 158]"
202,8,6361,5390,8153,0,663,5698,"[816, 365, 14, 1118, 1270, 820, 1651, 0, 1283, 901, 138, 300, 1746, 1298, 1684, 217, 1058, 1319, 980, 702, 617, 490, 1455, 1066, 1537, 564, 1319]"
203,8,5672,5362,8463,0,2783,2889,"[390, 639, 882, 873, 46, 776, 632, 0, 288, 635, 610, 407, 19, 168, 728, 232, 579, 65, 774, 138, 398, 850, 175, 716, 23, 544, 465]"
204,8,6911,5569,9805,0,6306,605,"[13, 21, 68, 102, 138, 120, 14, 0, 86, 44, 78, 101, 13, 40, 122, 47, 167, 101, 175, 134, 8, 195, 107, 136, 193, 168, 115]"
205,8,6953,5282,10000,1476,5261,1692,"[228, 553, 256, 68, 225, 224, 233, 0, 264, 29, 557, 217, 129, 250, 41, 508, 40, 96, 495, 249, 518, 357, 378, 199, 530, 510, 198]"
206,8,5628,6667,8961,0,1149,4479,"[1486, 653, 965, 1004, 144, 896, 1010, 0, 256, 898, 188, 724, 725, 859, 1266, 1409, 894, 170, 1380, 1172, 51, 802, 1003, 724, 619, 1456, 156]"
207,8,6922,5616,10000,267,3700,3222,"[993, 555, 607, 632, 564, 896, 937, 0, 984, 367, 989, 753, 192, 1070, 678, 686, 113, 891, 767, 849, 931, 185, 733, 764, 819, 374, 416]"
208,8,6354,7236,9118,0,1256,5098,"[828, 158, 1085, 1541, 1474, 322, 1120, 0, 1307, 1083, 891, 1569, 796, 1023, 699, 1314, 1476, 662, 592, 345, 1237, 948, 1009, 49, 299, 1230, 331]"
209,8,5902,6457,8563,0,344,5558,"[39, 928, 442, 542, 353, 1731, 495, 0, 820, 745, 432, 1763, 246, 585, 1062, 251, 606, 1069, 1584, 611, 294, 920, 584, 445, 1847, 456, 798]"
210,8,6124,7321,7366,0,3983,2141,"[216, 67, 154, 439, 554, 586, 481, 0, 360, 578, 118, 440, 260, 115, 551, 6, 80, 611, 266, 574, 561, 253, 390, 573, 565, 319, 50]"
211,8,6354,5685,8035,0,6322,32,"[4, 3, 5, 2, 10, 7, 0, 0, 9, 4, 10, 0, 8, 8, 10, 10, 4, 5, 0, 7, 8, 8, 7, 2, 0, 8, 1]"
212,8,6652,6888,7799,0,2756,3896,"[670, 116, 924, 106, 1285, 343, 968, 0, 1179, 173, 918, 303, 639, 404, 837, 125, 637, 860, 956, 554, 568, 988, 689, 102, 831, 1166, 498]"
213,8,5805,6482,7122,0,5224,581,"[181, 75, 104, 63, 168, 114, 54, 0, 34, 116, 79, 180, 23, 7, 127, 192, 3, 167, 5, 4, 144, 35, 89, 87, 58, 1, 172]"
214,8,6365,7154,6333,0,2991,3374,"[905, 531, 252, 220, 547, 291, 653, 0, 972, 241, 554, 528, 744, 278, 429, 650, 510, 909, 995, 549, 1120, 598, 513, 975, 116, 404, 228]"
215,8,6590,7040,5883,0,1093,5497,"[1015, 1070, 1232, 165, 749, 337, 829, 0, 170, 420, 280, 1820, 99, 452, 687, 1151, 91, 1047, 1476, 459, 524, 391, 296, 561, 471, 1388, 926]"
216,8,5449,5083,6249,0,4521,928,"[301, 23, 112, 68, 95, 92, 217, 0, 164, 279, 21, 223, 224, 252, 38, 258, 110, 134, 89, 176, 20, 134, 100, 304, 83, 196, 116]"
217,8,5366,7315,4300,0,3030,2336,"[767, 718, 353, 409, 391, 284, 513, 0, 635, 57, 511, 372, 634, 1, 395, 272, 215, 382, 481, 51, 278, 192, 625, 319, 582, 222, 58]"
218,8,5040,1316,8024,0,1952,3088,"[107, 620, 345, 864, 29, 413, 727, 0, 902, 453, 369, 931, 144, 793, 116, 754, 353, 54, 533, 13, 39, 37, 412, 682, 145, 154, 652]"
219,8,6474,7188,7310,0,2234,4240,"[91, 598, 466, 181, 404, 1330, 580, 0, 457, 90, 748, 1306, 542, 188, 720, 947, 154, 836, 123, 711, 390, 840, 1242, 476, 1264, 669, 1030]"
220,8,6174,6818,6666,0,238,5936,"[1438, 123, 408, 88, 520, 972, 1891, 0, 1035, 533, 1692, 1097, 423, 131, 188, 1206, 964, 532, 860, 298, 126, 1477, 1747, 1857, 101, 939, 1327]"
221,8,5782,5472,6976,0,4847,935,"[258, 52, 249, 33, 306, 207, 112, 0, 9, 288, 261, 292, 100, 155, 11, 10, 67, 233, 168, 161, 176, 70, 165, 218, 52, 265, 206]"
222,8,5842,7446,5372,0,5637,205,"[19, 56, 20, 58, 23, 57, 50, 0, 60, 28, 33, 10, 15, 16, 48, 51, 3, 5, 53, 30, 0, 30, 67, 25, 39, 37, 57]"
223,8,6546,6102,5816,0,5098,1448,"[434, 452, 464, 383, 270, 93, 360, 0, 15, 258, 146, 303, 26, 296, 369, 128, 382, 200, 37, 284, 229, 270, 140, 24, 189, 391, 98]"
224,8,5238,6974,4080,0,3888,1350,"[444, 210, 323, 31, 377, 107, 286, 0, 147, 93, 372, 365, 180, 39, 214, 12, 55, 9, 87, 383, 365, 35, 434, 227, 303, 304, 323]"
225,8,5105,3339,5846,0,763,4342,"[736, 1081, 355, 57, 809, 79, 754, 0, 884, 1442, 782, 510, 689, 922, 1232, 874, 1093, 515, 87, 506, 1158, 636, 659, 537, 254, 1180, 250]"
226,8,5626,6236,5236,0,16,5610,"[1258, 738, 1726, 272, 727, 1647, 580, 0, 1586, 783, 1482, 1426, 155, 1546, 1346, 865, 74, 1177, 310, 610, 1515, 1469, 708, 1189, 768, 1103, 1092]"
227,8,6160,5727,5669,0,1205,4955,"[1305, 1193, 356, 1503, 1242, 317, 846, 0, 1521, 553, 1162, 1426, 1449, 1273, 519, 472, 1083, 534, 756, 828, 876, 1460, 1206, 806, 906, 492, 1152]"
228,8,6276,7063,4882,0,3135,3141,"[805, 662, 886, 204, 918, 1004, 767, 0, 514, 374, 45, 862, 321, 706, 609, 783, 690, 614, 217, 828, 395, 438, 647, 524, 27, 782, 583]"
229,8,5612,744,9750,0,1393,4219,"[672, 574, 603, 532, 704, 37, 381, 0, 437, 1062, 421, 812, 661, 1282, 250, 601, 541, 670, 1159, 77, 406, 54, 569, 1050, 910, 989, 757]"
230,8,6499,6859,9390,0,6104,395,"[130, 23, 37, 8, 116, 41, 50, 0, 123, 10, 131, 54, 68, 107, 123, 30, 122, 13, 44, 86, 103, 81, 34, 100, 90, 127, 31]"
231,8,6158,5674,9874,0,459,5699,"[713, 1463, 212, 971, 1127, 155, 390, 0, 643, 1072, 615, 603, 1639, 414, 1573, 1363, 1293, 622, 323, 831, 1643, 496, 1884, 942, 832, 1758, 531]"
232,8,5157,5337,9694,0,3516,1641,"[250, 507, 18, 50, 135, 328, 295, 0, 40, 254, 364, 545, 528, 529, 441, 124, 64, 77, 131, 507, 392, 416, 261, 396, 21, 376, 167]"
233,8,5365,7065,7994,0,1888,3477,"[947, 314, 1141, 1051, 402, 1045, 487, 0, 841, 19, 249, 621, 78, 113, 1089, 220, 287, 251, 116, 629, 1057, 209, 1037, 302, 666, 967, 812]"
234,8,6223,5696,8521,0,3823,2400,"[494, 568, 424, 135, 421, 23, 205, 0, 118, 3, 222, 420, 462, 761, 569, 193, 329, 35, 500, 599, 758, 544, 409, 385, 798, 381, 679]"
235,8,6692,5766,9447,0,5872,820,"[136, 221, 42, 235, 53, 24, 227, 0, 108, 113, 200, 38, 229, 74, 221, 160, 72, 28, 39, 126, 212, 221, 254, 211, 222, 10, 252]"
236,8,5841,6072,9216,0,4388,1453,"[466, 98, 334, 474, 458, 302, 22, 0, 100, 357, 198, 117, 192, 205, 64, 252, 399, 102, 270, 0, 53, 128, 418, 272, 19, 82, 241]"
237,8,5547,6326,8437,0,2267,3280,"[963, 1049, 305, 258, 1072, 957, 498, 0, 1033, 862, 811, 449, 357, 439, 907, 375, 320, 267, 775, 77, 64, 1033, 23, 912, 447, 285, 726]"
238,8,5601,6204,7834,0,1874,3727,"[337, 571, 1033, 409, 1084, 1228, 1182, 0, 343, 358, 504, 473, 633, 600, 450, 455, 1135, 550, 92, 231, 879, 903, 592, 904, 617, 944, 254]"
239,8,5199,7426,5607,0,1693,3506,"[228, 320, 744, 370, 501, 967, 100, 0, 137, 802, 314, 3, 512, 510, 1064, 669, 1062, 226, 720, 70, 680, 973, 1070, 920, 917, 826, 542]"
240,8,5093,1370,9330,0,4020,1073,"[227, 148, 163, 233, 245, 324, 263, 0, 112, 311, 140, 173, 72, 282, 328, 196, 46, 47, 181, 249, 173, 202, 229, 274, 193, 196, 134]"
241,8,6667,5780,10000,217,1417,5250,"[1680, 326, 345, 1104, 1601, 848, 1314, 0, 530, 1376, 528, 524, 1421, 62, 876, 1404, 230, 1319, 1184, 1390, 805, 1518, 44, 415, 690, 910, 668]"
242,8,6190,5689,10000,501,5938,252,"[54, 82, 41, 49, 76, 58, 68, 0, 2, 81, 74, 61, 39, 6, 55, 60, 36, 33, 81, 73, 79, 75, 66, 84, 41, 53, 66]"
243,8,5039,5834,9205,0,684,4355,"[614, 1431, 715, 671, 982, 385, 16, 0, 1162, 345, 830, 818, 1404, 71, 981, 225, 361, 1222, 1019, 733, 995, 1435, 512, 46, 627, 408, 287]"
244,8,6008,6352,8861,0,3137,2871,"[625, 351, 370, 73, 358, 616, 290, 0, 362, 2, 159, 870, 314, 11, 300, 21, 484, 941, 265, 410, 940, 539, 17, 700, 315, 451, 903]"
245,8,6334,6637,8558,0,415,5919,"[1668, 271, 428, 1450, 1851, 442, 574, 0, 189, 560, 1722, 1833, 869, 1656, 1699, 1073, 580, 1072, 1268, 284, 1018, 1048, 1499, 1679, 1631, 1407, 686]"
246,8,5792,7041,7309,0,1253,4539,"[1067, 1041, 145, 206, 867, 817, 1354, 0, 376, 904, 184, 555, 414, 1299, 831, 235, 571, 1242, 476, 1031, 1376, 869, 321, 559, 358, 1211, 263]"
247,8,5336,5707,6938,0,1000,4336,"[493, 996, 660, 643, 994, 1334, 1369, 0, 1336, 1020, 869, 305, 287, 410, 766, 986, 1020, 266, 220, 1341, 772, 320, 23, 584, 1233, 10, 761]"
248,8,5451,6655,5734,0,3106,2345,"[28, 397, 39, 155, 546, 720, 445, 0, 36, 770, 415, 343, 705, 556, 461, 310, 664, 401, 243, 347, 267, 88, 171, 308, 570, 701, 627]"
249,8,5046,569,10000,211,1289,3757,"[251, 428, 1082, 197, 448, 11, 703, 0, 745, 654, 906, 416, 574, 182, 582, 1105, 859, 1049, 211, 187, 912, 1195, 1039, 711, 979, 1215, 837]"
250,8,5769,7014,8755,0,5426,343,"[22, 26, 63, 72, 112, 99, 53, 0, 1, 41, 79, 106, 79, 81, 18, 1, 72, 30, 70, 89, 73, 74, 30, 14, 23, 46, 15]"
251,8,5322,5832,8245,0,1466,3856,"[904, 876, 635, 808, 264, 380, 755, 0, 631, 928, 1182, 1130, 274, 707, 1145, 1065, 489, 492, 1151, 1137, 45, 757, 656, 651, 196, 738, 177]"
252,8,6396,6789,7852,0,5271,1125,"[276, 235, 286, 195, 57, 285, 130, 0, 66, 176, 217, 256, 2, 169, 313, 177, 325, 189, 251, 69, 266, 281, 212, 46, 161, 120, 204]"
253,8,6032,6831,7053,0,860,5172,"[77, 783, 200, 1023, 1697, 196, 807, 0, 1096, 142, 866, 214, 591, 1685, 733, 451, 313, 187, 108, 1415, 178, 1424, 1028, 498, 83, 1405, 947]"
254,8,6203,7039,6217,0,5837,366,"[31, 104, 7, 8, 35, 12, 28, 0, 60, 106, 56, 32, 53, 3, 91, 93, 61, 91, 42, 3, 39, 45, 61, 29, 118, 100, 50]"
255,8,6034,5812,6439,0,1571,4463,"[492, 1041, 645, 1180, 951, 221, 1388, 0, 877, 188, 1412, 1377, 867, 435, 899, 88, 1064, 554, 222, 1092, 63, 32, 984, 398, 1054, 1204, 435]"
256,8,6600,5993,7046,0,4479,2121,"[114, 231, 661, 569, 684, 52, 526, 0, 310, 460, 643, 223, 129, 351, 60, 562, 163, 85, 105, 373, 436, 373, 459, 234, 382, 262, 233]"
257,8,6120,5781,7385,0,449,5671,"[1528, 555, 437, 659, 339, 532, 681, 0, 82, 529, 1740, 48, 1515, 463, 1818, 870, 1422, 1188, 920, 558, 215, 1843, 998, 1798, 1644, 806, 1134]"
258,8,6447,5569,8263,0,3053,3394,"[1069, 87, 842, 82, 566, 581, 885, 0, 436, 1096, 50, 636, 323, 602, 23, 1031, 737, 273, 1105, 573, 470, 916, 1079, 674, 403, 1115, 1067]"
259,8,5366,5789,7840,0,3200,2166,"[343, 202, 339, 283, 259, 626, 82, 0, 249, 272, 617, 226, 141, 254, 528, 579, 29, 201, 528, 217, 197, 715, 19, 208, 444, 616, 677]"
260,8,5314,5465,7689,0,3755,1559,"[451, 425, 152, 83, 398, 112, 440, 0, 168, 379, 188, 234, 196, 51, 127, 357, 188, 388, 230, 107, 258, 498, 371, 205, 295, 332, 247]"
261,8,6061,5395,8355,0,4215,1846,"[35, 445, 106, 596, 417, 505, 162, 0, 374, 169, 414, 412, 143, 274, 253, 497, 482, 236, 35, 19, 475, 567, 57, 57, 154, 588, 153]"
262,8,6157,5267,9245,0,2003,4154,"[575, 837, 1055, 760, 183, 1087, 1061, 0, 683, 543, 466, 995, 1335, 381, 235, 1320, 1338, 973, 907, 246, 705, 978, 1154, 764, 92, 406, 435]"
263,8,5825,7340,7730,0,1700,4125,"[797, 421, 365, 1197, 128, 1307, 211, 0, 1254, 1274, 90, 901, 1344, 1359, 583, 602, 1127, 1289, 1070, 1354, 312, 910, 904, 1005, 270, 84, 183]"
264,8,5101,5761,7070,0,305,4796,"[882, 271, 1593, 901, 986, 279, 1067, 0, 672, 850, 1061, 764, 1318, 916, 1378, 673, 216, 706, 1384, 597, 1584, 1458, 581, 1533, 1265, 56, 1455]"
265,8,5733,7022,5781,0,687,5046,"[1344, 84, 643, 1163, 1397, 215, 1576, 0, 1668, 815, 1656, 706, 469, 531, 1557, 1523, 179, 170, 853, 1067, 830, 279, 1240, 864, 41, 1339, 151]"
266,8,6682,5287,7176,0,1349,5333,"[654, 1482, 636, 1693, 1259, 246, 248, 0, 315, 1285, 1024, 1142, 898, 959, 480, 516, 1145, 1010, 1436, 941, 1063, 1206, 983, 1067, 100, 1293, 497]"
267,8,5886,6686,6376,0,897,4989,"[294, 1000, 184, 1530, 340, 182, 430, 0, 353, 101, 817, 718, 1296, 597, 237, 1533, 1588, 599, 673, 1580, 764, 1073, 1632, 1205, 1369, 1090, 1014]"
268,8,5489,6092,5773,0,2867,2622,"[77, 251, 744, 603, 543, 117, 249, 0, 141, 563, 767, 680, 490, 563, 624, 463, 837, 560, 863, 845, 777, 867, 722, 221, 159, 402, 185]"
269,8,6913,7116,5570,0,6053,860,"[71, 83, 175, 68, 225, 225, 138, 0, 202, 52, 249, 51, 274, 95, 285, 79, 216, 189, 215, 114, 278, 79, 114, 277, 85, 46, 25]"
270,8,6195,7018,4747,0,3214,2981,"[537, 54, 480, 515, 34, 17, 753, 0, 486, 576, 936, 241, 754, 350, 170, 839, 500, 987, 837, 754, 297, 569, 984, 244, 891, 648, 939]"
271,8,6708,5264,6191,0,2763,3945,"[371, 821, 866, 377, 642, 1050, 223, 0, 416, 786, 48, 509, 655, 253, 910, 506, 709, 833, 1254, 514, 1103, 7, 1011, 964, 388, 1305, 355]"
272,8,6446,6236,6401,0,4889,1557,"[10, 144, 392, 32, 71, 354, 278, 0, 513, 162, 509, 352, 246, 189, 301, 294, 361, 204, 300, 241, 333, 225, 158, 334, 209, 491, 315]"
273,8,5515,5223,6693,0,3086,2429,"[137, 429, 199, 222, 632, 592, 463, 0, 491, 233, 768, 277, 296, 503, 620, 265, 437, 385, 697, 404, 786, 319, 233, 626, 19, 26, 738]"
274,8,5157,6602,5248,0,4075,1082,"[261, 312, 244, 303, 183, 223, 109, 0, 131, 145, 236, 60, 25, 355, 82, 35, 208, 193, 277, 32, 187, 275, 172, 83, 207, 120, 154]"
275,8,5025,966,9307,0,3824,1201,"[32, 220, 197, 20, 356, 134, 294, 0, 114, 376, 282, 198, 246, 368, 360, 158, 344, 140, 81, 360, 274, 199, 321, 335, 232, 53, 4]"
276,8,6436,5433,10000,310,2329,4107,"[10, 563, 1289, 529, 780, 608, 1055, 0, 390, 1179, 163, 1062, 853, 829, 986, 1011, 442, 463, 166, 1260, 309, 1184, 593, 678, 894, 487, 722]"
277,8,5132,5448,9684,0,3972,1160,"[160, 231, 38, 190, 338, 262, 309, 0, 246, 333, 213, 290, 309, 366, 342, 358, 373, 239, 114, 360, 100, 185, 359, 248, 381, 98, 214]"
278,8,5917,5643,9958,0,3437,2480,"[451, 665, 47, 314, 507, 16, 541, 0, 73, 756, 490, 26, 426, 360, 555, 80, 352, 826, 259, 359, 466, 563, 340, 663, 346, 613, 61]"
279,8,6584,7158,9384,0,4348,2236,"[519, 28, 279, 332, 700, 349, 250, 0, 567, 184, 286, 516, 343, 414, 586, 335, 652, 678, 131, 193, 467, 736, 603, 588, 130, 535, 470]"
280,8,6728,5133,10000,979,2558,4170,"[407, 785, 55, 73, 1066, 291, 1233, 0, 165, 556, 29, 544, 351, 245, 1386, 341, 1262, 1161, 287, 1309, 28, 936, 745, 1085, 643, 1359, 1344]"
281,8,5054,7024,8030,0,1683,3371,"[77, 1022, 341, 1013, 336, 304, 458, 0, 170, 714, 428, 907, 709, 631, 293, 997, 149, 855, 742, 815, 727, 212, 595, 56, 801, 378, 16]"
282,8,5748,5734,8044,0,1952,3796,"[1109, 171, 328, 298, 644, 20, 662, 0, 1217, 1053, 1248, 79, 1090, 193, 655, 26, 1199, 65, 542, 1206, 1085, 647, 91, 945, 596, 1083, 429]"
283,8,6907,5341,9610,0,223,6684,"[190, 1810, 2145, 1629, 583, 1915, 744, 0, 1199, 2119, 1014, 675, 480, 1922, 446, 528, 1751, 2052, 1143, 477, 1872, 2111, 424, 1188, 1650, 1421, 1454]"
284,8,6348,6624,9334,0,4405,1943,"[496, 266, 387, 420, 98, 392, 565, 0, 195, 493, 637, 40, 372, 353, 291, 56, 52, 556, 188, 450, 429, 306, 644, 298, 22, 466, 356]"
285,8,5698,6690,8342,0,379,5319,"[111, 169, 1119, 805, 376, 1298, 1254, 0, 716, 752, 1648, 222, 350, 1660, 112, 1192, 1606, 1424, 1464, 16, 1712, 884, 116, 103, 1298, 55, 1090]"
286,8,6084,5791,8635,0,2052,4032,"[1287, 1123, 802, 1328, 39, 374, 353, 0, 553, 557, 1005, 303, 300, 698, 425, 1039, 1241, 285, 266, 764, 504, 406, 1073, 726, 1312, 152, 463]"
287,8,6471,5029,10000,77,148,6323,"[1833, 1733, 531, 1315, 1223, 158, 1170, 0, 1222, 767, 183, 408, 1826, 1494, 115, 348, 411, 587, 1788, 571, 1153, 446, 1434, 676, 1852, 810, 1498]"
288,8,6762,6571,10000,191,3927,2835,"[936, 178, 528, 577, 652, 844, 515, 0, 501, 519, 374, 451, 416, 346, 385, 569, 421, 585, 591, 696, 384, 666, 586, 225, 553, 585, 471]"
289,8,5834,5323,10000,511,3628,2206,"[83, 487, 185, 519, 656, 456, 407, 0, 203, 242, 320, 674, 289, 534, 240, 270, 663, 595, 298, 245, 416, 464, 174, 497, 285, 341, 223]"
290,8,6719,6249,10000,470,562,6157,"[1834, 874, 900, 1903, 1075, 1766, 1742, 0, 1626, 451, 705, 602, 1378, 969, 729, 1593, 986, 1140, 2050, 1316, 204, 513, 1466, 678, 1942, 1812, 330]"
291,8,5511,6124,9387,0,2468,3043,"[612, 116, 303, 972, 13, 918, 471, 0, 259, 786, 830, 942, 893, 311, 184, 35, 309, 333, 161, 915, 461, 871, 267, 746, 781, 746, 45]"
292,8,6359,6213,9533,0,1691,4668,"[797, 1221, 519, 3, 189, 932, 625, 0, 217, 615, 415, 444, 1013, 1315, 1378, 347, 1054, 906, 66, 309, 1265, 761, 1172, 5, 293, 1031, 103]"
293,8,6119,5830,9822,0,4477,1642,"[328, 300, 115, 336, 512, 109, 508, 0, 89, 194, 191, 428, 243, 167, 452, 91, 264, 368, 168, 198, 306, 119, 47, 85, 249, 22, 297]"
294,8,5854,5864,9812,0,2834,3020,"[922, 72, 153, 493, 12, 64, 604, 0, 185, 472, 957, 4, 746, 818, 396, 734, 634, 773, 649, 640, 288, 304, 701, 160, 238, 101, 159]"
295,8,6037,6801,9048,0,843,5194,"[1419, 1038, 107, 996, 424, 1478, 669, 0, 1569, 824, 634, 998, 1505, 295, 697, 79, 559, 1009, 1226, 300, 1593, 430, 722, 713, 1261, 84, 773]"
296,8,6834,7145,8737,0,5290,1544,"[96, 453, 240, 332, 26, 209, 278, 0, 155, 233, 414, 111, 426, 154, 501, 161, 339, 75, 25, 299, 25, 156, 256, 413, 330, 389, 371]"
297,8,6981,7461,8257,0,3952,3029,"[935, 611, 82, 373, 663, 389, 780, 0, 712, 66, 736, 874, 363, 565, 669, 335, 771, 398, 142, 404, 941, 345, 977, 1005, 570, 348, 937]"
298,8,5788,6459,7586,0,3010,2778,"[209, 727, 369, 783, 869, 808, 377, 0, 432, 530, 235, 376, 220, 698, 818, 912, 663, 152, 73, 483, 631, 129, 193, 308, 308, 511, 55]"
299,8,5001,6631,5956,0,18,4983,"[109, 635, 1591, 1360, 354, 146, 283, 0, 223, 180, 475, 6, 1283, 789, 426, 294, 1497, 1243, 996, 732, 1639, 424, 621, 902, 739, 993, 1079]"
0,9,6020,0,6020,0,1851,4169,"[129, 1210, 512, 508, 121, 836, 601, 0, 1293, 644, 1349, 494, 451, 541, 906, 526, 959, 1388, 121, 422, 1162, 813, 522, 106, 1181, 53, 1069]"
1,9,6870,6822,6068,0,6230,640,"[17, 57, 117, 153, 135, 188, 33, 0, 110, 46, 126, 74, 72, 22, 9, 209, 43, 194, 45, 38, 43, 119, 153, 55, 29, 204, 201]"
2,9,5998,6573,5493,0,2960,3038,"[333, 217, 88, 845, 115, 943, 788, 0, 735, 559, 269, 296, 41, 586, 688, 154, 482, 782, 552, 360, 369, 831, 807, 733, 59, 230, 280]"
3,9,5988,6959,4522,0,900,5088,"[110, 899, 1667, 267, 1483, 632, 262, 0, 23, 621, 883, 1355, 1379, 700, 1215, 90, 605, 91, 322, 42, 1104, 50, 167, 1011, 1572, 311, 3]"
4,9,6475,5366,5631,0,2565,3910,"[882, 295, 451, 52, 480, 1295, 237, 0, 887, 760, 59, 1301, 331, 954, 703, 318, 811, 143, 1255, 3, 964, 1243, 1199, 571, 449, 245, 278]"
5,9,5461,5152,5940,0,4387,1074,"[209, 99, 300, 116, 31, 287, 311, 0, 268, 67, 184, 303, 224, 0, 260, 122, 74, 231, 65, 263, 103, 45, 179, 43, 104, 8, 165]"
6,9,5228,7302,3866,0,1779,3449,"[974, 102, 1051, 1145, 38, 483, 261, 0, 78, 392, 51, 770, 414, 484, 1122, 721, 586, 16, 649, 289, 713, 947, 1107, 1013, 950, 235, 1061]"
7,9,6706,2367,8205,0,3482,3224,"[688, 384, 48, 540, 482, 491, 699, 0, 458, 41, 188, 152, 309, 799, 556, 414, 692, 333, 560, 766, 796, 1042, 740, 806, 8, 195, 374]"
8,9,5699,5303,8601,0,5506,193,"[5, 37, 54, 38, 22, 46, 0, 0, 47, 0, 41, 55, 34, 31, 57, 2, 61, 19, 56, 48, 13, 10, 57, 36, 6, 38, 41]"
9,9,6019,6611,8009,0,5226,793,"[73, 252, 38, 82, 134, 146, 93, 0, 123, 237, 239, 32, 180, 124, 123, 157, 160, 202, 157, 193, 47, 169, 66, 76, 61, 213, 218]"
10,9,5687,5105,8591,0,749,4938,"[260, 210, 277, 297, 1041, 746, 543, 0, 1585, 1284, 110, 415, 1312, 788, 1145, 1402, 611, 1519, 1237, 1266, 406, 1042, 1445, 1054, 1253, 1326, 1363]"
11,9,5698,5189,9100,0,1543,4155,"[923, 1363, 270, 1377, 229, 589, 365, 0, 480, 780, 1306, 777, 144, 273, 116, 734, 284, 1333, 209, 250, 1089, 563, 649, 248, 984, 1350, 881]"
12,9,5731,7184,7647,0,634,5097,"[1675, 761, 1455, 120, 160, 173, 1553, 0, 111, 1362, 936, 186, 815, 702, 1026, 1690, 1491, 1204, 797, 518, 347, 487, 923, 1144, 269, 696, 1476]"
13,9,5025,6076,6596,0,4278,747,"[113, 172, 104, 186, 41, 214, 220, 0, 84, 100, 116, 140, 108, 181, 199, 229, 62, 35, 203, 49, 82, 65, 3, 81, 77, 196, 78]"
14,9,5072,6679,4989,0,562,4510,"[172, 873, 183, 1170, 474, 403, 1321, 0, 727, 820, 118, 526, 720, 1157, 1238, 1339, 709, 823, 1130, 214, 248, 588, 898, 1386, 1485, 1134, 59]"
15,9,5032,624,9397,0,2533,2499,"[292, 418, 170, 129, 574, 546, 736, 0, 561, 42, 425, 563, 23, 380, 427, 251, 255, 564, 416, 458, 222, 160, 668, 260, 329, 27, 537]"
16,9,5443,6716,8124,0,4446,997,"[99, 282, 169, 63, 120, 79, 24, 0, 76, 310, 36, 286, 96, 100, 103, 170, 163, 226, 283, 140, 283, 84, 267, 41, 100, 37, 200]"
17,9,6094,5517,8701,0,2116,3978,"[495, 965, 1036, 418, 976, 820, 685, 0, 656, 956, 226, 170, 948, 620, 332, 1170, 841, 104, 1319, 233, 1244, 1098, 191, 846, 1130, 590, 207]"
18,9,5167,5848,8020,0,4451,716,"[207, 211, 31, 182, 16, 55, 166, 0, 60, 224, 63, 182, 33, 146, 54, 123, 119, 189, 34, 211, 207, 85, 3, 81, 21, 44, 191]"
19,9,6402,5248,9174,0,678,5724,"[1404, 1528, 507, 1135, 394, 687, 764, 0, 75, 302, 1760, 85, 908, 344, 606, 404, 379, 834, 1529, 868, 534, 835, 171, 1246, 886, 45, 578]"
20,9,6565,5067,10000,672,13,6552,"[2099, 130, 1559, 1160, 1848, 1074, 826, 0, 69, 1356, 2010, 1648, 1885, 2134, 77, 289, 2043, 1312, 2098, 639, 63, 1721, 2121, 643, 1816, 711, 2156]"
21,9,5881,6514,9367,0,3869,2012,"[76, 360, 639, 614, 149, 439, 280, 0, 79, 135, 413, 114, 315, 519, 184, 394, 353, 201, 42, 396, 111, 46, 228, 456, 310, 169, 367]"
22,9,6875,6805,9437,0,1607,5268,"[1030, 1437, 1567, 892, 928, 514, 812, 0, 1116, 163, 160, 797, 1182, 220, 865, 192, 857, 1502, 691, 1675, 1607, 1584, 1598, 752, 428, 1266, 251]"
23,9,5448,5886,8999,0,4264,1184,"[83, 390, 206, 113, 17, 342, 8, 0, 340, 297, 143, 113, 317, 122, 24, 288, 103, 345, 127, 224, 130, 326, 125, 195, 150, 135, 201]"
24,9,5354,7280,7073,0,3401,1953,"[559, 251, 570, 1, 21, 401, 650, 0, 139, 599, 425, 268, 650, 19, 115, 457, 131, 555, 253, 280, 103, 434, 367, 516, 367, 313, 449]"
25,9,5132,6626,5579,0,2109,3023,"[833, 537, 285, 41, 561, 161, 360, 0, 401, 192, 859, 161, 424, 373, 133, 300, 79, 737, 997, 891, 322, 241, 135, 95, 145, 912, 139]"
26,9,6441,5129,6891,0,3276,3165,"[338, 525, 844, 292, 198, 2, 298, 0, 44, 278, 634, 455, 479, 231, 957, 302, 49, 158, 1018, 976, 737, 648, 916, 99, 353, 665, 538]"
27,9,5896,5900,6887,0,4744,1152,"[287, 172, 44, 360, 208, 8, 215, 0, 50, 195, 339, 156, 209, 229, 150, 57, 132, 280, 291, 169, 210, 177, 292, 29, 139, 130, 269]"
28,9,5835,5638,7084,0,3541,2294,"[438, 738, 664, 425, 717, 72, 499, 0, 223, 709, 203, 641, 694, 625, 63, 367, 406, 238, 495, 255, 578, 227, 411, 519, 368, 279, 477]"
29,9,5146,6896,5334,0,1564,3582,"[715, 592, 15, 506, 371, 950, 1011, 0, 652, 639, 638, 473, 52, 1009, 42, 297, 142, 954, 698, 239, 327, 885, 365, 1177, 321, 738, 877]"
30,9,6501,5336,6499,0,581,5920,"[494, 1013, 1584, 1394, 1639, 859, 297, 0, 1793, 1665, 1423, 718, 99, 736, 1874, 1586, 1415, 1455, 931, 555, 429, 678, 498, 1001, 1015, 1341, 1330]"
31,9,6803,6987,6315,0,1617,5186,"[690, 745, 1431, 1593, 348, 620, 1139, 0, 949, 417, 364, 943, 1310, 1049, 1494, 667, 429, 1263, 221, 1442, 282, 1095, 1381, 845, 785, 659, 1233]"
32,9,5211,6387,5139,0,4570,641,"[105, 205, 19, 67, 161, 43, 129, 0, 46, 46, 57, 124, 52, 19, 32, 152, 150, 7, 42, 129, 202, 208, 49, 180, 44, 177, 192]"
33,9,6838,5399,6578,0,4089,2749,"[737, 565, 348, 622, 728, 38, 88, 0, 305, 66, 497, 436, 854, 478, 464, 613, 654, 542, 871, 92, 414, 621, 664, 458, 291, 656, 694]"
34,9,6479,7186,5871,0,6175,304,"[72, 81, 50, 87, 99, 3, 58, 0, 63, 16, 57, 96, 91, 27, 4, 95, 76, 37, 22, 96, 37, 99, 80, 42, 6, 26, 76]"
35,9,5019,1715,9175,0,2994,2025,"[348, 342, 290, 265, 298, 491, 170, 0, 83, 13, 438, 219, 522, 163, 258, 505, 160, 475, 418, 622, 227, 582, 148, 462, 313, 436, 158]"
36,9,6605,7117,8663,0,1176,5429,"[222, 145, 1554, 1067, 1173, 1160, 733, 0, 771, 308, 724, 969, 1092, 542, 1755, 478, 701, 243, 698, 702, 957, 691, 1176, 730, 143, 500, 657]"
37,9,6007,6097,8573,0,1029,4978,"[1273, 1234, 463, 1321, 1458, 157, 900, 0, 1222, 663, 1216, 685, 71, 703, 688, 838, 1235, 794, 652, 993, 795, 799, 945, 1305, 152, 722, 50]"
38,9,5697,5439,8831,0,3709,1988,"[219, 36, 255, 490, 187, 38, 477, 0, 375, 369, 463, 607, 241, 81, 170, 192, 529, 45, 472, 295, 275, 485, 467, 37, 318, 142, 255]"
39,9,6323,6883,8271,0,2307,4016,"[644, 409, 1147, 495, 245, 402, 709, 0, 502, 851, 583, 833, 924, 573, 969, 653, 1161, 825, 368, 339, 1103, 400, 416, 1186, 390, 771, 37]"
40,9,6450,7461,7260,0,4665,1785,"[86, 20, 477, 428, 385, 169, 492, 0, 568, 225, 92, 301, 157, 307, 246, 425, 453, 362, 331, 541, 485, 349, 252, 256, 462, 290, 262]"
41,9,5420,7306,5374,0,229,5191,"[113, 1135, 721, 1257, 721, 1713, 1346, 0, 1726, 1597, 1351, 1670, 1045, 453, 1681, 1187, 1370, 665, 994, 720, 147, 198, 335, 473, 1146, 1508, 76]"
42,9,5609,4871,6112,0,385,5224,"[891, 1277, 1280, 877, 1195, 1588, 752, 0, 956, 1446, 654, 558, 317, 631, 542, 79, 879, 661, 1428, 350, 426, 984, 1407, 479, 351, 815, 1231]"
43,9,5229,6429,4912,0,4596,633,"[153, 34, 26, 141, 128, 139, 182, 0, 52, 169, 187, 208, 115, 11, 184, 12, 17, 42, 95, 194, 74, 76, 17, 68, 154, 63, 73]"
44,9,6431,7163,4180,0,2811,3620,"[447, 1180, 840, 258, 1166, 229, 249, 0, 943, 645, 863, 623, 240, 1110, 896, 397, 1073, 603, 6, 422, 491, 1147, 676, 377, 234, 63, 962]"
45,9,6798,1294,9684,0,5306,1492,"[194, 482, 80, 248, 292, 125, 346, 0, 18, 313, 439, 253, 253, 32, 139, 98, 441, 382, 363, 445, 367, 188, 337, 256, 32, 18, 263]"
46,9,5386,5686,9384,0,1245,4141,"[1154, 840, 863, 27, 1071, 603, 498, 0, 448, 763, 1215, 1037, 669, 296, 22, 757, 605, 1335, 496, 1375, 684, 730, 550, 1236, 653, 466, 1235]"
47,9,5036,5221,9199,0,2003,3033,"[404, 448, 664, 499, 981, 402, 277, 0, 947, 920, 767, 600, 952, 365, 600, 65, 997, 771, 323, 965, 363, 917, 991, 798, 881, 463, 11]"
48,9,6440,7002,8637,0,392,6048,"[1545, 851, 354, 1488, 760, 366, 854, 0, 13, 34, 1395, 987, 1405, 961, 235, 846, 885, 1007, 154, 1381, 1157, 2002, 171, 711, 446, 1638, 1945]"
49,9,6560,6887,8310,0,106,6454,"[1730, 1536, 1048, 295, 707, 1063, 1928, 0, 620, 487, 1872, 472, 2090, 1860, 441, 1990, 392, 1849, 1651, 1613, 1509, 1670, 1549, 829, 754, 1645, 873]"
50,9,5406,6673,7043,0,3889,1517,"[41, 365, 114, 388, 336, 455, 452, 0, 315, 401, 190, 176, 313, 107, 114, 58, 259, 340, 248, 336, 190, 144, 224, 207, 322, 119, 451]"
51,9,6019,6246,6816,0,5631,388,"[44, 22, 9, 40, 106, 69, 90, 0, 49, 51, 32, 31, 121, 0, 9, 59, 50, 52, 59, 60, 50, 89, 88, 113, 1, 57, 101]"
52,9,5176,6342,5650,0,128,5048,"[1477, 560, 740, 780, 1305, 359, 1464, 0, 673, 750, 416, 543, 1233, 374, 410, 610, 1022, 995, 1394, 221, 433, 485, 34, 171, 151, 971, 1220]"
53,9,6709,6610,5749,0,4491,2218,"[374, 489, 689, 2, 385, 522, 291, 0, 542, 682, 463, 38, 464, 51, 299, 128, 253, 642, 134, 453, 518, 43, 639, 130, 138, 253, 128]"
54,9,6361,5219,6891,0,2511,3850,"[1200, 660, 609, 1105, 438, 740, 184, 0, 1116, 257, 624, 541, 132, 999, 351, 625, 160, 1178, 735, 1049, 209, 661, 1010, 1155, 791, 492, 805]"
55,9,6413,5170,8134,0,2641,3772,"[152, 1252, 76, 859, 930, 724, 537, 0, 891, 669, 435, 1181, 635, 735, 834, 879, 906, 1205, 1190, 1078, 647, 1221, 397, 138, 1181, 57, 445]"
56,9,6445,5207,9372,0,5618,827,"[71, 180, 45, 70, 115, 125, 270, 0, 23, 2, 122, 251, 142, 72, 34, 50, 77, 4, 262, 123, 168, 214, 220, 233, 0, 264, 19]"
57,9,5613,5396,9589,0,4840,773,"[167, 104, 166, 144, 3, 254, 169, 0, 244, 242, 174, 187, 245, 113, 160, 82, 99, 208, 174, 175, 201, 179, 43, 24, 16, 86, 146]"
58,9,5825,6519,8895,0,2935,2890,"[689, 900, 900, 753, 889, 881, 594, 0, 543, 485, 458, 726, 99, 248, 71, 658, 292, 689, 532, 229, 100, 41, 92, 447, 574, 856, 116]"
59,9,5428,5339,8984,0,2731,2697,"[731, 235, 592, 284, 292, 703, 708, 0, 817, 334, 154, 740, 95, 539, 312, 473, 15, 41, 425, 299, 19, 261, 561, 720, 43, 420, 430]"
60,9,5207,6409,7782,0,1601,3606,"[628, 412, 550, 739, 918, 840, 604, 0, 100, 11, 652, 398, 802, 1112, 780, 580, 72, 316, 108, 1023, 234, 1106, 38, 645, 72, 745, 1076]"
61,9,5593,7153,6222,0,4015,1578,"[111, 295, 121, 263, 235, 83, 420, 0, 78, 413, 183, 45, 168, 87, 179, 411, 275, 150, 375, 201, 276, 11, 159, 414, 308, 378, 314]"
62,9,5209,5338,6093,0,2683,2526,"[635, 375, 571, 303, 175, 302, 767, 0, 369, 99, 216, 586, 348, 124, 157, 21, 278, 691, 723, 609, 503, 280, 7, 658, 124, 496, 362]"
63,9,5842,6802,5133,0,82,5760,"[138, 1358, 1575, 1918, 1639, 1819, 708, 0, 1597, 1134, 1689, 147, 1144, 137, 349, 1895, 637, 267, 1775, 380, 1136, 345, 1655, 612, 1851, 1646, 1844]"
64,9,5011,406,9738,0,4430,581,"[17, 131, 72, 152, 152, 15, 25, 0, 135, 172, 95, 192, 115, 69, 168, 123, 77, 139, 72, 157, 52, 89, 188, 186, 132, 25, 45]"
65,9,6103,6798,9043,0,3426,2677,"[642, 838, 301, 210, 615, 663, 75, 0, 530, 354, 363, 502, 81, 253, 494, 79, 98, 389, 806, 331, 173, 301, 644, 734, 709, 523, 263]"
66,9,5789,6376,8456,0,2039,3750,"[701, 138, 915, 156, 1178, 72, 921, 0, 1052, 818, 701, 837, 341, 1216, 468, 881, 853, 392, 1152, 432, 1089, 583, 748, 1238, 1132, 166, 386]"
67,9,6656,6831,8281,0,5339,1317,"[134, 215, 372, 137, 59, 29, 56, 0, 229, 38, 285, 21, 214, 66, 230, 258, 326, 307, 272, 431, 36, 166, 392, 151, 26, 19, 425]"
68,9,6790,6864,8207,0,4882,1908,"[244, 283, 378, 425, 362, 105, 173, 0, 612, 361, 557, 636, 611, 226, 1, 598, 198, 64, 375, 133, 238, 186, 625, 53, 21, 10, 406]"
69,9,5853,5370,8690,0,5598,255,"[57, 24, 54, 41, 47, 4, 68, 0, 56, 65, 73, 51, 16, 72, 37, 17, 49, 5, 67, 12, 63, 34, 68, 67, 7, 14, 81]"
70,9,5765,7097,7358,0,438,5327,"[1267, 261, 589, 680, 1721, 1550, 1246, 0, 1699, 1281, 625, 1568, 749, 480, 710, 794, 500, 204, 869, 299, 758, 100, 782, 14, 967, 842, 1101]"
71,9,5783,6332,6809,0,4004,1779,"[233, 195, 104, 130, 505, 178, 198, 0, 519, 408, 326, 566, 128, 77, 490, 503, 273, 93, 84, 187, 271, 30, 11, 265, 160, 441, 495]"
72,9,5999,6564,6244,0,1029,4970,"[1508, 1396, 222, 475, 90, 408, 882, 0, 857, 711, 1560, 493, 1354, 885, 904, 1435, 507, 481, 1387, 1621, 616, 1247, 97, 999, 233, 1407, 490]"
73,9,5254,7389,4109,0,1759,3495,"[699, 529, 1050, 679, 529, 422, 841, 0, 89, 18, 107, 986, 78, 798, 647, 565, 914, 700, 952, 372, 779, 909, 998, 197, 297, 1019, 97]"
74,9,6700,2872,7937,0,3362,3338,"[168, 765, 570, 102, 16, 995, 406, 0, 985, 164, 988, 698, 429, 294, 927, 1025, 1098, 626, 1017, 1027, 17, 1001, 62, 1010, 747, 380, 21]"
75,9,6941,6747,8131,0,6118,823,"[207, 244, 132, 84, 7, 55, 216, 0, 160, 5, 265, 213, 152, 232, 255, 177, 115, 29, 266, 274, 64, 155, 53, 257, 16, 120, 253]"
76,9,6001,5757,8375,0,3757,2244,"[658, 84, 677, 351, 59, 733, 592, 0, 577, 642, 437, 43, 219, 615, 650, 468, 523, 201, 336, 313, 456, 15, 737, 112, 376, 105, 180]"
77,9,6056,6713,7718,0,5024,1032,"[132, 287, 161, 276, 120, 234, 130, 0, 92, 119, 20, 186, 304, 183, 195, 331, 25, 5, 87, 213, 304, 38, 16, 43, 36, 117, 29]"
78,9,6007,5189,8536,0,368,5639,"[550, 625, 1027, 622, 414, 1006, 1396, 0, 1762, 1587, 881, 584, 1337, 850, 892, 1666, 899, 713, 154, 1486, 140, 540, 246, 1454, 1020, 809, 10]"
79,9,6216,6359,8393,0,748,5468,"[1091, 495, 285, 559, 112, 1616, 902, 0, 711, 1803, 1046, 218, 853, 1701, 58, 86, 761, 382, 1669, 1347, 1154, 1756, 16, 1707, 1182, 147, 1692]"
80,9,5761,6796,7358,0,3569,2192,"[548, 459, 171, 144, 716, 524, 493, 0, 489, 576, 600, 439, 644, 721, 283, 286, 566, 704, 203, 574, 8, 700, 378, 578, 417, 425, 71]"
81,9,5741,6657,6442,0,3870,1871,"[278, 269, 548, 197, 279, 222, 29, 0, 115, 192, 505, 334, 519, 60, 233, 110, 177, 138, 132, 473, 302, 18, 298, 230, 248, 589, 257]"
82,9,5102,6365,5179,0,4797,305,"[89, 100, 50, 70, 49, 57, 67, 0, 34, 18, 8, 40, 71, 55, 75, 65, 15, 46, 70, 0, 78, 33, 84, 3, 97, 1, 66]"
83,9,5974,5528,5625,0,1134,4840,"[367, 935, 1011, 818, 471, 940, 211, 0, 497, 342, 643, 116, 27, 1108, 1465, 598, 718, 259, 381, 1179, 988, 1019, 1093, 341, 681, 1589, 866]"
84,9,5355,5176,5804,0,4208,1147,"[161, 199, 132, 366, 197, 322, 213, 0, 281, 117, 193, 11, 350, 151, 276, 193, 379, 230, 336, 165, 221, 333, 197, 91, 244, 80, 328]"
85,9,6244,5761,6287,0,1687,4557,"[253, 287, 789, 1037, 1320, 1424, 828, 0, 441, 745, 1504, 446, 1035, 1462, 345, 1167, 1472, 859, 1402, 428, 671, 1299, 1498, 1388, 137, 652, 1240]"
86,9,5222,7496,4013,0,1944,3278,"[186, 228, 198, 510, 93, 1080, 147, 0, 734, 952, 887, 56, 512, 1030, 669, 429, 17, 875, 95, 1073, 815, 1071, 1007, 120, 331, 1083, 460]"
87,9,5918,5891,4040,0,2315,3603,"[946, 37, 1140, 1110, 1085, 161, 221, 0, 4, 231, 425, 298, 1065, 56, 477, 75, 304, 1070, 544, 984, 380, 915, 298, 1186, 673, 312, 579]"
88,9,6760,3160,7640,0,1481,5279,"[1486, 298, 1697, 911, 489, 480, 770, 0, 514, 836, 1058, 1016, 1313, 1651, 873, 859, 1722, 1753, 349, 1068, 1074, 1432, 860, 3, 1549, 1388, 944]"
89,9,6099,5645,8094,0,215,5884,"[171, 84, 980, 1881, 1261, 394, 825, 0, 687, 1252, 1878, 1500, 832, 1124, 600, 1014, 519, 246, 697, 167, 922, 916, 918, 1249, 926, 1697, 311]"
90,9,6788,5321,9561,0,2166,4622,"[171, 1268, 165, 939, 55, 1307, 30, 0, 402, 940, 1242, 34, 1246, 1442, 899, 1533, 1436, 290, 155, 804, 1053, 17, 1492, 120, 276, 575, 28]"
91,9,6883,5646,10000,798,3670,3213,"[673, 825, 708, 481, 743, 79, 417, 0, 204, 522, 354, 99, 922, 1035, 599, 36, 114, 785, 390, 41, 4, 172, 473, 234, 1049, 287, 529]"
92,9,5657,6759,8898,0,3300,2357,"[4, 423, 661, 321, 540, 226, 440, 0, 553, 736, 770, 411, 114, 186, 656, 523, 180, 649, 757, 380, 470, 69, 295, 601, 247, 679, 759]"
93,9,5308,5632,8574,0,5163,145,"[32, 13, 33, 15, 24, 23, 40, 0, 10, 7, 18, 6, 18, 4, 28, 0, 20, 23, 41, 42, 2, 6, 18, 26, 38, 18, 4]"
94,9,5836,5971,8439,0,2773,3063,"[929, 549, 32, 636, 663, 559, 451, 0, 776, 899, 239, 300, 3, 320, 388, 32, 517, 661, 766, 376, 611, 229, 646, 846, 534, 409, 139]"
95,9,6484,7363,7560,0,784,5700,"[996, 801, 1349, 523, 1068, 629, 81, 0, 1459, 992, 113, 660, 1109, 1730, 242, 1497, 1017, 98, 506, 1612, 934, 878, 1059, 234, 1880, 721, 1642]"
96,9,5563,6888,6235,0,4130,1433,"[447, 370, 465, 204, 302, 240, 380, 0, 380, 84, 441, 120, 125, 372, 417, 271, 302, 340, 466, 276, 74, 279, 274, 194, 73, 58, 311]"
97,9,6402,5054,7583,0,3597,2805,"[506, 783, 515, 893, 620, 389, 193, 0, 49, 504, 241, 656, 775, 93, 7, 340, 606, 173, 929, 843, 563, 749, 743, 713, 901, 180, 641]"
98,9,6234,7020,6797,0,93,6141,"[1340, 1510, 530, 980, 1834, 886, 654, 0, 1238, 1995, 814, 778, 257, 1714, 1848, 1197, 1007, 265, 1282, 326, 585, 1984, 1079, 1189, 1488, 1698, 298]"
99,9,5547,5065,7279,0,563,4984,"[347, 970, 580, 1337, 275, 1598, 866, 0, 768, 1011, 1231, 331, 531, 1596, 836, 1231, 745, 1540, 1011, 814, 719, 631, 550, 1643, 827, 458, 356]"
100,9,5947,5907,7319,0,3026,2921,"[510, 742, 808, 199, 569, 18, 631, 0, 435, 693, 582, 822, 936, 752, 952, 508, 929, 508, 671, 747, 275, 514, 864, 97, 185, 224, 180]"
101,9,5839,7452,5706,0,1123,4716,"[630, 197, 1565, 1181, 1298, 1013, 1036, 0, 854, 1515, 68, 713, 110, 678, 700, 1480, 40, 959, 653, 1544, 723, 810, 35, 435, 1535, 1326, 1474]"
102,9,5274,3947,7033,0,3954,1320,"[269, 17, 19, 40, 420, 263, 32, 0, 65, 420, 69, 410, 73, 70, 54, 18, 299, 421, 340, 94, 189, 65, 76, 141, 144, 167, 433]"
103,9,6328,5471,7890,0,924,5404,"[609, 1208, 629, 931, 1636, 1713, 1020, 0, 801, 175, 1095, 862, 12, 1726, 989, 606, 1339, 1172, 1369, 239, 1654, 894, 1799, 411, 1390, 221, 342]"
104,9,5245,6510,6625,0,2193,3052,"[519, 646, 831, 333, 166, 75, 677, 0, 218, 287, 252, 775, 399, 728, 491, 29, 170, 931, 128, 685, 218, 621, 1016, 103, 358, 800, 121]"
105,9,6861,5446,8040,0,6285,576,"[147, 14, 82, 79, 17, 192, 33, 0, 160, 137, 45, 8, 156, 100, 162, 168, 157, 41, 113, 64, 9, 167, 3, 2, 175, 98, 133]"
106,9,5955,6853,7142,0,1276,4679,"[375, 562, 792, 45, 1215, 679, 291, 0, 1349, 647, 1473, 108, 580, 1369, 514, 1383, 599, 1026, 613, 864, 1138, 1528, 992, 1039, 1216, 902, 848]"
107,9,6085,5324,7903,0,4196,1889,"[132, 65, 206, 187, 71, 198, 315, 0, 209, 311, 566, 347, 125, 91, 247, 25, 29, 298, 532, 593, 28, 69, 72, 251, 385, 371, 4]"
108,9,6771,6621,8053,0,615,6156,"[706, 499, 587, 159, 1844, 1378, 191, 0, 279, 2045, 442, 180, 1643, 1654, 1199, 604, 372, 26, 1414, 1101, 1280, 911, 2, 1941, 1281, 1655, 1387]"
109,9,5754,6949,6858,0,5661,93,"[19, 12, 9, 23, 9, 1, 22, 0, 20, 3, 16, 11, 18, 2, 31, 16, 11, 18, 29, 22, 27, 10, 8, 31, 31, 30, 19]"
110,9,5024,5930,5952,0,4616,408,"[28, 10, 98, 39, 72, 126, 134, 0, 37, 58, 41, 121, 78, 79, 51, 120, 69, 22, 43, 33, 93, 89, 61, 15, 51, 28, 92]"
111,9,6686,7307,5331,0,568,6118,"[1164, 495, 672, 1177, 1267, 1493, 645, 0, 825, 1351, 1999, 1803, 137, 1893, 282, 1321, 789, 1120, 1588, 1542, 414, 200, 1514, 1572, 560, 205, 144]"
112,9,5263,4161,6433,0,3683,1580,"[128, 313, 222, 44, 86, 489, 499, 0, 506, 169, 73, 386, 374, 89, 186, 278, 210, 58, 519, 140, 126, 322, 112, 27, 179, 512, 288]"
113,9,6845,6347,6931,0,6817,28,"[7, 9, 5, 8, 1, 3, 2, 0, 3, 8, 7, 6, 2, 5, 7, 5, 5, 8, 1, 4, 4, 9, 2, 8, 5, 2, 9]"
114,9,5193,6887,5237,0,765,4428,"[1113, 313, 863, 71, 692, 602, 137, 0, 907, 335, 91, 324, 306, 738, 1024, 715, 591, 700, 132, 924, 780, 407, 360, 1438, 1098, 1190, 1003]"
115,9,6296,6196,5337,0,1248,5048,"[166, 147, 426, 1653, 1575, 798, 390, 0, 186, 916, 548, 977, 1402, 40, 1545, 1585, 1624, 1664, 339, 1295, 606, 590, 1644, 250, 110, 404, 471]"
116,9,5385,383,10000,339,5228,157,"[50, 31, 12, 38, 21, 37, 14, 0, 0, 16, 52, 15, 20, 34, 31, 29, 18, 42, 0, 17, 48, 16, 4, 52, 11, 13, 44]"
117,9,5384,6591,8793,0,2194,3190,"[687, 811, 984, 774, 437, 703, 510, 0, 271, 207, 388, 547, 429, 964, 146, 946, 765, 18, 438, 951, 309, 1011, 743, 897, 632, 945, 142]"
118,9,5842,6876,7759,0,560,5282,"[1180, 1662, 581, 1209, 1759, 1542, 485, 0, 659, 1017, 778, 1266, 1643, 1458, 128, 1617, 1683, 1738, 1690, 1637, 840, 1327, 819, 1459, 861, 1556, 79]"
119,9,6550,6002,8307,0,1257,5293,"[961, 210, 1491, 422, 1630, 907, 512, 0, 407, 1732, 1673, 359, 1483, 835, 52, 426, 318, 241, 230, 701, 333, 646, 986, 1080, 1465, 1130, 150]"
120,9,5195,6468,7034,0,2570,2625,"[727, 53, 252, 23, 317, 683, 734, 0, 243, 112, 776, 3, 560, 457, 373, 73, 239, 261, 456, 538, 512, 595, 35, 511, 602, 710, 25]"
121,9,5616,6748,5902,0,1381,4235,"[595, 1050, 334, 1357, 358, 626, 854, 0, 809, 1075, 1088, 546, 150, 925, 296, 241, 625, 143, 248, 1000, 1309, 1270, 3, 1220, 561, 1015, 379]"
122,9,5685,6068,5519,0,2320,3365,"[703, 963, 186, 1091, 923, 440, 143, 0, 993, 644, 1119, 81, 795, 107, 648, 416, 294, 982, 44, 1057, 1118, 876, 563, 183, 537, 901, 201]"
123,9,6088,7090,4517,0,4651,1437,"[400, 405, 225, 233, 263, 472, 454, 0, 122, 451, 459, 420, 115, 339, 366, 88, 452, 142, 117, 419, 45, 208, 10, 438, 58, 301, 208]"
124,9,6198,2625,8090,0,4956,1242,"[94, 61, 366, 55, 332, 124, 3, 0, 173, 311, 408, 269, 126, 61, 61, 336, 24, 227, 339, 280, 0, 281, 35, 202, 226, 283, 344]"
125,9,5965,7455,6600,0,3612,2353,"[658, 2, 442, 706, 34, 372, 123, 0, 301, 245, 53, 31, 776, 283, 0, 481, 491, 156, 686, 759, 702, 430, 721, 151, 332, 634, 226]"
126,9,5282,5068,6814,0,112,5170,"[1348, 1241, 431, 539, 240, 262, 1282, 0, 193, 1132, 219, 34, 54, 126, 1162, 1352, 189, 1722, 1474, 1601, 486, 1478, 843, 282, 1604, 359, 62]"
127,9,5640,7136,5318,0,279,5361,"[555, 469, 1262, 29, 1473, 753, 1398, 0, 873, 1766, 1687, 1091, 1540, 1285, 1595, 447, 1580, 679, 1079, 357, 149, 350, 1687, 1656, 1713, 706, 1431]"
128,9,5646,5323,5641,0,524,5122,"[1401, 1304, 346, 1376, 1542, 136, 1361, 0, 263, 1378, 1278, 1520, 994, 758, 1325, 895, 1638, 1456, 23, 1312, 740, 1531, 753, 1274, 655, 564, 297]"
129,9,6315,7449,4507,0,2590,3725,"[1179, 272, 791, 618, 113, 95, 473, 0, 597, 240, 1124, 436, 561, 1226, 745, 714, 1114, 723, 48, 961, 432, 391, 200, 307, 1204, 241, 854]"
130,9,5771,3550,6728,0,320,5451,"[814, 874, 1702, 1713, 1774, 1373, 105, 0, 1559, 1558, 627, 1429, 1048, 542, 395, 796, 148, 151, 1730, 537, 402, 1611, 189, 1159, 1363, 1050, 697]"
131,9,5543,5997,6274,0,4149,1394,"[172, 259, 123, 288, 336, 50, 134, 0, 183, 341, 397, 39, 26, 126, 174, 313, 71, 102, 72, 252, 390, 275, 353, 144, 70, 228, 156]"
132,9,5533,5954,5853,0,652,4881,"[362, 1475, 745, 266, 533, 632, 348, 0, 131, 169, 669, 1077, 1503, 940, 574, 868, 693, 670, 76, 801, 278, 1589, 368, 387, 490, 967, 1139]"
133,9,6888,6585,6156,0,6378,510,"[140, 82, 136, 64, 0, 10, 54, 0, 48, 108, 67, 131, 125, 92, 30, 130, 144, 152, 170, 51, 152, 103, 166, 137, 90, 72, 5]"
134,9,6564,7404,5316,0,6269,295,"[51, 57, 57, 35, 10, 13, 80, 0, 46, 31, 52, 82, 31, 13, 85, 4, 98, 71, 72, 60, 0, 34, 60, 14, 76, 28, 84]"
135,9,6053,5714,5655,0,1509,4544,"[1299, 195, 562, 1313, 802, 254, 862, 0, 707, 709, 1231, 1027, 1257, 506, 706, 1513, 814, 314, 362, 1369, 1124, 1216, 0, 196, 490, 1243, 928]"
136,9,6934,6704,5885,0,1865,5069,"[700, 1234, 922, 97, 1489, 636, 323, 0, 1160, 1562, 10, 398, 1114, 388, 332, 339, 402, 659, 60, 1678, 4, 1545, 161, 990, 1078, 702, 157]"
137,9,5291,5200,5976,0,2738,2553,"[671, 30, 617, 767, 784, 355, 234, 0, 136, 351, 805, 163, 739, 530, 329, 779, 433, 830, 5, 302, 58, 479, 845, 145, 826, 58, 636]"
138,9,5482,7136,4322,0,23,5459,"[1524, 190, 1799, 441, 705, 745, 1246, 0, 937, 1408, 1069, 578, 1187, 1377, 1505, 993, 1716, 493, 501, 162, 1471, 660, 1682, 191, 1105, 606, 842]"
139,9,5922,90,10000,154,5594,328,"[14, 19, 69, 101, 73, 3, 106, 0, 39, 102, 30, 64, 79, 69, 97, 87, 21, 66, 44, 11, 50, 30, 37, 46, 91, 56, 71]"
140,9,5893,6906,8987,0,2027,3866,"[734, 640, 838, 786, 985, 1048, 1028, 0, 199, 1013, 483, 1087, 1161, 466, 679, 994, 1074, 150, 1069, 1151, 1231, 1180, 243, 125, 840, 780, 278]"
141,9,6801,7427,8361,0,4688,2113,"[15, 493, 163, 243, 213, 666, 82, 0, 372, 476, 701, 388, 576, 635, 416, 267, 542, 111, 599, 505, 380, 505, 698, 580, 136, 670, 143]"
142,9,6092,5569,8884,0,3257,2835,"[632, 480, 264, 481, 728, 515, 479, 0, 657, 510, 594, 148, 616, 824, 837, 506, 634, 569, 602, 271, 647, 12, 924, 110, 848, 913, 30]"
143,9,5324,5599,8609,0,3066,2258,"[206, 470, 642, 386, 721, 70, 613, 0, 0, 267, 385, 617, 202, 524, 250, 187, 558, 560, 241, 163, 672, 732, 255, 603, 580, 110, 659]"
144,9,5344,6527,7426,0,483,4861,"[1546, 1354, 253, 1169, 1250, 485, 113, 0, 591, 333, 1367, 1282, 794, 942, 1345, 579, 612, 1407, 1292, 1594, 1237, 1132, 233, 1227, 1024, 428, 191]"
145,9,6138,6993,6571,0,2362,3776,"[839, 419, 563, 434, 885, 554, 1075, 0, 713, 1257, 540, 751, 1007, 941, 1183, 637, 565, 679, 531, 212, 747, 484, 663, 1140, 718, 330, 972]"
146,9,5849,5847,6573,0,3326,2523,"[512, 100, 532, 381, 805, 684, 835, 0, 201, 749, 693, 65, 132, 362, 51, 639, 392, 328, 717, 188, 46, 442, 218, 643, 403, 630, 292]"
147,9,5603,5766,6410,0,228,5375,"[1781, 1216, 640, 1267, 1449, 578, 774, 0, 398, 1438, 487, 125, 728, 733, 153, 1229, 272, 1429, 1443, 1556, 492, 1417, 859, 1079, 1762, 720, 302]"
148,9,6915,6314,7011,0,5414,1501,"[154, 319, 296, 499, 330, 419, 108, 0, 473, 70, 221, 355, 93, 293, 475, 276, 484, 115, 215, 362, 359, 201, 176, 468, 392, 5, 465]"
149,9,5992,6798,6205,0,1041,4951,"[1401, 1273, 1150, 1130, 1254, 1244, 498, 0, 1634, 327, 1330, 1456, 1374, 1468, 1139, 980, 1479, 1021, 30, 876, 621, 1281, 1207, 1302, 747, 205, 1539]"
150,9,6719,7380,5544,0,3525,3194,"[303, 846, 652, 794, 59, 251, 126, 0, 247, 61, 606, 990, 805, 425, 1043, 92, 755, 41, 788, 198, 1009, 764, 1059, 710, 484, 987, 736]"
151,9,5653,6877,4320,0,3753,1900,"[73, 386, 107, 516, 407, 367, 66, 0, 526, 253, 425, 601, 434, 284, 277, 570, 489, 55, 127, 243, 513, 474, 514, 26, 87, 209, 240]"
152,9,5757,1248,8829,0,2389,3368,"[698, 696, 1057, 926, 120, 792, 932, 0, 15, 429, 158, 218, 201, 957, 515, 836, 146, 374, 507, 367, 963, 316, 1070, 932, 840, 202, 506]"
153,9,5661,6228,8262,0,1216,4445,"[345, 1423, 1414, 1019, 291, 68, 1159, 0, 957, 131, 752, 1397, 1, 1354, 809, 261, 1452, 227, 32, 45, 1447, 1297, 480, 755, 1020, 858, 255]"
154,9,6555,7493,7324,0,1271,5284,"[456, 1104, 1408, 1124, 581, 233, 1562, 0, 878, 342, 1343, 246, 814, 705, 807, 1001, 429, 442, 1404, 1071, 718, 456, 1359, 1072, 901, 575, 1092]"
155,9,6388,5443,8269,0,1119,5269,"[1115, 1317, 1454, 1472, 1290, 1741, 232, 0, 899, 1043, 1608, 1250, 1742, 671, 153, 482, 1381, 663, 1072, 1597, 479, 740, 622, 280, 1009, 1264, 1093]"
156,9,5574,5952,7891,0,2485,3089,"[7, 421, 100, 353, 927, 976, 239, 0, 41, 78, 740, 308, 600, 361, 131, 409, 607, 514, 780, 619, 92, 933, 803, 329, 56, 964, 509]"
157,9,5451,7457,5885,0,4106,1345,"[238, 114, 432, 332, 310, 132, 302, 0, 399, 371, 284, 278, 209, 241, 335, 173, 234, 218, 197, 315, 327, 403, 105, 440, 326, 423, 318]"
158,9,5799,7230,4454,0,4976,823,"[92, 42, 248, 183, 230, 82, 128, 0, 104, 32, 77, 222, 143, 124, 237, 248, 211, 5, 198, 207, 45, 23, 210, 231, 103, 134, 230]"
159,9,5664,3772,6346,0,984,4680,"[1075, 1377, 784, 743, 91, 204, 674, 0, 1459, 176, 1500, 1503, 639, 1359, 1019, 1216, 1186, 1386, 83, 502, 1110, 327, 1041, 1369, 1429, 423, 825]"
160,9,6158,6804,5700,0,4108,2050,"[626, 626, 150, 594, 163, 669, 171, 0, 74, 217, 657, 351, 148, 466, 410, 5, 273, 260, 20, 283, 20, 357, 578, 606, 655, 300, 302]"
161,9,5846,5434,6112,0,4626,1220,"[57, 85, 252, 350, 230, 341, 8, 0, 334, 261, 406, 394, 153, 227, 246, 16, 337, 39, 252, 186, 57, 213, 344, 273, 396, 312, 338]"
162,9,6026,5475,6663,0,2646,3380,"[374, 612, 314, 36, 1052, 1121, 505, 0, 1125, 46, 156, 278, 449, 98, 279, 468, 595, 558, 293, 342, 243, 119, 290, 207, 305, 375, 940]"
163,9,5846,7079,5430,0,2569,3277,"[836, 323, 243, 342, 341, 101, 140, 0, 16, 727, 732, 94, 1033, 566, 332, 521, 38, 627, 556, 516, 246, 1047, 185, 744, 407, 601, 390]"
164,9,6518,5955,5993,0,5051,1467,"[475, 28, 9, 408, 243, 385, 418, 0, 264, 334, 335, 1, 257, 158, 196, 169, 373, 18, 166, 244, 84, 171, 259, 366, 440, 91, 181]"
165,9,6710,6151,6552,0,5586,1124,"[342, 8, 154, 219, 251, 353, 147, 0, 9, 355, 186, 120, 102, 167, 249, 84, 305, 364, 363, 103, 350, 158, 257, 336, 256, 129, 70]"
166,9,5961,5231,7282,0,3011,2950,"[447, 353, 574, 570, 812, 861, 898, 0, 730, 228, 921, 359, 361, 699, 830, 210, 172, 789, 213, 248, 805, 933, 868, 767, 408, 118, 225]"
167,9,5705,7302,5685,0,1704,4001,"[290, 272, 449, 923, 603, 750, 33, 0, 679, 45, 548, 897, 564, 1286, 66, 934, 1270, 329, 109, 996, 303, 396, 1010, 698, 361, 515, 604]"
168,9,6650,6111,6224,0,4739,1911,"[511, 298, 370, 421, 488, 357, 423, 0, 233, 139, 48, 423, 559, 101, 253, 313, 143, 425, 242, 381, 284, 486, 626, 0, 615, 303, 425]"
169,9,6777,6144,6857,0,3807,2970,"[912, 950, 494, 39, 792, 914, 83, 0, 654, 417, 644, 21, 931, 445, 627, 517, 968, 667, 48, 576, 232, 10, 332, 907, 408, 173, 356]"
170,9,5343,6536,5664,0,4363,980,"[298, 199, 170, 67, 286, 216, 169, 0, 214, 20, 304, 243, 273, 0, 301, 203, 223, 178, 183, 37, 253, 4, 33, 160, 175, 129, 57]"
171,9,5260,4253,6671,0,2004,3256,"[953, 168, 397, 244, 1069, 833, 628, 0, 298, 908, 871, 349, 755, 548, 1070, 225, 991, 549, 776, 253, 999, 185, 1010, 831, 298, 814, 915]"
172,9,5200,7313,4558,0,3060,2140,"[623, 402, 629, 142, 303, 121, 333, 0, 299, 508, 348, 252, 341, 39, 82, 194, 42, 683, 217, 9, 96, 210, 687, 251, 146, 183, 177]"
173,9,6500,6738,4320,0,4317,2183,"[50, 134, 142, 491, 585, 230, 472, 0, 529, 390, 698, 326, 243, 197, 481, 3, 288, 262, 71, 98, 172, 444, 715, 588, 170, 19, 672]"
174,9,6850,5583,5587,0,6615,235,"[18, 65, 11, 55, 23, 9, 36, 0, 66, 71, 42, 73, 77, 40, 55, 40, 17, 74, 22, 18, 38, 30, 17, 47, 22, 45, 31]"
175,9,5146,3292,7441,0,298,4848,"[67, 1129, 191, 808, 962, 731, 1069, 0, 22, 492, 1446, 1307, 315, 1169, 1554, 1562, 931, 1270, 111, 602, 1386, 1564, 218, 464, 962, 266, 1349]"
176,9,6228,5531,8138,0,5199,1029,"[254, 143, 135, 182, 64, 316, 246, 0, 36, 218, 324, 257, 45, 147, 237, 57, 304, 42, 110, 172, 245, 274, 135, 48, 122, 164, 149]"
177,9,5571,7383,6326,0,3637,1934,"[621, 641, 252, 412, 81, 214, 541, 0, 303, 458, 395, 111, 633, 286, 509, 106, 37, 78, 498, 392, 106, 194, 383, 60, 523, 336, 583]"
178,9,6180,7442,5064,0,3920,2260,"[138, 143, 575, 720, 703, 534, 340, 0, 716, 3, 290, 690, 733, 397, 248, 567, 364, 254, 342, 308, 740, 749, 490, 369, 315, 78, 136]"
179,9,6341,5598,5807,0,1889,4452,"[469, 1466, 84, 283, 253, 8, 334, 0, 1469, 1138, 420, 206, 912, 361, 677, 687, 1232, 483, 660, 1416, 1267, 710, 589, 322, 1320, 592, 963]"
180,9,6240,7087,4960,0,1765,4475,"[369, 1102, 309, 1232, 860, 124, 1160, 0, 611, 52, 907, 1084, 1372, 756, 403, 1424, 327, 136, 475, 1233, 406, 1435, 943, 1469, 536, 1421, 743]"
181,9,5923,1099,9784,0,1852,4071,"[940, 708, 1349, 832, 1286, 968, 1050, 0, 1293, 1349, 838, 886, 1071, 1055, 582, 700, 505, 1083, 443, 1335, 1183, 99, 583, 199, 862, 662, 59]"
182,9,5214,5935,9063,0,468,4746,"[1070, 412, 1488, 1058, 202, 1160, 32, 0, 1535, 1020, 650, 336, 1487, 942, 350, 1452, 1227, 306, 337, 425, 298, 332, 723, 163, 109, 418, 1539]"
183,9,5683,5813,8933,0,3870,1813,"[126, 118, 392, 89, 573, 44, 175, 0, 243, 341, 162, 522, 266, 144, 138, 366, 282, 443, 323, 597, 312, 52, 429, 380, 477, 56, 474]"
184,9,5221,6533,7621,0,3913,1308,"[193, 133, 6, 405, 333, 3, 116, 0, 338, 7, 311, 4, 55, 85, 215, 378, 166, 247, 24, 356, 435, 268, 242, 407, 136, 170, 41]"
185,9,6158,5760,8019,0,5795,363,"[64, 115, 74, 27, 7, 91, 57, 0, 9, 77, 28, 88, 86, 25, 54, 23, 104, 70, 68, 116, 57, 24, 14, 49, 4, 101, 12]"
186,9,5264,6072,7211,0,4393,871,"[169, 42, 251, 7, 26, 173, 62, 0, 63, 65, 3, 260, 279, 57, 250, 246, 118, 268, 95, 162, 133, 85, 252, 274, 82, 278, 105]"
187,9,6137,5198,8150,0,5787,350,"[74, 73, 107, 69, 36, 21, 95, 0, 62, 86, 43, 73, 89, 33, 79, 37, 84, 1, 94, 107, 22, 50, 19, 39, 27, 113, 30]"
188,9,6304,5779,8675,0,6232,72,"[16, 15, 0, 19, 17, 8, 7, 0, 1, 4, 6, 7, 16, 5, 20, 7, 24, 23, 4, 12, 20, 17, 1, 17, 13, 16, 12]"
189,9,5872,6548,7999,0,2333,3539,"[304, 1113, 102, 487, 459, 292, 1088, 0, 348, 815, 704, 212, 285, 44, 74, 812, 144, 599, 91, 640, 134, 350, 131, 1063, 811, 1117, 289]"
190,9,6961,5474,9486,0,6197,764,"[12, 178, 67, 79, 92, 185, 251, 0, 100, 162, 3, 195, 164, 60, 32, 29, 214, 7, 52, 132, 80, 218, 105, 132, 9, 207, 83]"
191,9,6492,6760,9218,0,3796,2696,"[422, 342, 46, 864, 891, 359, 871, 0, 133, 115, 194, 590, 826, 801, 700, 222, 461, 779, 2, 532, 389, 354, 230, 14, 240, 47, 8]"
192,9,6433,7157,8494,0,2759,3674,"[1205, 898, 536, 986, 132, 105, 564, 0, 1211, 701, 84, 457, 68, 59, 619, 742, 525, 707, 865, 504, 1106, 474, 56, 679, 614, 516, 1219]"
193,9,6526,6266,8754,0,388,6138,"[1828, 121, 1128, 177, 403, 1029, 1176, 0, 1551, 837, 1676, 408, 411, 1319, 1739, 1340, 336, 496, 826, 876, 1004, 116, 204, 1963, 1183, 1878, 2003]"
194,9,5468,7061,7161,0,1979,3489,"[653, 541, 663, 133, 4, 454, 2, 0, 302, 1154, 199, 635, 1075, 51, 735, 31, 202, 391, 549, 306, 21, 548, 271, 14, 236, 343, 322]"
195,9,5537,7028,5670,0,2153,3384,"[319, 329, 70, 245, 414, 1022, 699, 0, 758, 1030, 275, 954, 1047, 659, 150, 97, 235, 512, 1015, 527, 421, 413, 89, 24, 246, 741, 1023]"
196,9,6123,6703,5090,0,1340,4783,"[173, 800, 1047, 930, 768, 1382, 56, 0, 1340, 189, 659, 882, 1583, 160, 1437, 1419, 1339, 517, 1418, 979, 864, 371, 418, 818, 1022, 159, 604]"
197,9,6156,7147,4099,0,3836,2320,"[195, 652, 592, 34, 422, 743, 666, 0, 586, 540, 354, 275, 690, 443, 708, 63, 663, 392, 524, 160, 574, 263, 118, 346, 627, 474, 373]"
198,9,6541,5961,4679,0,1354,5187,"[181, 1273, 901, 852, 537, 844, 79, 0, 1001, 1171, 849, 434, 1252, 512, 350, 149, 794, 539, 1453, 983, 678, 217, 1225, 1569, 121, 91, 1434]"
199,9,5036,865,8850,0,3221,1815,"[603, 574, 336, 61, 260, 385, 160, 0, 587, 336, 423, 65, 460, 288, 83, 9, 470, 529, 244, 64, 122, 587, 452, 206, 597, 44, 417]"
200,9,6768,6938,8680,0,3463,3305,"[486, 132, 252, 307, 910, 934, 410, 0, 195, 994, 602, 756, 453, 862, 728, 541, 578, 868, 456, 275, 395, 168, 1090, 101, 193, 643, 38]"
201,9,6871,5799,9752,0,6838,33,"[10, 7, 7, 2, 3, 11, 0, 0, 6, 8, 3, 2, 4, 0, 5, 8, 2, 11, 6, 2, 3, 1, 10, 4, 11, 1, 6]"
202,9,5241,5457,9536,0,5189,52,"[4, 4, 2, 2, 5, 12, 1, 0, 14, 3, 4, 0, 9, 3, 12, 14, 8, 5, 7, 16, 0, 7, 12, 9, 0, 5, 6]"
203,9,5250,5560,9226,0,1072,4178,"[35, 1331, 750, 874, 681, 743, 1011, 0, 544, 664, 1054, 556, 1271, 1000, 740, 937, 598, 1165, 522, 1096, 476, 1158, 682, 1110, 198, 576, 171]"
204,9,5359,6671,7914,0,1934,3425,"[657, 255, 119, 737, 1095, 833, 583, 0, 302, 841, 50, 558, 604, 1078, 127, 749, 50, 585, 919, 4, 865, 980, 552, 176, 786, 102, 353]"
205,9,5077,5908,7083,0,3430,1647,"[370, 254, 505, 97, 28, 106, 118, 0, 61, 314, 373, 274, 330, 294, 180, 168, 194, 273, 202, 472, 490, 337, 375, 476, 409, 10, 37]"
206,9,5135,5449,6769,0,4676,459,"[60, 47, 91, 139, 94, 7, 82, 0, 132, 13, 104, 132, 122, 45, 32, 121, 146, 93, 140, 130, 127, 43, 9, 142, 93, 140, 151]"
207,9,5089,5161,6697,0,2731,2358,"[57, 277, 583, 60, 149, 705, 693, 0, 38, 671, 347, 529, 330, 191, 612, 268, 228, 175, 325, 253, 516, 299, 665, 709, 114, 726, 132]"
208,9,6686,6534,6849,0,3866,2820,"[296, 287, 485, 250, 263, 639, 541, 0, 412, 264, 167, 332, 197, 144, 270, 677, 507, 466, 556, 437, 706, 44, 893, 391, 625, 237, 847]"
209,9,5678,7207,5320,0,3101,2577,"[761, 593, 520, 563, 418, 676, 311, 0, 498, 117, 826, 714, 7, 473, 275, 619, 287, 529, 601, 262, 629, 200, 615, 720, 443, 678, 153]"
210,9,6295,6198,5417,0,1030,5265,"[585, 76, 850, 1265, 1004, 274, 1566, 0, 394, 214, 1468, 1305, 351, 1346, 53, 919, 249, 1731, 881, 1405, 1511, 29, 1287, 452, 591, 400, 359]"
211,9,5525,1912,9030,0,2043,3482,"[255, 978, 546, 619, 487, 797, 880, 0, 307, 211, 598, 1000, 194, 814, 27, 423, 1045, 888, 180, 620, 733, 625, 606, 1114, 807, 75, 685]"
212,9,6641,7106,8565,0,3815,2826,"[157, 298, 7, 864, 651, 336, 51, 0, 689, 428, 89, 921, 510, 74, 855, 355, 633, 891, 526, 636, 476, 366, 235, 552, 1, 130, 210]"
213,9,5835,5978,8422,0,5789,46,"[8, 13, 12, 10, 5, 3, 0, 0, 12, 8, 3, 11, 11, 14, 5, 7, 12, 9, 5, 7, 12, 12, 12, 1, 6, 3, 8]"
214,9,5773,6768,7427,0,4354,1419,"[289, 352, 165, 434, 455, 212, 207, 0, 332, 458, 107, 278, 274, 291, 56, 230, 46, 250, 267, 363, 468, 220, 125, 78, 299, 313, 131]"
215,9,6954,5320,9061,0,1678,5276,"[885, 254, 40, 72, 433, 352, 773, 0, 241, 103, 1074, 1043, 1518, 1544, 8, 1300, 713, 867, 1381, 125, 1131, 1734, 1395, 709, 377, 942, 248]"
216,9,6107,5330,9838,0,5192,915,"[139, 84, 203, 121, 31, 13, 151, 0, 159, 195, 80, 271, 61, 173, 266, 97, 180, 26, 4, 174, 281, 184, 211, 260, 69, 258, 208]"
217,9,5629,5186,10000,281,2007,3622,"[1060, 1072, 31, 876, 144, 46, 843, 0, 986, 59, 103, 1165, 33, 1200, 925, 254, 479, 525, 234, 378, 277, 321, 764, 925, 113, 1195, 994]"
218,9,6397,5993,10000,404,4891,1506,"[10, 441, 396, 328, 388, 163, 147, 0, 243, 133, 478, 4, 226, 141, 156, 224, 405, 65, 30, 216, 427, 418, 448, 300, 336, 412, 63]"
219,9,5501,6237,9264,0,5089,412,"[103, 136, 71, 41, 105, 55, 102, 0, 6, 117, 54, 132, 75, 76, 40, 24, 71, 77, 61, 21, 96, 94, 15, 23, 124, 114, 97]"
220,9,5298,5271,9291,0,4121,1177,"[352, 177, 93, 154, 85, 64, 107, 0, 68, 209, 1, 109, 200, 337, 58, 143, 103, 364, 175, 374, 19, 254, 318, 99, 107, 102, 321]"
221,9,6684,6004,9971,0,3635,3049,"[117, 135, 358, 832, 540, 989, 433, 0, 576, 524, 674, 111, 132, 940, 616, 21, 872, 11, 241, 300, 513, 125, 386, 648, 793, 78, 18]"
222,9,6639,5778,10000,832,6568,71,"[18, 16, 14, 15, 9, 22, 11, 0, 14, 3, 0, 5, 18, 10, 9, 3, 16, 16, 8, 4, 11, 23, 7, 21, 19, 6, 3]"
223,9,6438,7495,8943,0,4472,1966,"[247, 96, 527, 622, 536, 618, 162, 0, 312, 623, 621, 77, 23, 95, 323, 534, 456, 321, 333, 627, 493, 47, 102, 363, 476, 457, 216]"
224,9,6074,5372,9645,0,2674,3400,"[1071, 862, 109, 284, 6, 876, 5, 0, 570, 930, 911, 1017, 108, 1001, 196, 840, 800, 999, 746, 630, 544, 828, 209, 382, 938, 991, 798]"
225,9,5966,6327,9284,0,4903,1063,"[294, 86, 314, 33, 171, 51, 310, 0, 231, 220, 192, 4, 222, 115, 93, 32, 292, 31, 76, 139, 319, 351, 283, 24, 91, 273, 305]"
226,9,6768,7315,8737,0,5170,1598,"[155, 292, 262, 16, 75, 451, 520, 0, 161, 498, 11, 267, 454, 434, 386, 470, 81, 478, 217, 240, 121, 223, 250, 100, 254, 85, 113]"
227,9,6569,6788,8518,0,674,5895,"[1813, 971, 1380, 1923, 1914, 1361, 1046, 0, 154, 706, 750, 1405, 1000, 1790, 324, 1050, 302, 775, 1577, 1410, 1245, 1143, 285, 556, 1264, 1367, 17]"
228,9,6423,7487,7454,0,1169,5254,"[640, 498, 250, 614, 539, 433, 1130, 0, 659, 1041, 199, 1499, 1552, 547, 334, 108, 1031, 818, 1614, 813, 584, 123, 471, 1029, 1594, 293, 491]"
229,9,6849,7434,6869,0,140,6709,"[1813, 325, 352, 152, 639, 548, 1310, 0, 1032, 211, 575, 1391, 614, 1348, 473, 1650, 1200, 667, 1721, 1011, 1814, 435, 983, 713, 909, 1841, 343]"
230,9,5915,6510,6274,0,4038,1877,"[455, 24, 24, 137, 275, 320, 215, 0, 339, 415, 292, 529, 554, 121, 375, 436, 252, 594, 145, 294, 481, 601, 376, 62, 532, 30, 79]"
231,9,6606,5521,7359,0,5816,790,"[188, 64, 126, 5, 58, 255, 223, 0, 256, 128, 52, 42, 70, 21, 168, 175, 34, 88, 21, 15, 88, 159, 41, 67, 228, 3, 121]"
232,9,6370,5382,8347,0,5185,1185,"[202, 257, 154, 88, 15, 164, 283, 0, 324, 97, 359, 228, 294, 345, 225, 371, 240, 285, 249, 6, 190, 387, 161, 37, 92, 49, 372]"
233,9,6683,7100,7930,0,6436,247,"[9, 11, 71, 14, 19, 65, 46, 0, 63, 5, 69, 28, 41, 49, 41, 73, 47, 25, 66, 14, 13, 81, 20, 72, 62, 25, 36]"
234,9,6654,5550,9034,0,250,6404,"[1266, 1286, 794, 883, 1236, 244, 877, 0, 786, 1507, 2031, 1959, 891, 764, 462, 1961, 1544, 1179, 654, 256, 1615, 1979, 291, 764, 901, 682, 1109]"
235,9,5438,5896,8576,0,3493,1945,"[106, 43, 57, 480, 47, 66, 412, 0, 363, 585, 297, 347, 541, 492, 331, 469, 162, 262, 533, 110, 397, 28, 45, 433, 213, 540, 131]"
236,9,6285,7224,7637,0,473,5812,"[1348, 341, 691, 554, 283, 735, 1614, 0, 1539, 608, 273, 1173, 415, 928, 1724, 1549, 461, 1639, 1505, 393, 1672, 1186, 1310, 1255, 659, 1459, 1866]"
237,9,6644,5541,8740,0,3100,3544,"[727, 135, 455, 212, 900, 506, 871, 0, 650, 992, 808, 78, 640, 904, 397, 1039, 455, 437, 111, 295, 178, 128, 1022, 349, 258, 1108, 804]"
238,9,6282,5994,9028,0,3976,2306,"[349, 698, 231, 627, 176, 201, 605, 0, 185, 464, 178, 235, 490, 383, 269, 751, 291, 445, 3, 166, 575, 220, 139, 650, 123, 358, 713]"
239,9,5914,7091,7851,0,3693,2221,"[685, 76, 431, 477, 424, 353, 389, 0, 678, 289, 422, 55, 293, 450, 339, 569, 366, 415, 682, 270, 531, 464, 628, 392, 152, 242, 245]"
240,9,6505,6148,8208,0,5758,747,"[91, 225, 124, 21, 26, 80, 167, 0, 199, 44, 88, 196, 76, 168, 162, 127, 105, 237, 229, 122, 35, 220, 137, 59, 116, 196, 150]"
241,9,5125,7014,6319,0,1635,3490,"[988, 465, 911, 715, 831, 779, 658, 0, 808, 226, 227, 472, 427, 870, 722, 970, 120, 171, 403, 529, 787, 854, 1013, 973, 849, 384, 957]"
242,9,6297,5253,7363,0,3534,2763,"[563, 679, 561, 475, 529, 486, 536, 0, 820, 849, 0, 308, 347, 389, 522, 6, 290, 676, 645, 395, 396, 871, 610, 166, 849, 524, 606]"
243,9,6067,7262,6168,0,3546,2521,"[209, 272, 344, 158, 752, 593, 156, 0, 602, 805, 600, 369, 581, 703, 142, 686, 481, 571, 567, 304, 48, 39, 679, 28, 606, 465, 755]"
244,9,6161,5084,7245,0,5956,205,"[37, 10, 60, 0, 40, 27, 11, 0, 11, 1, 22, 65, 29, 27, 53, 50, 38, 40, 63, 23, 1, 17, 26, 15, 64, 65, 23]"
245,9,5342,6275,6312,0,39,5303,"[864, 513, 1178, 1355, 146, 1746, 104, 0, 914, 613, 263, 1311, 381, 702, 510, 840, 426, 692, 385, 1083, 1390, 81, 264, 515, 1712, 822, 1645]"
246,9,5071,6124,5259,0,1252,3819,"[1190, 625, 228, 822, 261, 1196, 462, 0, 69, 674, 1117, 697, 1169, 992, 1185, 50, 103, 775, 924, 969, 623, 517, 840, 386, 912, 1204, 697]"
247,9,6579,5645,6193,0,4631,1948,"[568, 168, 55, 85, 576, 2, 600, 0, 173, 400, 480, 636, 530, 59, 262, 481, 407, 463, 492, 119, 278, 198, 471, 500, 68, 194, 338]"
248,9,6065,6434,5824,0,4420,1645,"[172, 91, 484, 276, 132, 44, 388, 0, 322, 529, 418, 65, 424, 379, 96, 434, 13, 298, 404, 514, 487, 147, 33, 94, 476, 294, 499]"
249,9,5747,6829,4742,0,1983,3764,"[1002, 1104, 566, 1189, 1071, 530, 1160, 0, 36, 87, 396, 202, 461, 841, 1138, 1223, 1152, 825, 789, 1165, 509, 827, 1125, 34, 416, 731, 197]"
250,9,5015,4014,5743,0,4630,385,"[19, 24, 45, 8, 79, 37, 14, 0, 48, 64, 48, 45, 4, 54, 110, 59, 103, 23, 114, 59, 94, 86, 45, 96, 77, 81, 97]"
251,9,6831,5478,7096,0,6012,819,"[209, 50, 84, 35, 188, 173, 43, 0, 74, 12, 113, 130, 15, 223, 12, 22, 180, 186, 165, 70, 267, 47, 68, 169, 201, 105, 60]"
252,9,6000,6519,6577,0,791,5209,"[647, 332, 978, 752, 1032, 1545, 1027, 0, 281, 1043, 1691, 1351, 23, 1580, 942, 1727, 356, 850, 1730, 215, 967, 644, 770, 1595, 638, 576, 448]"
253,9,6960,5245,8292,0,252,6708,"[892, 583, 2151, 1937, 1690, 1608, 2001, 0, 1766, 502, 69, 1965, 1238, 704, 1554, 1996, 1266, 810, 1026, 433, 2207, 1456, 785, 154, 1495, 1407, 717]"
254,9,5489,5623,8158,0,1699,3790,"[18, 1080, 923, 611, 593, 43, 712, 0, 259, 875, 927, 356, 820, 588, 718, 764, 1213, 596, 809, 139, 474, 1122, 869, 319, 865, 49, 720]"
255,9,6664,5431,9391,0,544,6120,"[1186, 1437, 576, 867, 646, 132, 1452, 0, 1286, 195, 290, 912, 488, 1533, 641, 531, 1538, 1377, 1265, 1874, 923, 1825, 650, 1053, 353, 976, 781]"
256,9,5661,7269,7783,0,3344,2317,"[395, 730, 68, 132, 163, 765, 278, 0, 414, 213, 769, 177, 402, 300, 522, 534, 401, 153, 349, 408, 60, 351, 578, 491, 692, 86, 292]"
257,9,6279,6208,7854,0,2231,4048,"[466, 444, 847, 609, 700, 831, 871, 0, 1094, 1317, 42, 627, 216, 224, 50, 1015, 497, 551, 1184, 22, 698, 822, 398, 384, 91, 8, 498]"
258,9,5847,7010,6691,0,4400,1447,"[453, 35, 271, 155, 75, 229, 319, 0, 228, 53, 128, 20, 371, 180, 224, 385, 13, 168, 313, 136, 402, 415, 160, 175, 81, 427, 400]"
259,9,6385,6020,7056,0,5092,1293,"[177, 59, 214, 60, 316, 36, 32, 0, 324, 15, 224, 290, 263, 5, 12, 367, 66, 412, 297, 61, 123, 352, 56, 370, 200, 359, 55]"
260,9,5633,7218,5471,0,1893,3740,"[708, 1187, 840, 941, 185, 830, 1033, 0, 41, 168, 1176, 556, 703, 983, 885, 414, 1115, 1246, 1047, 1093, 580, 1171, 399, 725, 291, 488, 1223]"
261,9,6052,7135,4388,0,1095,4957,"[655, 1183, 677, 1067, 721, 365, 216, 0, 494, 518, 281, 952, 603, 244, 1546, 1544, 611, 818, 241, 1212, 1201, 733, 420, 1591, 1220, 744, 1482]"
262,9,5690,3381,6697,0,4445,1245,"[189, 396, 161, 400, 332, 298, 4, 0, 408, 283, 209, 87, 281, 262, 211, 256, 146, 303, 17, 315, 239, 400, 353, 357, 184, 202, 10]"
263,9,6153,7231,5619,0,329,5824,"[140, 1094, 1450, 1323, 706, 811, 1170, 0, 328, 798, 1314, 1382, 604, 1484, 329, 1782, 1511, 111, 850, 1352, 1055, 6, 1802, 875, 29, 1755, 1703]"
264,9,5391,5482,5528,0,4182,1209,"[121, 380, 403, 131, 67, 399, 49, 0, 44, 45, 393, 192, 263, 106, 243, 286, 354, 295, 175, 2, 32, 30, 342, 284, 377, 340, 389]"
265,9,5388,5110,5806,0,4536,852,"[15, 11, 141, 182, 265, 1, 23, 0, 268, 29, 115, 179, 131, 215, 157, 220, 264, 112, 54, 21, 60, 229, 125, 202, 153, 3, 116]"
266,9,5283,5439,5650,0,2510,2773,"[780, 94, 76, 524, 839, 856, 362, 0, 666, 646, 589, 236, 711, 817, 15, 209, 322, 902, 44, 854, 75, 348, 261, 397, 316, 693, 305]"
267,9,5876,7011,4515,0,3073,2803,"[424, 806, 577, 522, 15, 852, 830, 0, 807, 50, 751, 136, 813, 291, 228, 297, 113, 686, 829, 113, 895, 820, 401, 28, 892, 483, 918]"
268,9,5731,3062,7184,0,953,4778,"[567, 644, 933, 1325, 856, 1109, 358, 0, 78, 237, 1006, 7, 1104, 753, 1212, 416, 167, 1364, 83, 161, 393, 1023, 85, 78, 656, 277, 403]"
269,9,6535,6040,7679,0,6326,209,"[10, 44, 41, 41, 22, 65, 55, 0, 54, 8, 46, 51, 60, 31, 63, 14, 52, 59, 33, 54, 8, 33, 65, 27, 7, 62, 11]"
270,9,6596,6504,7771,0,257,6339,"[239, 917, 1576, 764, 247, 1820, 493, 0, 2003, 782, 1403, 182, 1222, 1432, 1434, 1322, 1935, 843, 5, 1802, 852, 1491, 1456, 1241, 817, 1950, 1016]"
271,9,6012,6672,7111,0,5910,102,"[1, 8, 18, 29, 18, 1, 14, 0, 21, 13, 12, 27, 20, 6, 24, 8, 25, 9, 6, 5, 13, 10, 30, 4, 25, 4, 7]"
272,9,5566,6467,6210,0,861,4705,"[835, 1489, 734, 727, 1069, 1128, 837, 0, 419, 92, 1518, 742, 425, 981, 1525, 338, 282, 44, 884, 1062, 400, 743, 73, 1466, 1071, 1338, 37]"
273,9,6330,7212,5328,0,6013,317,"[95, 101, 52, 50, 43, 105, 65, 0, 78, 10, 74, 6, 57, 43, 6, 5, 38, 14, 63, 9, 82, 66, 27, 27, 65, 91, 6]"
274,9,5651,2286,8693,0,252,5399,"[571, 1603, 1087, 655, 1510, 1278, 1180, 0, 423, 1520, 594, 792, 1556, 131, 710, 1143, 1441, 877, 63, 1, 1458, 794, 670, 1390, 1380, 297, 1156]"
275,9,5096,6011,7778,0,732,4364,"[1423, 1303, 109, 514, 383, 1031, 492, 0, 1309, 729, 309, 826, 528, 353, 1436, 1115, 185, 556, 866, 1085, 512, 749, 114, 676, 396, 456, 422]"
276,9,5430,6751,6457,0,4795,635,"[192, 11, 90, 80, 6, 159, 164, 0, 106, 98, 123, 189, 191, 126, 107, 84, 161, 91, 138, 97, 183, 92, 135, 146, 38, 184, 194]"
277,9,6541,6232,6766,0,4296,2245,"[412, 327, 556, 665, 744, 683, 10, 0, 26, 92, 420, 568, 714, 155, 395, 346, 245, 161, 600, 385, 661, 302, 643, 254, 71, 724, 465]"
278,9,6677,6069,7374,0,772,5905,"[1968, 405, 1790, 705, 170, 1898, 154, 0, 1375, 1727, 1548, 1781, 1264, 601, 346, 1627, 508, 904, 180, 398, 1385, 98, 1613, 394, 1786, 1187, 708]"
279,9,6752,6924,7202,0,3770,2982,"[820, 237, 301, 698, 954, 879, 572, 0, 0, 518, 415, 656, 96, 715, 547, 286, 869, 849, 231, 502, 280, 780, 217, 265, 830, 903, 62]"
280,9,5943,7257,5888,0,4452,1491,"[432, 464, 88, 72, 371, 398, 419, 0, 395, 40, 184, 78, 121, 300, 137, 229, 23, 400, 264, 123, 320, 315, 288, 29, 61, 74, 44]"
281,9,6349,5985,6252,0,6011,338,"[72, 1, 35, 14, 20, 34, 39, 0, 71, 33, 51, 35, 47, 62, 25, 51, 15, 78, 79, 106, 93, 29, 94, 66, 33, 98, 37]"
282,9,6956,6914,6294,0,6842,114,"[8, 37, 4, 21, 38, 26, 31, 0, 26, 18, 31, 32, 15, 23, 8, 35, 36, 17, 27, 32, 1, 10, 19, 20, 30, 32, 35]"
283,9,5699,6198,5795,0,4086,1613,"[357, 175, 425, 447, 403, 82, 191, 0, 242, 338, 228, 65, 178, 351, 165, 67, 343, 151, 300, 6, 209, 183, 252, 524, 529, 487, 201]"
284,9,5746,6429,5112,0,180,5566,"[1043, 1187, 457, 397, 950, 993, 1793, 0, 840, 625, 74, 582, 1756, 1186, 1823, 1271, 327, 1755, 677, 1733, 1701, 1008, 112, 857, 588, 1684, 138]"
285,9,6441,6032,5521,0,2774,3667,"[971, 832, 178, 666, 469, 756, 830, 0, 1208, 1007, 554, 653, 585, 465, 118, 203, 651, 283, 686, 1215, 262, 360, 293, 459, 892, 295, 427]"
286,9,5951,6454,5018,0,2644,3307,"[912, 949, 825, 1044, 599, 163, 974, 0, 1054, 991, 485, 74, 521, 750, 393, 647, 531, 257, 952, 10, 840, 384, 735, 517, 681, 213, 113]"
287,9,5876,1887,9007,0,5075,801,"[95, 216, 53, 183, 66, 157, 255, 0, 139, 106, 252, 118, 262, 134, 23, 30, 13, 240, 91, 244, 136, 42, 52, 127, 83, 88, 252]"
288,9,6412,5596,9823,0,5911,501,"[120, 17, 89, 101, 40, 125, 100, 0, 39, 103, 148, 82, 18, 134, 21, 67, 46, 91, 106, 33, 164, 47, 2, 116, 56, 107, 105]"
289,9,5691,7449,8065,0,1251,4440,"[91, 457, 345, 482, 209, 956, 640, 0, 399, 234, 1254, 1208, 1255, 514, 220, 873, 914, 697, 940, 53, 638, 210, 138, 379, 40, 461, 318]"
290,9,5007,5923,7149,0,2795,2212,"[579, 275, 192, 352, 83, 373, 713, 0, 229, 555, 372, 240, 258, 348, 171, 429, 340, 521, 154, 207, 696, 501, 145, 647, 177, 275, 367]"
291,9,5660,5752,7057,0,843,4817,"[1097, 782, 942, 432, 1321, 1531, 651, 0, 861, 264, 1055, 326, 855, 1460, 1513, 1338, 1463, 1280, 1523, 1060, 462, 1173, 1561, 272, 362, 475, 1244]"
292,9,5773,5610,7220,0,2773,3000,"[409, 10, 572, 166, 911, 661, 866, 0, 699, 271, 52, 890, 870, 892, 655, 396, 746, 679, 56, 914, 298, 650, 524, 685, 343, 457, 475]"
293,9,6149,7497,5872,0,1874,4275,"[93, 976, 1187, 1413, 852, 1329, 466, 0, 1329, 1397, 1180, 580, 35, 679, 1192, 295, 659, 143, 1305, 242, 1326, 367, 854, 144, 1350, 277, 1270]"
294,9,6685,5523,7034,0,3331,3354,"[585, 972, 783, 670, 785, 1000, 861, 0, 35, 795, 289, 584, 252, 492, 346, 967, 1024, 172, 393, 518, 1021, 755, 792, 660, 885, 771, 362]"
295,9,5623,7402,5255,0,2919,2704,"[511, 419, 433, 541, 524, 302, 884, 0, 725, 423, 172, 50, 367, 276, 553, 193, 92, 758, 608, 76, 291, 531, 182, 556, 532, 126, 558]"
296,9,6970,7329,4896,0,1158,5812,"[720, 529, 471, 1871, 772, 1243, 1400, 0, 53, 980, 584, 1156, 1446, 1071, 431, 825, 1397, 1872, 1311, 702, 339, 95, 322, 1810, 925, 494, 1147]"
297,9,5114,2533,7477,0,3401,1713,"[524, 327, 40, 496, 59, 406, 173, 0, 440, 324, 343, 427, 342, 397, 185, 79, 384, 183, 270, 209, 414, 113, 230, 414, 538, 2, 121]"
298,9,6531,5230,8778,0,5052,1479,"[44, 448, 177, 470, 228, 205, 383, 0, 488, 155, 166, 424, 157, 328, 73, 414, 275, 87, 474, 178, 259, 145, 382, 415, 145, 397, 267]"
299,9,6858,7250,8386,0,5771,1087,"[287, 71, 250, 294, 247, 118, 315, 0, 246, 186, 42, 235, 107, 55, 84, 11, 63, 14, 33, 70, 319, 202, 47, 56, 305, 213, 195]"
0,10,4221,0,4221,0,128,4093,"[97, 1145, 126, 103, 1287, 230, 419, 1264, 581, 379, 0, 1322, 250, 595, 486, 687, 786, 366, 232, 759, 1126, 1360, 1280, 470, 65, 784, 668]"
1,10,3904,2423,5702,0,752,3152,"[810, 840, 1043, 387, 527, 1049, 951, 327, 607, 580, 0, 871, 233, 679, 383, 276, 455, 848, 449, 180, 377, 322, 266, 711, 487, 387, 923]"
2,10,4996,2359,8339,0,1553,3443,"[316, 767, 443, 134, 479, 833, 501, 494, 471, 181, 0, 92, 861, 366, 813, 1035, 232, 627, 100, 711, 1110, 855, 5, 1018, 967, 576, 781]"
3,10,4286,6177,6448,0,1404,2882,"[191, 955, 17, 20, 43, 31, 802, 475, 153, 541, 0, 580, 698, 855, 527, 355, 302, 859, 161, 178, 127, 464, 788, 635, 523, 685, 731]"
4,10,3659,2836,7271,0,2462,1197,"[27, 280, 72, 214, 383, 121, 244, 281, 15, 295, 0, 57, 284, 36, 132, 134, 361, 3, 374, 16, 11, 226, 94, 95, 120, 168, 111]"
5,10,3717,5,10000,983,280,3437,"[408, 671, 295, 381, 233, 822, 678, 163, 972, 246, 0, 173, 90, 1105, 819, 484, 72, 83, 307, 606, 948, 222, 16, 201, 780, 4, 1036]"
6,10,3604,6789,6815,0,802,2802,"[82, 304, 262, 653, 195, 268, 451, 145, 575, 802, 0, 410, 362, 88, 572, 488, 216, 596, 375, 262, 344, 359, 464, 46, 494, 829, 562]"
7,10,3181,1443,8553,0,1517,1664,"[87, 259, 159, 311, 540, 366, 94, 390, 190, 117, 0, 228, 515, 31, 136, 97, 49, 186, 186, 520, 11, 109, 400, 108, 496, 227, 102]"
8,10,3881,5581,6853,0,2048,1833,"[526, 29, 290, 72, 382, 69, 534, 495, 141, 169, 0, 36, 334, 86, 520, 89, 597, 153, 188, 20, 13, 141, 352, 83, 276, 448, 159]"
9,10,4532,7073,4312,0,3833,699,"[75, 201, 230, 168, 21, 205, 86, 109, 94, 227, 0, 178, 73, 148, 122, 224, 133, 198, 212, 69, 130, 93, 117, 135, 139, 77, 137]"
10,10,4402,2357,6357,0,3257,1145,"[371, 380, 187, 292, 110, 215, 56, 247, 152, 341, 0, 108, 18, 331, 187, 303, 347, 174, 78, 70, 323, 371, 50, 182, 377, 376, 354]"
11,10,3418,339,9436,0,979,2439,"[639, 294, 261, 799, 699, 130, 614, 564, 115, 809, 0, 690, 447, 109, 91, 426, 528, 256, 190, 132, 618, 592, 638, 143, 318, 324, 294]"
12,10,4578,6484,7530,0,3653,925,"[4, 30, 164, 61, 111, 96, 19, 150, 89, 217, 0, 121, 114, 38, 50, 73, 297, 98, 237, 245, 221, 285, 188, 57, 56, 119, 244]"
13,10,4288,5651,6167,0,3874,414,"[67, 73, 14, 65, 125, 72, 45, 90, 54, 66, 0, 8, 102, 35, 67, 102, 49, 77, 115, 88, 7, 111, 91, 103, 18, 23, 39]"
14,10,3698,2643,7222,0,435,3263,"[216, 1064, 351, 211, 1005, 790, 972, 220, 973, 1036, 0, 508, 518, 893, 239, 91, 457, 1011, 691, 583, 566, 407, 629, 350, 98, 1015, 688]"
15,10,3259,2798,7683,0,437,2822,"[614, 328, 322, 799, 277, 679, 645, 200, 712, 606, 0, 641, 777, 708, 576, 275, 486, 607, 291, 865, 649, 534, 224, 283, 917, 701, 295]"
16,10,3442,6648,4477,0,2252,1190,"[163, 347, 283, 342, 208, 102, 149, 251, 325, 73, 0, 357, 192, 39, 238, 114, 314, 182, 320, 353, 225, 12, 300, 44, 118, 205, 183]"
17,10,4604,3632,5449,0,3748,856,"[240, 131, 182, 231, 205, 66, 13, 17, 114, 278, 0, 150, 112, 152, 125, 9, 85, 267, 193, 68, 5, 29, 122, 29, 263, 80, 82]"
18,10,4879,1099,9229,0,4356,523,"[25, 6, 171, 18, 135, 156, 19, 48, 148, 113, 0, 53, 70, 133, 41, 101, 146, 35, 93, 154, 111, 106, 98, 70, 109, 41, 76]"
19,10,3529,5741,7017,0,484,3045,"[344, 638, 124, 771, 939, 208, 342, 477, 851, 406, 0, 740, 428, 327, 833, 612, 708, 311, 904, 109, 445, 801, 658, 810, 646, 654, 416]"
20,10,4870,5810,6077,0,4734,136,"[35, 40, 43, 6, 23, 2, 13, 25, 20, 22, 0, 33, 4, 24, 42, 39, 33, 20, 29, 5, 37, 11, 3, 11, 1, 43, 23]"
21,10,3486,962,8601,0,2809,677,"[173, 174, 160, 39, 142, 169, 224, 147, 53, 223, 0, 30, 62, 26, 216, 111, 6, 109, 181, 93, 159, 142, 98, 70, 177, 12, 198]"
22,10,3077,7006,4672,0,323,2754,"[38, 263, 697, 3, 435, 711, 842, 446, 211, 137, 0, 835, 153, 190, 290, 626, 845, 378, 738, 51, 354, 353, 817, 537, 192, 851, 900]"
23,10,3293,3132,4833,0,2173,1120,"[123, 228, 123, 263, 79, 2, 258, 327, 352, 265, 0, 286, 269, 68, 315, 262, 101, 239, 163, 218, 317, 79, 122, 227, 230, 299, 360]"
24,10,4005,2754,6084,0,518,3487,"[446, 1084, 321, 627, 868, 354, 227, 816, 882, 307, 0, 1054, 1100, 115, 1143, 927, 311, 891, 1050, 780, 202, 517, 696, 633, 233, 496, 904]"
25,10,4269,3598,6755,0,4217,52,"[11, 10, 12, 0, 7, 15, 0, 13, 9, 7, 0, 15, 11, 10, 13, 14, 8, 13, 6, 5, 17, 6, 12, 12, 16, 17, 2]"
26,10,4770,7165,4360,0,1344,3426,"[1129, 1053, 856, 760, 144, 1072, 812, 389, 632, 416, 0, 786, 240, 845, 902, 722, 419, 960, 353, 554, 464, 957, 280, 139, 902, 940, 232]"
27,10,4375,1865,6870,0,678,3697,"[185, 91, 475, 205, 1002, 217, 590, 712, 459, 524, 0, 905, 460, 1087, 1218, 257, 1136, 137, 695, 907, 454, 1004, 0, 1011, 919, 54, 1134]"
28,10,4988,6836,5022,0,756,4232,"[675, 1323, 490, 575, 1165, 1019, 385, 960, 444, 38, 0, 355, 1273, 1025, 1154, 1099, 1200, 180, 24, 902, 1131, 1121, 434, 45, 447, 1064, 927]"
29,10,3725,396,8351,0,2262,1463,"[3, 56, 44, 147, 59, 214, 30, 28, 187, 129, 0, 332, 57, 481, 406, 487, 461, 411, 81, 170, 137, 122, 32, 133, 27, 458, 237]"
30,10,4892,6774,6469,0,2519,2373,"[69, 20, 667, 739, 465, 520, 633, 684, 17, 490, 0, 491, 490, 519, 681, 511, 307, 580, 113, 496, 231, 344, 55, 373, 202, 640, 574]"
31,10,3931,591,9809,0,1720,2211,"[454, 695, 437, 280, 713, 52, 252, 429, 243, 312, 0, 132, 11, 704, 245, 250, 540, 633, 693, 418, 363, 153, 123, 35, 132, 688, 15]"
32,10,3639,5990,7458,0,659,2980,"[251, 229, 407, 169, 507, 733, 405, 268, 765, 629, 0, 467, 743, 853, 461, 954, 596, 198, 746, 632, 783, 41, 888, 756, 288, 482, 596]"
33,10,4416,5844,6030,0,1078,3338,"[280, 95, 169, 295, 124, 771, 118, 421, 929, 553, 0, 37, 116, 184, 176, 822, 76, 20, 636, 571, 444, 640, 468, 630, 898, 740, 77]"
34,10,3086,2312,6804,0,1154,1932,"[227, 615, 633, 458, 75, 591, 68, 470, 125, 466, 0, 71, 558, 168, 199, 222, 455, 116, 458, 528, 280, 222, 47, 597, 36, 256, 618]"
35,10,4417,5583,5638,0,470,3947,"[404, 1150, 42, 284, 594, 1286, 1092, 560, 456, 722, 0, 216, 363, 1054, 1254, 1038, 1071, 61, 19, 1221, 519, 956, 1063, 68, 460, 692, 35]"
36,10,3404,3366,5676,0,1217,2187,"[540, 433, 271, 160, 278, 488, 396, 260, 506, 726, 0, 130, 110, 434, 483, 492, 410, 124, 56, 688, 438, 688, 280, 391, 391, 293, 330]"
37,10,4929,908,9697,0,2128,2801,"[346, 804, 30, 32, 705, 459, 408, 733, 427, 406, 0, 820, 176, 687, 144, 657, 548, 537, 914, 826, 600, 702, 905, 769, 877, 68, 511]"
38,10,4585,7234,7048,0,2974,1611,"[196, 126, 84, 84, 491, 163, 99, 48, 181, 22, 0, 409, 242, 233, 302, 37, 79, 388, 165, 374, 387, 81, 58, 472, 364, 422, 5]"
39,10,3449,2786,7711,0,3080,369,"[89, 46, 123, 64, 78, 61, 71, 115, 48, 56, 0, 26, 110, 90, 77, 61, 96, 64, 36, 11, 34, 91, 101, 10, 101, 83, 76]"
40,10,3394,5162,5943,0,3128,266,"[67, 75, 83, 62, 27, 85, 54, 52, 42, 76, 0, 41, 9, 75, 52, 29, 11, 84, 58, 39, 82, 50, 0, 88, 57, 43, 66]"
41,10,4705,1412,9236,0,3790,915,"[168, 147, 165, 115, 113, 22, 230, 263, 107, 126, 0, 34, 283, 169, 274, 237, 16, 106, 64, 7, 304, 137, 50, 260, 196, 84, 0]"
42,10,4471,6711,6996,0,308,4163,"[682, 73, 808, 1031, 1113, 1353, 762, 718, 212, 125, 0, 156, 398, 957, 918, 652, 176, 597, 1377, 332, 1149, 1387, 559, 1164, 38, 265, 1219]"
43,10,4916,6075,5837,0,1631,3285,"[299, 1083, 649, 337, 935, 599, 632, 1092, 442, 751, 0, 757, 387, 254, 739, 629, 1059, 677, 898, 368, 262, 1033, 351, 509, 158, 34, 404]"
44,10,4889,2891,7835,0,556,4333,"[468, 617, 1244, 99, 542, 485, 974, 640, 261, 752, 0, 1052, 642, 266, 477, 679, 1339, 1291, 805, 787, 694, 1195, 790, 284, 949, 588, 892]"
45,10,4196,6289,5742,0,3339,857,"[27, 43, 123, 113, 220, 10, 25, 151, 67, 223, 0, 43, 244, 52, 125, 119, 222, 110, 281, 173, 192, 281, 211, 105, 187, 127, 262]"
46,10,3078,1270,7550,0,2663,415,"[11, 93, 76, 133, 37, 35, 64, 63, 61, 127, 0, 124, 122, 11, 92, 50, 132, 61, 75, 52, 99, 5, 75, 135, 136, 21, 122]"
47,10,4477,7311,4716,0,2188,2289,"[124, 126, 104, 440, 480, 686, 183, 576, 761, 687, 0, 77, 718, 717, 489, 212, 193, 649, 343, 10, 739, 740, 759, 240, 746, 167, 567]"
48,10,3298,397,7617,0,1531,1767,"[311, 560, 203, 522, 65, 88, 496, 61, 364, 156, 0, 253, 8, 267, 171, 72, 469, 531, 173, 192, 23, 321, 429, 415, 207, 481, 365]"
49,10,3230,1080,9767,0,3224,6,"[2, 2, 2, 1, 1, 2, 1, 2, 1, 0, 0, 1, 0, 1, 0, 0, 0, 2, 2, 0, 0, 0, 1, 2, 2, 1, 0]"
50,10,4368,6452,7683,0,1711,2657,"[688, 460, 295, 568, 585, 183, 450, 542, 693, 500, 0, 342, 452, 394, 785, 794, 604, 843, 344, 719, 608, 866, 880, 234, 563, 129, 181]"
51,10,4074,6654,5103,0,3254,820,"[95, 160, 133, 234, 82, 97, 173, 47, 246, 1, 0, 196, 220, 205, 189, 81, 139, 83, 205, 135, 39, 10, 70, 27, 196, 0, 0]"
52,10,4884,99,9888,0,1459,3425,"[601, 335, 299, 1029, 185, 38, 681, 553, 737, 677, 0, 675, 908, 360, 61, 410, 1011, 472, 1125, 1077, 757, 204, 595, 198, 161, 1064, 3]"
53,10,3869,6178,7579,0,1644,2225,"[56, 115, 280, 201, 144, 699, 597, 225, 375, 302, 0, 203, 448, 360, 261, 327, 623, 132, 7, 635, 86, 643, 665, 488, 152, 725, 509]"
54,10,4536,5957,6158,0,59,4477,"[622, 441, 626, 454, 67, 667, 580, 385, 435, 194, 0, 667, 1052, 1435, 1327, 917, 1300, 126, 767, 909, 796, 874, 733, 1203, 404, 1193, 1040]"
55,10,3522,42,9638,0,231,3291,"[86, 296, 720, 75, 826, 27, 241, 1039, 981, 1049, 0, 1011, 809, 531, 99, 170, 670, 385, 367, 481, 699, 1014, 993, 639, 641, 165, 1000]"
56,10,4399,6101,7936,0,422,3977,"[45, 240, 1213, 459, 451, 364, 988, 127, 449, 1301, 0, 199, 1310, 167, 110, 807, 147, 557, 887, 285, 791, 1028, 1091, 1000, 1046, 144, 540]"
57,10,4791,7093,5634,0,719,4072,"[250, 1095, 1134, 1214, 646, 580, 862, 954, 611, 773, 0, 85, 1039, 485, 1213, 822, 1123, 545, 976, 1178, 1035, 206, 155, 946, 74, 980, 1031]"
58,10,3566,2,9198,0,3192,374,"[124, 91, 41, 108, 53, 13, 80, 27, 93, 120, 0, 44, 54, 122, 32, 53, 109, 89, 114, 87, 74, 121, 4, 64, 23, 12, 62]"
59,10,4870,7163,6905,0,4809,61,"[8, 0, 10, 0, 9, 2, 7, 5, 16, 15, 0, 6, 7, 18, 9, 17, 12, 13, 20, 11, 11, 6, 8, 11, 19, 5, 5]"
60,10,3360,2459,7806,0,1739,1621,"[351, 162, 323, 432, 117, 367, 466, 111, 182, 15, 0, 491, 122, 486, 8, 60, 68, 442, 68, 519, 416, 44, 152, 79, 475, 135, 87]"
61,10,4585,7004,5387,0,1830,2755,"[211, 247, 809, 171, 12, 769, 820, 249, 418, 808, 0, 810, 390, 587, 42, 746, 317, 806, 687, 763, 620, 470, 758, 109, 817, 341, 322]"
62,10,4449,4019,5817,0,2548,1901,"[624, 142, 201, 248, 533, 54, 298, 239, 573, 262, 0, 262, 144, 376, 588, 491, 491, 111, 614, 60, 596, 184, 70, 17, 492, 537, 28]"
63,10,4654,3877,6594,0,2763,1891,"[434, 592, 194, 409, 505, 145, 310, 117, 294, 152, 0, 507, 258, 43, 576, 354, 350, 0, 426, 197, 551, 292, 335, 426, 46, 39, 560]"
64,10,3240,2403,7431,0,1643,1597,"[214, 333, 289, 4, 169, 15, 79, 230, 14, 330, 0, 326, 456, 303, 14, 492, 401, 254, 527, 46, 478, 351, 156, 14, 100, 435, 502]"
65,10,3869,5481,5819,0,3074,795,"[98, 146, 151, 100, 209, 29, 203, 78, 14, 138, 0, 262, 158, 1, 173, 210, 201, 39, 247, 44, 230, 66, 34, 7, 159, 38, 130]"
66,10,3157,2044,6932,0,632,2525,"[565, 291, 516, 92, 755, 197, 445, 814, 273, 554, 0, 39, 508, 695, 214, 648, 464, 188, 97, 32, 199, 77, 217, 434, 377, 762, 534]"
67,10,3945,2143,8734,0,3113,832,"[157, 170, 12, 109, 176, 157, 266, 133, 106, 240, 0, 109, 46, 193, 144, 176, 105, 230, 78, 151, 44, 32, 112, 150, 15, 246, 109]"
68,10,3033,5240,6527,0,2105,928,"[276, 163, 66, 167, 24, 245, 195, 261, 264, 100, 0, 195, 288, 195, 205, 178, 254, 102, 31, 185, 100, 68, 91, 48, 164, 137, 234]"
69,10,3210,1631,8106,0,1314,1896,"[239, 445, 630, 620, 395, 295, 514, 323, 316, 122, 0, 316, 301, 60, 493, 55, 279, 592, 204, 398, 631, 577, 542, 92, 530, 174, 344]"
70,10,3173,5864,5415,0,2673,500,"[124, 85, 149, 44, 47, 117, 141, 30, 32, 10, 0, 94, 159, 28, 69, 28, 124, 69, 29, 50, 127, 16, 148, 67, 87, 42, 143]"
71,10,4308,1669,8054,0,4083,225,"[58, 30, 70, 59, 54, 72, 6, 34, 50, 17, 0, 27, 26, 40, 23, 57, 50, 47, 33, 2, 19, 28, 11, 23, 34, 73, 63]"
72,10,4718,7279,5493,0,2581,2137,"[29, 519, 669, 576, 196, 365, 607, 666, 525, 67, 0, 453, 78, 316, 698, 115, 660, 553, 142, 170, 88, 264, 419, 303, 304, 104, 115]"
73,10,4897,2860,7530,0,484,4413,"[1000, 1355, 376, 1434, 1063, 1062, 1414, 941, 395, 103, 0, 824, 270, 662, 190, 188, 393, 35, 228, 1396, 81, 620, 1240, 990, 286, 477, 747]"
74,10,4874,5658,6746,0,1327,3547,"[847, 631, 839, 889, 1077, 953, 1154, 54, 804, 1054, 0, 244, 1063, 183, 592, 991, 490, 317, 618, 1110, 989, 202, 863, 200, 1005, 306, 413]"
75,10,3432,1846,8332,0,3340,92,"[2, 21, 14, 3, 9, 19, 10, 11, 27, 17, 0, 24, 25, 26, 12, 27, 18, 13, 12, 4, 2, 20, 26, 16, 6, 29, 9]"
76,10,4396,5430,7298,0,4260,136,"[14, 43, 14, 0, 44, 20, 15, 39, 19, 11, 0, 34, 27, 20, 19, 36, 21, 44, 10, 9, 41, 8, 37, 17, 20, 21, 17]"
77,10,3495,1486,9307,0,689,2806,"[323, 744, 917, 776, 185, 891, 95, 884, 882, 204, 0, 119, 776, 356, 523, 224, 250, 295, 747, 350, 439, 242, 696, 215, 646, 327, 620]"
78,10,3965,6143,7129,0,1721,2244,"[145, 126, 520, 188, 493, 320, 332, 56, 321, 663, 0, 434, 208, 385, 392, 632, 726, 356, 30, 531, 302, 381, 392, 726, 638, 602, 268]"
79,10,3557,363,10000,323,818,2739,"[123, 103, 755, 822, 646, 233, 33, 164, 590, 104, 0, 489, 544, 899, 872, 569, 539, 98, 238, 149, 690, 469, 853, 763, 3, 197, 263]"
80,10,3686,7459,6227,0,353,3333,"[239, 646, 574, 138, 1087, 28, 739, 1025, 485, 1026, 0, 251, 142, 752, 1080, 712, 1062, 15, 913, 1108, 647, 264, 372, 118, 932, 280, 1010]"
81,10,4444,578,10000,93,4032,412,"[59, 104, 111, 10, 75, 71, 62, 119, 104, 17, 0, 124, 10, 84, 25, 85, 16, 22, 83, 101, 53, 43, 82, 99, 39, 8, 79]"
82,10,3192,6152,7040,0,2707,485,"[35, 54, 105, 64, 5, 130, 70, 59, 23, 17, 0, 87, 130, 150, 47, 38, 140, 121, 57, 96, 103, 108, 76, 86, 44, 16, 16]"
83,10,3461,1804,8697,0,1713,1748,"[187, 498, 399, 289, 498, 218, 116, 448, 353, 91, 0, 379, 332, 443, 179, 46, 453, 305, 384, 97, 104, 71, 113, 489, 396, 379, 455]"
84,10,4643,5139,8201,0,802,3841,"[917, 568, 548, 344, 100, 438, 28, 960, 1038, 1140, 0, 724, 610, 822, 57, 558, 332, 436, 965, 663, 307, 902, 1051, 769, 1054, 360, 189]"
85,10,4587,5953,6835,0,2556,2031,"[137, 183, 609, 412, 196, 206, 192, 289, 493, 618, 0, 132, 676, 576, 115, 384, 371, 362, 483, 407, 486, 510, 327, 23, 649, 608, 495]"
86,10,4878,5229,6484,0,2127,2751,"[544, 66, 396, 768, 57, 575, 468, 815, 224, 371, 0, 857, 433, 490, 379, 399, 917, 521, 491, 450, 569, 351, 805, 56, 878, 564, 480]"
87,10,3206,9,9681,0,1523,1683,"[475, 17, 139, 80, 343, 203, 418, 203, 182, 360, 0, 158, 18, 247, 51, 450, 275, 361, 156, 289, 278, 329, 70, 112, 493, 113, 170]"
88,10,3244,7081,5844,0,288,2956,"[797, 143, 724, 184, 148, 492, 464, 923, 820, 643, 0, 369, 244, 30, 7, 507, 108, 969, 593, 801, 830, 280, 598, 437, 91, 278, 629]"
89,10,3655,2236,7263,0,2006,1649,"[376, 417, 476, 441, 203, 202, 449, 392, 487, 329, 0, 132, 414, 530, 426, 364, 474, 30, 203, 311, 236, 171, 480, 272, 333, 101, 435]"
90,10,3472,2604,8131,0,1078,2394,"[244, 571, 426, 533, 691, 371, 536, 32, 681, 203, 0, 35, 571, 778, 394, 485, 578, 221, 433, 239, 305, 175, 73, 693, 712, 555, 745]"
91,10,4215,6950,5396,0,2760,1455,"[183, 425, 166, 475, 232, 39, 378, 236, 429, 357, 0, 480, 243, 20, 359, 378, 297, 208, 179, 406, 27, 346, 50, 206, 134, 144, 65]"
92,10,3538,2090,6844,0,438,3100,"[580, 842, 149, 367, 854, 205, 648, 63, 566, 750, 0, 181, 290, 1020, 417, 489, 553, 463, 10, 478, 647, 0, 718, 417, 688, 519, 667]"
93,10,3501,1922,8423,0,2101,1400,"[223, 285, 343, 46, 189, 273, 112, 163, 112, 255, 0, 182, 373, 455, 269, 79, 136, 257, 17, 260, 275, 14, 146, 133, 282, 129, 280]"
94,10,4804,6042,7185,0,3973,831,"[225, 201, 18, 155, 151, 250, 243, 21, 157, 178, 0, 180, 249, 246, 205, 173, 41, 268, 92, 36, 239, 268, 162, 124, 52, 257, 222]"
95,10,3952,6104,5033,0,2893,1059,"[334, 236, 235, 220, 95, 272, 117, 332, 343, 125, 0, 30, 74, 125, 8, 205, 184, 235, 181, 96, 337, 287, 251, 256, 134, 219, 103]"
96,10,3545,697,7881,0,2200,1345,"[26, 221, 216, 143, 170, 333, 148, 129, 0, 284, 0, 393, 358, 99, 85, 353, 58, 18, 106, 24, 406, 260, 401, 444, 443, 204, 264]"
97,10,4951,7411,5421,0,2490,2461,"[357, 498, 789, 449, 231, 766, 410, 111, 88, 23, 0, 416, 394, 371, 778, 429, 613, 261, 769, 503, 43, 744, 205, 112, 306, 781, 66]"
98,10,3500,2757,6164,0,2378,1122,"[320, 49, 43, 5, 87, 186, 284, 1, 195, 232, 0, 98, 164, 161, 120, 1, 171, 101, 203, 149, 0, 86, 369, 219, 364, 314, 336]"
99,10,3475,1216,8423,0,2285,1190,"[205, 164, 158, 198, 131, 272, 226, 101, 179, 72, 0, 116, 342, 119, 79, 20, 325, 38, 55, 221, 65, 343, 179, 337, 244, 237, 55]"
100,10,4756,6232,6947,0,3642,1114,"[5, 251, 368, 361, 324, 0, 155, 157, 82, 5, 0, 210, 85, 258, 187, 63, 240, 36, 117, 61, 147, 23, 316, 69, 331, 256, 251]"
101,10,3132,1868,8211,0,402,2730,"[158, 884, 595, 756, 508, 143, 158, 274, 449, 116, 0, 852, 763, 673, 799, 383, 28, 882, 414, 413, 44, 813, 674, 515, 328, 824, 321]"
102,10,4422,6159,6474,0,993,3429,"[535, 371, 573, 417, 175, 919, 667, 804, 251, 800, 0, 412, 857, 557, 768, 497, 592, 1090, 991, 900, 351, 983, 532, 1117, 224, 1092, 213]"
103,10,3547,2857,7164,0,2305,1242,"[167, 56, 248, 369, 28, 389, 349, 350, 348, 212, 0, 101, 41, 238, 12, 389, 118, 311, 324, 138, 64, 278, 222, 281, 289, 316, 22]"
104,10,3773,738,10000,199,1284,2489,"[611, 78, 223, 613, 19, 794, 364, 124, 720, 720, 0, 2, 496, 525, 246, 773, 3, 632, 24, 14, 545, 701, 43, 600, 357, 631, 691]"
105,10,4039,5168,8871,0,163,3876,"[351, 562, 160, 888, 1136, 333, 921, 805, 890, 1214, 0, 786, 950, 1185, 556, 323, 235, 900, 475, 504, 707, 723, 345, 906, 1175, 645, 254]"
106,10,4548,6137,7282,0,182,4366,"[1296, 1043, 237, 1046, 82, 220, 1103, 536, 93, 1437, 0, 1058, 1248, 746, 1185, 1174, 1349, 377, 1267, 343, 143, 701, 804, 1050, 775, 539, 371]"
107,10,4685,5383,6584,0,2259,2426,"[192, 621, 449, 306, 45, 300, 206, 550, 649, 649, 0, 594, 618, 455, 620, 806, 461, 532, 236, 376, 163, 571, 265, 15, 113, 644, 63]"
108,10,4736,6159,5161,0,3680,1056,"[151, 65, 116, 325, 115, 11, 225, 163, 286, 52, 0, 152, 258, 8, 108, 314, 327, 39, 0, 199, 124, 275, 232, 141, 296, 224, 89]"
109,10,4955,26,10000,90,3117,1838,"[512, 427, 5, 213, 85, 532, 490, 499, 557, 364, 0, 69, 409, 327, 448, 439, 321, 376, 93, 155, 484, 159, 246, 80, 357, 414, 68]"
110,10,4634,5465,9169,0,1864,2770,"[460, 372, 437, 789, 632, 543, 643, 808, 811, 549, 0, 631, 533, 807, 213, 161, 830, 462, 747, 800, 123, 203, 912, 68, 71, 712, 494]"
111,10,4458,5982,7645,0,1024,3434,"[637, 1016, 650, 528, 1098, 656, 721, 868, 1059, 243, 0, 336, 703, 364, 922, 1135, 656, 995, 1003, 401, 1016, 949, 1018, 932, 379, 375, 470]"
112,10,3587,6837,4395,0,67,3520,"[515, 1160, 1166, 1020, 406, 1095, 926, 376, 593, 74, 0, 671, 380, 554, 544, 983, 538, 113, 457, 550, 455, 1171, 189, 196, 755, 485, 541]"
113,10,3591,1313,6673,0,1024,2567,"[738, 728, 417, 639, 782, 588, 391, 726, 498, 776, 0, 599, 809, 447, 528, 595, 129, 518, 706, 52, 785, 315, 113, 209, 342, 425, 825]"
114,10,4494,6425,4742,0,516,3978,"[316, 17, 692, 665, 880, 383, 1145, 237, 91, 407, 0, 643, 431, 1015, 578, 1292, 754, 1023, 1214, 91, 1022, 100, 818, 253, 868, 419, 384]"
115,10,4502,3193,6051,0,1343,3159,"[112, 920, 626, 568, 322, 344, 26, 318, 104, 293, 0, 399, 1011, 5, 591, 769, 315, 617, 772, 630, 827, 1044, 637, 410, 850, 938, 563]"
116,10,3337,939,8449,0,2944,393,"[100, 53, 22, 30, 27, 19, 33, 22, 62, 112, 0, 43, 104, 91, 51, 129, 23, 103, 113, 95, 14, 13, 54, 123, 64, 79, 54]"
117,10,3436,6109,5776,0,470,2966,"[336, 474, 498, 102, 152, 890, 226, 496, 136, 228, 0, 752, 443, 622, 683, 768, 475, 221, 34, 242, 948, 16, 965, 812, 908, 857, 212]"
118,10,3085,2172,6689,0,1515,1570,"[102, 434, 181, 443, 470, 469, 9, 440, 122, 193, 0, 376, 133, 444, 27, 388, 401, 242, 170, 78, 134, 506, 409, 402, 166, 507, 217]"
119,10,4216,375,10000,530,3419,797,"[84, 168, 244, 39, 34, 172, 190, 189, 166, 81, 0, 217, 56, 224, 46, 249, 83, 140, 210, 74, 250, 128, 126, 249, 215, 124, 50]"
120,10,3265,6238,7027,0,3037,228,"[64, 59, 4, 19, 52, 10, 74, 51, 45, 50, 0, 22, 15, 74, 13, 43, 51, 16, 38, 54, 17, 70, 65, 34, 56, 19, 58]"
121,10,3204,1694,8537,0,2905,299,"[26, 33, 8, 86, 92, 2, 1, 66, 76, 11, 0, 68, 84, 7, 67, 85, 6, 91, 91, 48, 62, 67, 50, 60, 31, 80, 40]"
122,10,3858,6331,6064,0,2127,1731,"[268, 24, 158, 162, 406, 488, 510, 131, 362, 323, 0, 273, 412, 275, 93, 227, 157, 88, 150, 298, 356, 473, 99, 381, 288, 91, 103]"
123,10,4523,4163,6424,0,4090,433,"[56, 121, 40, 67, 63, 98, 84, 39, 90, 72, 0, 68, 66, 108, 12, 12, 133, 110, 38, 94, 29, 36, 43, 117, 45, 78, 75]"
124,10,3702,3493,6633,0,260,3442,"[775, 636, 826, 177, 272, 931, 664, 228, 85, 586, 0, 884, 626, 584, 299, 1013, 578, 408, 529, 542, 158, 1105, 704, 741, 424, 441, 699]"
125,10,3920,2578,7975,0,1099,2821,"[775, 613, 869, 489, 571, 898, 338, 561, 315, 422, 0, 33, 646, 661, 401, 417, 504, 255, 386, 175, 153, 392, 536, 883, 81, 274, 760]"
126,10,3016,618,10000,373,510,2506,"[133, 791, 172, 594, 146, 26, 111, 197, 177, 813, 0, 733, 334, 698, 709, 470, 428, 76, 126, 112, 145, 12, 532, 359, 433, 685, 424]"
127,10,3018,6288,6730,0,390,2628,"[802, 110, 64, 742, 657, 134, 392, 256, 266, 313, 0, 839, 770, 320, 531, 722, 247, 110, 856, 432, 613, 761, 359, 412, 387, 142, 448]"
128,10,4770,7140,4360,0,1100,3670,"[334, 842, 642, 158, 553, 795, 971, 1051, 1146, 861, 0, 62, 249, 452, 158, 1112, 93, 945, 1182, 1096, 272, 700, 279, 21, 1144, 38, 292]"
129,10,4691,2086,6965,0,2654,2037,"[436, 278, 510, 473, 576, 620, 391, 242, 328, 134, 0, 109, 614, 11, 20, 166, 591, 160, 389, 249, 4, 159, 455, 159, 485, 504, 285]"
130,10,4766,6021,5710,0,3361,1405,"[336, 293, 168, 378, 450, 243, 10, 342, 360, 277, 0, 267, 185, 225, 399, 296, 240, 73, 7, 371, 397, 141, 186, 38, 313, 41, 227]"
131,10,3467,3223,5954,0,297,3170,"[460, 110, 16, 1050, 66, 197, 115, 422, 869, 234, 0, 672, 237, 58, 897, 346, 260, 723, 234, 263, 782, 100, 715, 221, 511, 459, 671]"
132,10,3446,2138,7262,0,3293,153,"[25, 46, 26, 43, 23, 39, 28, 16, 13, 5, 0, 42, 48, 40, 14, 36, 47, 16, 13, 32, 51, 51, 42, 30, 51, 37, 5]"
133,10,3006,1246,9022,0,1086,1920,"[303, 250, 624, 22, 571, 638, 232, 97, 432, 407, 0, 433, 502, 480, 454, 104, 473, 36, 335, 246, 525, 100, 310, 5, 394, 565, 17]"
134,10,3831,6184,6669,0,2542,1289,"[39, 336, 379, 58, 285, 41, 366, 271, 95, 110, 0, 277, 237, 271, 137, 294, 99, 298, 156, 310, 310, 347, 216, 349, 131, 330, 322]"
135,10,4855,5908,5616,0,2122,2733,"[853, 587, 110, 749, 543, 492, 767, 7, 817, 568, 0, 730, 854, 342, 524, 793, 702, 663, 417, 462, 319, 727, 509, 689, 624, 524, 306]"
136,10,4765,2083,8298,0,3998,767,"[129, 120, 108, 217, 196, 67, 17, 173, 111, 38, 0, 141, 202, 115, 94, 244, 194, 9, 197, 44, 165, 62, 56, 196, 140, 91, 25]"
137,10,4600,7380,5518,0,3723,877,"[66, 210, 213, 268, 121, 134, 234, 131, 78, 20, 0, 286, 2, 100, 16, 42, 223, 195, 200, 45, 105, 57, 221, 156, 270, 113, 136]"
138,10,4839,2971,7386,0,2431,2408,"[774, 713, 231, 270, 493, 789, 68, 620, 762, 336, 0, 50, 729, 712, 690, 570, 330, 430, 157, 6, 301, 213, 753, 741, 648, 194, 446]"
139,10,4661,5583,6464,0,1666,2995,"[882, 764, 742, 939, 175, 133, 40, 633, 355, 689, 0, 961, 175, 640, 235, 86, 445, 397, 564, 544, 907, 939, 292, 985, 267, 370, 918]"
140,10,4374,2257,8581,0,2346,2028,"[30, 324, 54, 579, 403, 572, 410, 168, 117, 230, 0, 343, 311, 278, 615, 388, 355, 248, 339, 275, 187, 362, 648, 74, 77, 505, 582]"
141,10,4648,6007,7222,0,4092,556,"[110, 94, 156, 146, 97, 64, 74, 68, 100, 71, 0, 52, 92, 67, 48, 9, 181, 5, 84, 76, 111, 1, 115, 146, 177, 74, 138]"
142,10,3848,7276,3794,0,3503,345,"[19, 12, 45, 71, 14, 91, 39, 51, 6, 90, 0, 88, 114, 78, 57, 10, 66, 80, 16, 26, 10, 82, 29, 61, 50, 104, 75]"
143,10,3008,1453,5349,0,1449,1559,"[149, 70, 51, 286, 504, 333, 106, 90, 8, 400, 0, 367, 77, 239, 8, 214, 167, 275, 139, 259, 516, 21, 9, 71, 338, 306, 186]"
144,10,4476,747,9078,0,1523,2953,"[554, 903, 295, 605, 175, 197, 547, 255, 232, 93, 0, 641, 121, 614, 624, 359, 237, 451, 479, 61, 703, 287, 364, 877, 901, 302, 973]"
145,10,4291,6221,7148,0,3040,1251,"[269, 401, 12, 156, 292, 308, 256, 311, 114, 107, 0, 303, 408, 40, 294, 347, 343, 401, 314, 7, 115, 0, 33, 98, 246, 119, 266]"
146,10,4142,6140,5150,0,2252,1890,"[392, 392, 488, 349, 171, 405, 137, 546, 536, 582, 0, 560, 12, 544, 267, 124, 38, 240, 74, 145, 73, 594, 35, 10, 75, 102, 89]"
147,10,3089,2681,5558,0,2764,325,"[30, 71, 61, 54, 12, 78, 67, 38, 37, 108, 0, 86, 102, 97, 81, 99, 20, 24, 24, 5, 72, 50, 100, 62, 11, 72, 2]"
148,10,4310,1271,8597,0,1953,2357,"[745, 258, 331, 716, 362, 785, 69, 559, 419, 694, 0, 514, 524, 622, 457, 704, 132, 215, 604, 372, 738, 624, 284, 29, 617, 192, 654]"
149,10,3593,6085,6105,0,2995,598,"[151, 189, 116, 36, 2, 8, 4, 113, 116, 158, 0, 188, 36, 48, 189, 51, 89, 135, 69, 37, 152, 74, 92, 64, 2, 140, 76]"
150,10,3899,2444,7560,0,2623,1276,"[407, 351, 60, 211, 34, 67, 244, 330, 197, 347, 0, 292, 164, 81, 243, 42, 85, 174, 401, 247, 179, 124, 13, 317, 212, 364, 104]"
151,10,3828,6595,4793,0,1407,2421,"[664, 392, 248, 477, 568, 613, 88, 629, 195, 57, 0, 624, 663, 763, 581, 726, 180, 259, 734, 76, 411, 19, 156, 768, 443, 331, 641]"
152,10,4528,1668,7653,0,300,4228,"[1320, 985, 974, 341, 1086, 1018, 570, 385, 936, 495, 0, 835, 484, 464, 1268, 1342, 882, 655, 683, 996, 1033, 1144, 1307, 1354, 1221, 1279, 654]"
153,10,3466,5281,5838,0,1879,1587,"[109, 143, 511, 116, 175, 271, 317, 219, 238, 458, 0, 58, 313, 440, 4, 201, 2, 118, 136, 356, 147, 438, 186, 72, 208, 227, 64]"
154,10,3857,3779,5916,0,1973,1884,"[149, 375, 523, 234, 89, 327, 196, 550, 414, 577, 0, 532, 485, 48, 24, 360, 271, 123, 249, 463, 479, 268, 89, 236, 224, 108, 160]"
155,10,3304,1630,7590,0,422,2882,"[407, 604, 270, 874, 701, 70, 925, 898, 657, 480, 0, 164, 623, 844, 828, 414, 920, 694, 504, 805, 499, 689, 617, 421, 30, 153, 759]"
156,10,4535,5907,6218,0,1025,3510,"[562, 757, 428, 548, 1078, 728, 907, 209, 675, 285, 0, 526, 674, 709, 1038, 631, 422, 725, 205, 507, 696, 268, 1092, 1029, 134, 1049, 489]"
157,10,3318,1753,7783,0,3218,100,"[15, 17, 5, 26, 33, 15, 18, 2, 27, 12, 0, 7, 19, 23, 20, 29, 5, 28, 26, 33, 8, 14, 24, 6, 12, 5, 23]"
158,10,3563,5908,5438,0,582,2981,"[644, 909, 861, 387, 94, 400, 283, 356, 23, 170, 0, 695, 597, 622, 552, 690, 460, 104, 533, 158, 653, 128, 712, 494, 2, 163, 852]"
159,10,4764,2700,7502,0,520,4244,"[77, 886, 147, 921, 197, 21, 645, 981, 1273, 948, 0, 634, 840, 433, 317, 806, 1171, 740, 186, 243, 543, 900, 663, 510, 1187, 866, 505]"
160,10,4186,6544,5144,0,155,4031,"[125, 70, 181, 20, 749, 338, 865, 1053, 273, 682, 0, 435, 1246, 868, 430, 290, 595, 903, 815, 486, 320, 112, 554, 533, 1294, 40, 1124]"
161,10,4389,4239,5294,0,3612,777,"[129, 2, 82, 110, 241, 213, 128, 80, 139, 79, 0, 170, 233, 9, 47, 248, 252, 30, 191, 71, 188, 67, 47, 257, 245, 140, 113]"
162,10,4436,2516,7214,0,736,3700,"[718, 116, 595, 861, 1051, 336, 1125, 482, 1064, 685, 0, 935, 674, 860, 1129, 715, 326, 379, 921, 737, 1018, 837, 744, 132, 302, 971, 98]"
163,10,4524,5692,6046,0,1243,3281,"[279, 54, 479, 954, 737, 1081, 509, 114, 986, 811, 0, 360, 648, 535, 960, 456, 570, 605, 992, 90, 452, 280, 968, 824, 493, 843, 824]"
164,10,3572,2490,7128,0,556,3016,"[983, 960, 732, 860, 432, 624, 139, 431, 502, 304, 0, 751, 514, 831, 780, 747, 773, 346, 60, 427, 844, 992, 347, 419, 209, 116, 228]"
165,10,3313,631,9810,0,2487,826,"[106, 128, 200, 112, 73, 187, 102, 70, 187, 189, 0, 140, 156, 139, 248, 217, 181, 215, 27, 164, 89, 28, 179, 94, 74, 179, 215]"
166,10,4673,7465,7018,0,1353,3320,"[227, 33, 607, 606, 241, 855, 1094, 959, 587, 342, 0, 226, 247, 33, 963, 348, 998, 172, 560, 781, 425, 834, 340, 400, 1090, 806, 192]"
167,10,4735,6182,5571,0,3508,1227,"[26, 327, 103, 77, 278, 191, 56, 349, 406, 409, 0, 305, 262, 60, 34, 155, 397, 70, 222, 220, 103, 177, 86, 138, 208, 94, 60]"
168,10,4871,4791,5651,0,2773,2098,"[177, 159, 514, 592, 575, 325, 523, 324, 295, 222, 0, 597, 428, 311, 37, 441, 574, 689, 461, 34, 641, 641, 237, 76, 697, 593, 60]"
169,10,3628,52,9227,0,1826,1802,"[365, 324, 559, 560, 585, 365, 556, 548, 500, 297, 0, 592, 182, 333, 433, 329, 124, 160, 39, 157, 427, 55, 403, 256, 15, 406, 300]"
170,10,3040,6459,5808,0,1079,1961,"[481, 577, 80, 433, 271, 85, 85, 117, 79, 566, 0, 519, 233, 8, 357, 320, 496, 456, 67, 77, 379, 283, 218, 645, 290, 116, 240]"
171,10,3045,1108,7745,0,991,2054,"[677, 111, 21, 531, 249, 165, 213, 629, 191, 146, 0, 198, 359, 668, 47, 174, 375, 20, 96, 176, 200, 298, 512, 0, 115, 221, 108]"
172,10,3745,5887,5603,0,2702,1043,"[338, 136, 278, 214, 155, 320, 19, 346, 117, 328, 0, 87, 163, 168, 69, 240, 141, 324, 237, 182, 238, 107, 225, 26, 201, 268, 152]"
173,10,3984,3377,6210,0,3793,191,"[13, 26, 8, 33, 44, 32, 17, 47, 14, 30, 0, 14, 0, 29, 48, 41, 15, 16, 25, 7, 52, 22, 52, 36, 7, 41, 29]"
174,10,3555,3078,6687,0,894,2661,"[723, 173, 884, 100, 653, 275, 113, 44, 780, 316, 0, 142, 725, 278, 363, 502, 877, 169, 671, 258, 658, 264, 265, 302, 100, 279, 417]"
175,10,4196,2444,8439,0,3449,747,"[100, 23, 157, 204, 157, 3, 174, 77, 12, 203, 0, 139, 12, 227, 150, 227, 127, 96, 36, 132, 123, 112, 56, 246, 245, 207, 190]"
176,10,3492,7373,4558,0,1025,2467,"[80, 285, 362, 439, 436, 526, 88, 707, 770, 268, 0, 766, 109, 31, 582, 710, 521, 420, 294, 773, 676, 449, 508, 357, 441, 113, 529]"
177,10,3942,3682,4818,0,2625,1317,"[44, 267, 314, 370, 265, 147, 344, 259, 128, 234, 0, 83, 14, 54, 388, 216, 404, 423, 338, 116, 106, 149, 361, 116, 165, 322, 339]"
178,10,3186,2106,5898,0,234,2952,"[804, 273, 622, 609, 106, 650, 415, 554, 80, 965, 0, 589, 24, 70, 490, 22, 101, 99, 455, 62, 222, 679, 698, 559, 586, 578, 897]"
179,10,4332,4005,6225,0,1482,2850,"[278, 67, 500, 475, 284, 616, 849, 797, 21, 191, 0, 487, 11, 286, 861, 820, 309, 517, 353, 175, 518, 599, 79, 391, 336, 77, 236]"
180,10,4763,4529,6459,0,1320,3443,"[44, 424, 1142, 233, 929, 1024, 886, 330, 77, 189, 0, 898, 253, 603, 1101, 853, 463, 1103, 351, 872, 256, 876, 207, 943, 108, 743, 240]"
181,10,3430,2425,7464,0,705,2725,"[523, 507, 413, 180, 612, 471, 800, 622, 840, 683, 0, 234, 870, 739, 147, 204, 182, 513, 407, 689, 398, 638, 257, 695, 744, 61, 466]"
182,10,3459,2211,8712,0,3042,417,"[17, 27, 94, 73, 76, 1, 20, 130, 23, 103, 0, 10, 10, 83, 97, 30, 60, 2, 46, 106, 95, 99, 127, 63, 98, 102, 76]"
183,10,4314,6226,6800,0,3622,692,"[49, 59, 17, 140, 94, 80, 131, 141, 172, 212, 0, 178, 61, 115, 113, 0, 205, 203, 37, 199, 2, 102, 126, 98, 36, 106, 148]"
184,10,4676,7073,4403,0,1363,3313,"[443, 888, 531, 466, 550, 978, 308, 283, 624, 104, 0, 370, 763, 391, 34, 294, 1051, 796, 784, 525, 765, 24, 924, 906, 108, 791, 522]"
185,10,4270,2924,5749,0,340,3930,"[510, 530, 704, 1072, 401, 357, 197, 1024, 1069, 478, 0, 346, 559, 860, 486, 876, 535, 1303, 755, 1104, 930, 324, 1282, 558, 264, 827, 684]"
186,10,4292,2649,7392,0,2997,1295,"[318, 379, 350, 146, 289, 137, 292, 61, 32, 204, 0, 15, 14, 424, 276, 197, 373, 301, 73, 174, 284, 146, 220, 315, 331, 11, 190]"
187,10,3072,192,10000,272,563,2509,"[602, 254, 223, 226, 248, 561, 698, 739, 83, 613, 0, 735, 95, 259, 718, 743, 804, 91, 129, 817, 315, 799, 395, 823, 371, 527, 32]"
188,10,3597,5315,8282,0,41,3556,"[935, 1065, 466, 344, 19, 1158, 200, 265, 189, 352, 0, 39, 576, 567, 1097, 702, 1049, 683, 839, 765, 249, 342, 429, 1024, 150, 1169, 990]"
189,10,4708,5024,7966,0,3502,1206,"[176, 205, 9, 135, 274, 141, 111, 22, 349, 123, 0, 343, 272, 330, 255, 62, 305, 275, 277, 354, 50, 389, 54, 86, 119, 314, 140]"
190,10,3105,5821,5250,0,2487,618,"[177, 84, 105, 96, 11, 142, 37, 97, 98, 183, 0, 83, 202, 120, 154, 38, 13, 189, 164, 197, 15, 166, 35, 54, 59, 166, 112]"
191,10,3820,2650,6420,0,1300,2520,"[80, 632, 535, 74, 535, 695, 814, 612, 536, 390, 0, 644, 592, 113, 363, 135, 415, 582, 672, 795, 774, 245, 379, 455, 311, 802, 637]"
192,10,4523,688,10000,255,2251,2272,"[59, 433, 460, 574, 622, 476, 18, 102, 517, 481, 0, 354, 146, 684, 194, 550, 668, 95, 195, 161, 352, 173, 175, 348, 230, 389, 739]"
193,10,3732,7269,6463,0,2984,748,"[191, 222, 111, 207, 72, 11, 19, 10, 127, 166, 0, 235, 32, 162, 178, 24, 109, 75, 124, 133, 189, 107, 204, 191, 234, 109, 180]"
194,10,3610,292,9781,0,505,3105,"[874, 735, 925, 973, 200, 485, 630, 889, 594, 561, 0, 719, 831, 42, 67, 634, 23, 606, 512, 966, 155, 244, 141, 655, 843, 341, 154]"
195,10,3883,6912,6752,0,2706,1177,"[326, 280, 133, 120, 379, 255, 150, 158, 213, 292, 0, 249, 49, 209, 342, 218, 268, 162, 363, 354, 283, 65, 324, 211, 338, 196, 296]"
196,10,3486,798,9440,0,1768,1718,"[571, 169, 238, 102, 149, 123, 150, 307, 505, 186, 0, 199, 461, 475, 43, 319, 388, 202, 48, 327, 365, 568, 18, 104, 11, 68, 77]"
197,10,3230,5283,7387,0,1121,2109,"[185, 287, 357, 259, 632, 77, 325, 424, 32, 526, 0, 348, 209, 259, 183, 216, 328, 458, 323, 694, 619, 559, 326, 344, 157, 35, 361]"
198,10,3454,2842,7999,0,386,3068,"[503, 650, 611, 6, 927, 420, 336, 514, 807, 560, 0, 377, 402, 978, 158, 405, 456, 102, 495, 728, 878, 306, 930, 423, 69, 102, 467]"
199,10,4118,7080,5037,0,2732,1386,"[159, 181, 320, 252, 349, 106, 368, 436, 157, 259, 0, 335, 253, 452, 13, 437, 376, 61, 345, 150, 31, 252, 462, 36, 409, 102, 3]"
200,10,3965,2788,6214,0,1067,2898,"[533, 368, 786, 445, 255, 668, 853, 145, 874, 805, 0, 825, 189, 27, 940, 857, 928, 726, 610, 818, 577, 472, 184, 264, 812, 659, 335]"
201,10,4098,1204,9108,0,1260,2838,"[337, 624, 466, 750, 457, 219, 841, 457, 785, 279, 0, 56, 99, 819, 240, 564, 777, 234, 568, 303, 181, 192, 0, 61, 362, 427, 455]"
202,10,3741,5966,6883,0,2857,884,"[254, 244, 174, 174, 26, 61, 181, 162, 210, 36, 0, 283, 229, 56, 253, 113, 40, 284, 190, 27, 247, 93, 206, 107, 191, 53, 277]"
203,10,3268,1945,8206,0,1765,1503,"[77, 47, 198, 300, 46, 89, 263, 405, 263, 388, 0, 196, 32, 51, 282, 15, 77, 211, 362, 263, 203, 484, 82, 23, 154, 11, 395]"
204,10,4080,7420,4866,0,33,4047,"[1037, 254, 1263, 645, 218, 289, 933, 91, 1045, 867, 0, 754, 193, 496, 1, 1071, 1317, 133, 679, 565, 857, 932, 6, 254, 538, 1043, 498]"
205,10,3008,1589,6285,0,1904,1104,"[336, 65, 196, 287, 309, 174, 315, 216, 168, 170, 0, 89, 172, 42, 217, 30, 203, 9, 94, 224, 70, 199, 267, 240, 120, 287, 157]"
206,10,4146,2531,7900,0,210,3936,"[767, 606, 203, 834, 178, 28, 1077, 897, 1109, 898, 0, 991, 1103, 1258, 1041, 137, 1049, 675, 181, 1255, 823, 430, 348, 915, 538, 238, 1001]"
207,10,3615,7355,4160,0,2123,1492,"[378, 431, 407, 437, 348, 346, 287, 400, 346, 100, 0, 401, 447, 486, 369, 425, 424, 87, 271, 491, 139, 38, 170, 260, 115, 305, 315]"
208,10,3796,116,7840,0,1727,2069,"[127, 557, 664, 170, 623, 590, 90, 443, 569, 497, 0, 560, 330, 261, 659, 675, 493, 323, 605, 108, 127, 420, 525, 456, 636, 143, 341]"
209,10,3570,6633,4777,0,2638,932,"[107, 11, 300, 163, 46, 94, 211, 207, 267, 115, 0, 78, 294, 23, 276, 265, 232, 20, 161, 142, 273, 136, 72, 105, 253, 167, 157]"
210,10,4893,1006,8664,0,902,3991,"[109, 618, 1148, 480, 628, 656, 880, 1103, 819, 1155, 0, 769, 478, 731, 1316, 727, 756, 1132, 856, 755, 17, 949, 323, 1114, 1063, 552, 358]"
211,10,4284,5792,7156,0,3426,858,"[265, 48, 99, 171, 137, 109, 135, 274, 29, 224, 0, 189, 140, 80, 7, 161, 168, 189, 34, 14, 7, 162, 152, 33, 6, 280, 207]"
212,10,4999,6839,5316,0,264,4735,"[62, 539, 729, 1238, 17, 480, 47, 405, 521, 424, 0, 757, 1293, 995, 317, 1208, 733, 910, 623, 658, 500, 146, 262, 1033, 930, 552, 615]"
213,10,3656,1770,7202,0,1087,2569,"[452, 229, 822, 800, 111, 679, 780, 391, 155, 553, 0, 757, 714, 74, 653, 25, 519, 733, 170, 434, 273, 757, 783, 766, 148, 126, 107]"
214,10,4156,5235,6123,0,3290,866,"[275, 122, 109, 275, 203, 125, 25, 247, 221, 121, 0, 107, 48, 117, 90, 277, 226, 20, 214, 90, 171, 216, 40, 101, 71, 211, 284]"
215,10,3539,141,9521,0,247,3292,"[200, 809, 584, 887, 770, 1012, 6, 299, 208, 653, 0, 467, 127, 322, 1021, 251, 1071, 65, 350, 202, 942, 634, 827, 605, 718, 234, 329]"
216,10,3425,6369,6577,0,2444,981,"[220, 250, 258, 123, 99, 60, 21, 235, 160, 3, 0, 153, 72, 173, 244, 8, 39, 127, 15, 200, 41, 101, 121, 71, 228, 103, 105]"
217,10,3338,3214,6701,0,1158,2180,"[686, 462, 502, 650, 473, 48, 189, 597, 328, 308, 0, 308, 97, 591, 38, 614, 286, 716, 379, 11, 610, 720, 372, 466, 350, 93, 478]"
218,10,3891,441,10000,151,412,3479,"[788, 215, 121, 208, 204, 307, 318, 22, 709, 285, 0, 497, 412, 513, 735, 157, 243, 138, 246, 61, 53, 512, 454, 543, 786, 288, 1051]"
219,10,4469,6722,7747,0,1862,2607,"[242, 477, 853, 708, 377, 392, 69, 67, 217, 487, 0, 21, 33, 194, 367, 791, 791, 832, 725, 755, 748, 216, 331, 541, 529, 668, 49]"
220,10,3646,6395,4998,0,2205,1441,"[421, 331, 434, 480, 290, 429, 333, 377, 462, 225, 0, 386, 68, 33, 396, 398, 434, 161, 260, 432, 450, 217, 315, 214, 363, 287, 472]"
221,10,3838,3195,5641,0,1183,2655,"[209, 130, 273, 354, 857, 237, 182, 768, 680, 864, 0, 538, 107, 538, 808, 793, 399, 840, 456, 386, 665, 599, 470, 181, 547, 314, 17]"
222,10,3138,1044,7735,0,3076,62,"[18, 3, 13, 19, 16, 5, 6, 18, 9, 3, 0, 18, 0, 9, 4, 3, 16, 8, 17, 10, 1, 14, 2, 20, 14, 7, 14]"
223,10,3177,2644,8268,0,2845,332,"[101, 78, 13, 40, 46, 20, 80, 61, 33, 50, 0, 13, 16, 78, 50, 97, 5, 68, 26, 39, 93, 103, 79, 10, 107, 86, 55]"
224,10,3415,5311,6372,0,2753,662,"[34, 31, 102, 203, 178, 5, 75, 3, 213, 117, 0, 28, 196, 19, 153, 194, 183, 29, 49, 74, 56, 55, 219, 110, 136, 110, 138]"
225,10,4716,5254,5834,0,982,3734,"[590, 268, 741, 643, 220, 680, 0, 643, 1112, 493, 0, 774, 755, 799, 753, 1220, 826, 869, 956, 301, 651, 645, 833, 992, 426, 1046, 947]"
226,10,3852,3014,6672,0,1203,2649,"[349, 88, 432, 602, 570, 2, 826, 554, 147, 383, 0, 431, 271, 1, 312, 763, 852, 383, 853, 791, 852, 168, 751, 426, 232, 720, 452]"
227,10,3026,1089,8609,0,1833,1193,"[281, 348, 203, 71, 219, 126, 206, 29, 29, 335, 0, 278, 44, 296, 171, 342, 3, 94, 7, 203, 93, 258, 279, 117, 21, 187, 132]"
228,10,3057,5524,6142,0,1689,1368,"[270, 401, 139, 34, 219, 348, 108, 448, 81, 260, 0, 334, 430, 378, 106, 47, 398, 31, 7, 372, 184, 103, 78, 256, 447, 81, 128]"
229,10,4781,3634,7289,0,1985,2796,"[735, 88, 223, 150, 633, 149, 631, 855, 810, 668, 0, 34, 608, 324, 758, 915, 350, 468, 563, 730, 48, 77, 96, 924, 301, 568, 273]"
230,10,4683,6398,5574,0,4222,461,"[118, 139, 86, 37, 98, 130, 116, 14, 143, 11, 0, 14, 107, 74, 65, 109, 31, 120, 98, 75, 5, 109, 77, 36, 70, 79, 6]"
231,10,3902,2683,6793,0,2533,1369,"[294, 291, 277, 451, 163, 110, 344, 318, 235, 332, 0, 164, 9, 331, 251, 427, 379, 362, 408, 240, 110, 370, 207, 227, 416, 43, 325]"
232,10,4386,5171,6008,0,3310,1076,"[299, 217, 72, 98, 103, 46, 268, 217, 18, 291, 0, 272, 56, 212, 269, 54, 299, 2, 265, 125, 110, 12, 197, 8, 271, 192, 144]"
233,10,3448,1271,8185,0,3373,75,"[11, 20, 17, 13, 15, 9, 2, 2, 1, 4, 0, 7, 7, 18, 4, 5, 3, 1, 19, 8, 4, 16, 1, 5, 10, 23, 8]"
234,10,3587,5195,6577,0,1568,2019,"[557, 192, 415, 638, 461, 319, 633, 247, 327, 640, 0, 452, 80, 382, 28, 393, 55, 46, 192, 158, 39, 508, 391, 656, 8, 643, 321]"
235,10,4346,1425,9498,0,1315,3031,"[40, 249, 802, 818, 823, 773, 701, 947, 657, 999, 0, 482, 609, 304, 445, 414, 746, 448, 218, 699, 769, 954, 611, 823, 143, 355, 561]"
236,10,3966,5065,8399,0,2649,1317,"[325, 233, 208, 126, 435, 274, 342, 219, 412, 162, 0, 409, 69, 161, 362, 399, 256, 55, 421, 197, 357, 319, 412, 299, 58, 0, 434]"
237,10,4771,7427,5743,0,569,4202,"[1029, 831, 1352, 1244, 670, 685, 522, 697, 1046, 286, 0, 1293, 369, 324, 113, 789, 730, 1369, 1357, 1034, 135, 1324, 391, 684, 803, 1341, 912]"
238,10,4877,1053,9567,0,156,4721,"[132, 1552, 595, 1065, 10, 668, 579, 627, 414, 1454, 0, 1115, 311, 1499, 642, 560, 1489, 309, 991, 907, 1280, 561, 1313, 1409, 937, 303, 183]"
239,10,4379,7153,6793,0,198,4181,"[922, 433, 936, 510, 1077, 1355, 1069, 571, 398, 96, 0, 765, 593, 285, 1388, 1055, 24, 1308, 1375, 764, 185, 999, 135, 807, 923, 104, 701]"
240,10,4823,6133,5483,0,234,4589,"[109, 219, 1121, 1318, 258, 410, 1182, 1110, 314, 1009, 0, 404, 1237, 460, 115, 1478, 276, 969, 120, 1415, 1468, 441, 1443, 1183, 722, 392, 1191]"
241,10,4339,1828,7994,0,1197,3142,"[808, 303, 293, 771, 32, 460, 817, 1023, 411, 953, 0, 653, 372, 300, 901, 345, 354, 795, 882, 232, 297, 970, 172, 970, 1042, 348, 829]"
242,10,3163,5963,5194,0,2388,775,"[53, 138, 63, 198, 90, 113, 89, 90, 189, 117, 0, 137, 112, 233, 201, 121, 146, 145, 179, 9, 245, 123, 189, 69, 91, 116, 231]"
243,10,4001,3372,5823,0,514,3487,"[321, 583, 289, 268, 427, 752, 345, 794, 47, 243, 0, 481, 1080, 1100, 441, 173, 962, 832, 394, 912, 281, 84, 777, 960, 324, 1152, 211]"
244,10,4576,902,9497,0,2882,1694,"[127, 516, 220, 301, 181, 104, 127, 307, 429, 100, 0, 64, 11, 438, 448, 343, 559, 473, 530, 9, 213, 424, 126, 437, 271, 492, 23]"
245,10,4797,5400,8894,0,2347,2450,"[666, 330, 180, 463, 785, 400, 456, 219, 701, 193, 0, 217, 129, 183, 26, 88, 46, 106, 106, 574, 137, 168, 285, 164, 182, 225, 609]"
246,10,3433,5578,6749,0,507,2926,"[27, 849, 798, 414, 897, 726, 81, 827, 478, 313, 0, 98, 144, 133, 369, 685, 260, 611, 506, 966, 35, 243, 628, 704, 717, 155, 921]"
247,10,3396,2519,7626,0,923,2473,"[168, 535, 466, 797, 11, 199, 555, 83, 690, 723, 0, 292, 103, 106, 730, 442, 86, 316, 433, 582, 42, 567, 515, 746, 691, 208, 632]"
248,10,3864,7436,4054,0,3034,830,"[46, 189, 63, 233, 154, 28, 256, 108, 61, 11, 0, 230, 114, 185, 94, 89, 252, 158, 208, 0, 145, 180, 18, 134, 112, 110, 114]"
249,10,4185,2265,5974,0,3716,469,"[95, 33, 138, 104, 73, 55, 16, 82, 4, 12, 0, 19, 46, 92, 18, 70, 107, 135, 102, 80, 118, 122, 54, 22, 1, 55, 87]"
250,10,3247,1534,7687,0,1735,1512,"[350, 101, 448, 257, 389, 262, 443, 172, 146, 371, 0, 163, 105, 171, 69, 36, 387, 227, 299, 182, 435, 3, 419, 33, 319, 0, 145]"
251,10,4603,7124,5166,0,2099,2504,"[179, 410, 16, 708, 110, 161, 306, 178, 353, 825, 0, 790, 440, 157, 204, 571, 311, 646, 577, 416, 762, 402, 728, 375, 274, 141, 519]"
252,10,4718,3756,6128,0,4249,469,"[22, 103, 85, 146, 41, 31, 112, 5, 28, 148, 0, 117, 148, 22, 93, 30, 49, 153, 12, 147, 106, 26, 95, 78, 36, 118, 57]"
253,10,4341,345,10000,124,3303,1038,"[72, 269, 67, 341, 2, 157, 246, 141, 202, 171, 0, 287, 279, 46, 203, 134, 42, 202, 124, 255, 137, 226, 151, 141, 18, 239, 157]"
254,10,4664,6525,8139,0,2392,2272,"[736, 19, 174, 537, 164, 593, 448, 314, 533, 407, 0, 293, 71, 387, 72, 356, 512, 561, 146, 496, 540, 527, 568, 228, 270, 317, 69]"
255,10,3719,6243,5615,0,2702,1017,"[41, 60, 337, 334, 190, 81, 43, 170, 175, 91, 0, 189, 307, 183, 22, 208, 155, 13, 155, 196, 303, 28, 54, 84, 308, 20, 330]"
256,10,3474,1660,7429,0,1000,2474,"[308, 741, 454, 302, 341, 156, 409, 793, 130, 545, 0, 339, 20, 447, 220, 295, 747, 639, 713, 525, 313, 797, 753, 594, 29, 395, 157]"
257,10,3339,592,10000,176,3286,53,"[1, 13, 11, 11, 2, 3, 6, 14, 9, 7, 0, 6, 13, 10, 1, 2, 4, 13, 1, 9, 0, 1, 7, 6, 17, 8, 9]"
258,10,3688,6398,7290,0,3382,306,"[13, 19, 80, 38, 10, 33, 82, 13, 83, 17, 0, 7, 17, 12, 25, 96, 39, 35, 76, 94, 38, 46, 57, 88, 63, 91, 38]"
259,10,4334,6305,5319,0,147,4187,"[1302, 296, 247, 780, 608, 353, 410, 386, 731, 797, 0, 841, 1187, 418, 836, 481, 626, 136, 245, 1258, 1382, 284, 923, 278, 161, 42, 1197]"
260,10,3502,157,8664,0,659,2843,"[595, 684, 692, 20, 658, 64, 459, 359, 50, 17, 0, 870, 935, 104, 345, 515, 146, 271, 785, 878, 268, 541, 91, 124, 807, 417, 898]"
261,10,3561,5733,6492,0,2658,903,"[228, 52, 109, 117, 298, 162, 148, 52, 134, 243, 0, 263, 194, 186, 211, 284, 16, 97, 91, 255, 181, 297, 56, 14, 47, 128, 23]"
262,10,3647,2903,7236,0,2463,1184,"[264, 130, 350, 240, 17, 90, 380, 279, 221, 12, 0, 356, 145, 342, 296, 276, 204, 48, 2, 362, 185, 71, 368, 385, 211, 339, 311]"
263,10,4216,5326,6126,0,1859,2357,"[567, 211, 594, 244, 177, 431, 545, 132, 471, 366, 0, 340, 5, 506, 8, 744, 71, 266, 156, 304, 681, 754, 646, 312, 482, 605, 207]"
264,10,3321,1932,7515,0,1087,2234,"[485, 346, 720, 389, 697, 299, 159, 155, 100, 117, 0, 190, 708, 44, 595, 294, 330, 656, 636, 242, 654, 456, 360, 565, 470, 735, 289]"
265,10,4693,5464,6744,0,4135,558,"[11, 71, 74, 97, 81, 74, 27, 109, 45, 116, 0, 80, 88, 51, 44, 5, 74, 46, 56, 168, 26, 86, 146, 107, 104, 58, 120]"
266,10,4542,5922,5364,0,848,3694,"[89, 1079, 862, 909, 1019, 72, 1190, 937, 755, 893, 0, 1136, 938, 95, 658, 78, 789, 758, 912, 1202, 1090, 851, 1075, 961, 670, 234, 893]"
267,10,4519,4094,5789,0,1448,3071,"[695, 233, 619, 933, 455, 220, 407, 881, 266, 662, 0, 556, 943, 144, 259, 522, 151, 71, 643, 416, 243, 86, 925, 157, 941, 207, 133]"
268,10,3050,659,8180,0,519,2531,"[496, 157, 580, 492, 588, 658, 475, 151, 465, 750, 0, 813, 307, 617, 339, 351, 66, 237, 793, 618, 732, 841, 361, 142, 838, 380, 662]"
269,10,4145,5494,6831,0,2228,1917,"[100, 112, 429, 289, 376, 23, 70, 142, 61, 267, 0, 602, 621, 582, 320, 72, 419, 237, 260, 480, 103, 309, 148, 506, 27, 318, 196]"
270,10,3247,1682,8396,0,740,2507,"[490, 519, 694, 276, 159, 724, 525, 684, 561, 507, 0, 427, 142, 27, 347, 341, 634, 401, 344, 414, 359, 364, 334, 152, 479, 39, 821]"
271,10,3940,7153,5183,0,671,3269,"[680, 297, 509, 1081, 550, 217, 998, 430, 965, 259, 0, 901, 757, 525, 663, 764, 466, 179, 52, 466, 1083, 260, 342, 447, 692, 452, 781]"
272,10,4186,484,8885,0,814,3372,"[670, 652, 274, 302, 973, 666, 765, 886, 878, 50, 0, 51, 516, 1029, 1028, 197, 186, 288, 562, 111, 570, 857, 932, 879, 340, 245, 69]"
273,10,4613,5863,7635,0,3353,1260,"[400, 111, 0, 248, 314, 126, 262, 253, 228, 218, 0, 164, 36, 225, 53, 255, 389, 219, 386, 406, 53, 97, 113, 196, 321, 115, 382]"
274,10,4828,5560,6903,0,3811,1017,"[73, 1, 134, 306, 145, 145, 126, 121, 17, 213, 0, 318, 223, 21, 168, 92, 141, 200, 41, 160, 116, 144, 18, 178, 173, 117, 252]"
275,10,3524,309,10000,118,1650,1874,"[609, 30, 417, 419, 593, 418, 17, 339, 341, 294, 0, 509, 105, 303, 595, 616, 179, 359, 103, 162, 436, 411, 532, 508, 318, 315, 535]"
276,10,4779,7151,7628,0,1078,3701,"[837, 443, 576, 957, 811, 10, 139, 1191, 1016, 1206, 0, 151, 257, 953, 622, 546, 883, 122, 793, 319, 650, 902, 591, 1157, 994, 504, 651]"
277,10,3669,7121,4176,0,659,3010,"[495, 480, 79, 868, 194, 617, 827, 226, 533, 89, 0, 837, 263, 699, 697, 723, 1, 146, 426, 682, 112, 662, 803, 634, 340, 678, 527]"
278,10,4230,2452,5954,0,2136,2094,"[365, 88, 373, 446, 571, 593, 23, 496, 147, 211, 0, 73, 421, 628, 531, 473, 431, 239, 46, 511, 148, 164, 197, 314, 127, 103, 252]"
279,10,3940,1400,8494,0,3669,271,"[52, 68, 23, 48, 62, 11, 7, 20, 45, 12, 0, 71, 87, 84, 82, 21, 2, 87, 70, 70, 2, 40, 60, 33, 24, 73, 68]"
280,10,3489,7279,4704,0,259,3230,"[864, 910, 784, 896, 939, 490, 693, 1037, 63, 945, 0, 870, 883, 539, 509, 575, 172, 673, 635, 258, 449, 540, 615, 881, 1026, 875, 210]"
281,10,4464,2869,6299,0,4049,415,"[48, 80, 4, 64, 6, 125, 61, 91, 79, 51, 0, 125, 33, 23, 85, 128, 113, 97, 89, 116, 9, 47, 76, 13, 22, 54, 101]"
282,10,4062,2186,8175,0,3546,516,"[106, 156, 96, 117, 73, 130, 23, 165, 128, 31, 0, 38, 68, 128, 92, 89, 130, 162, 10, 36, 135, 137, 25, 161, 46, 129, 111]"
283,10,3043,6583,4635,0,51,2992,"[177, 786, 698, 760, 454, 421, 689, 897, 105, 756, 0, 822, 403, 910, 353, 902, 212, 524, 518, 360, 577, 895, 181, 338, 78, 506, 453]"
284,10,4784,3982,5437,0,2512,2272,"[540, 176, 69, 691, 387, 115, 175, 199, 275, 286, 0, 313, 106, 498, 586, 447, 76, 670, 614, 409, 272, 283, 374, 196, 336, 641, 390]"
285,10,4292,2997,6732,0,2539,1753,"[249, 378, 531, 47, 196, 557, 99, 257, 211, 250, 0, 327, 478, 327, 351, 391, 42, 70, 175, 2, 448, 388, 160, 143, 82, 0, 150]"
286,10,3411,680,9463,0,3283,128,"[13, 32, 21, 1, 5, 21, 26, 4, 2, 7, 0, 0, 28, 4, 32, 21, 9, 4, 8, 7, 41, 4, 7, 11, 21, 8, 9]"
287,10,4692,5139,9016,0,278,4414,"[1138, 1183, 584, 1034, 1402, 306, 716, 1395, 1127, 723, 0, 960, 1183, 726, 134, 313, 1448, 1252, 543, 741, 762, 210, 443, 1158, 386, 1028, 1300]"
288,10,3649,6355,6310,0,1973,1676,"[287, 303, 6, 121, 491, 196, 450, 315, 300, 134, 0, 528, 415, 279, 495, 359, 115, 239, 81, 14, 288, 539, 433, 510, 202, 110, 348]"
289,10,4007,1653,8664,0,150,3857,"[821, 816, 190, 595, 327, 1093, 709, 26, 292, 327, 0, 783, 1264, 1126, 587, 501, 525, 213, 851, 901, 162, 1239, 1126, 807, 1062, 1222, 794]"
290,10,3569,5470,6763,0,98,3471,"[312, 1014, 157, 996, 1059, 830, 247, 20, 520, 910, 0, 1112, 168, 1101, 438, 334, 5, 554, 452, 1074, 82, 191, 545, 1122, 989, 10, 294]"
291,10,4115,729,10000,149,325,3790,"[338, 799, 34, 265, 414, 617, 450, 71, 1151, 57, 0, 915, 630, 1086, 831, 684, 1229, 811, 821, 905, 604, 803, 95, 1053, 287, 1194, 68]"
292,10,3610,5740,7870,0,1504,2106,"[667, 555, 600, 501, 135, 566, 69, 699, 268, 623, 0, 537, 499, 396, 600, 297, 204, 115, 7, 649, 51, 210, 609, 236, 483, 398, 306]"
293,10,4492,5580,6782,0,2366,2126,"[305, 609, 404, 674, 224, 97, 516, 71, 88, 639, 0, 416, 304, 489, 508, 243, 319, 156, 4, 485, 102, 255, 462, 244, 63, 181, 661]"
294,10,4791,6626,4947,0,4427,364,"[120, 94, 11, 19, 21, 8, 98, 47, 111, 93, 0, 120, 98, 27, 52, 12, 80, 4, 4, 61, 106, 21, 54, 112, 56, 93, 37]"
295,10,3594,757,7784,0,901,2693,"[577, 85, 528, 216, 512, 362, 822, 853, 283, 529, 0, 480, 87, 165, 53, 799, 48, 220, 849, 246, 701, 497, 122, 186, 580, 716, 887]"
296,10,4418,6646,5556,0,281,4137,"[935, 603, 1088, 210, 1375, 373, 727, 12, 813, 892, 0, 579, 140, 862, 459, 1379, 706, 365, 833, 623, 905, 608, 1193, 1097, 1332, 744, 441]"
297,10,4267,4197,5626,0,2668,1599,"[444, 160, 171, 462, 378, 478, 257, 439, 312, 416, 0, 392, 300, 513, 452, 224, 173, 78, 368, 439, 484, 173, 324, 343, 471, 300, 413]"
298,10,4809,3290,7145,0,2204,2605,"[654, 104, 313, 217, 315, 65, 414, 671, 551, 8, 0, 121, 198, 383, 586, 602, 797, 779, 799, 288, 606, 677, 632, 398, 412, 261, 767]"
299,10,3172,2259,8058,0,2052,1120,"[316, 79, 205, 365, 203, 261, 256, 87, 242, 160, 0, 76, 111, 119, 160, 128, 124, 332, 78, 142, 58, 367, 62, 280, 70, 304, 335]"
0,11,4769,0,4769,0,221,4548,"[674, 508, 1370, 1346, 163, 879, 310, 809, 1255, 1298, 654, 0, 320, 1379, 402, 972, 639, 1480, 1059, 92, 723, 707, 274, 1146, 442, 540, 627]"
1,11,4583,1070,8282,0,971,3612,"[787, 291, 386, 255, 1051, 133, 827, 466, 15, 543, 1084, 0, 423, 232, 998, 1183, 1196, 920, 448, 40, 158, 929, 13, 738, 511, 955, 764]"
2,11,3256,5561,5977,0,1299,1957,"[119, 102, 273, 193, 121, 383, 506, 230, 214, 508, 179, 0, 366, 130, 43, 576, 226, 43, 506, 107, 160, 630, 269, 79, 231, 535, 91]"
3,11,3400,2619,6758,0,1587,1813,"[546, 496, 329, 508, 53, 367, 521, 234, 559, 506, 375, 0, 163, 174, 49, 391, 403, 327, 361, 45, 149, 118, 263, 503, 265, 162, 554]"
4,11,3181,2388,7551,0,360,2821,"[24, 218, 182, 103, 489, 271, 904, 931, 174, 375, 798, 0, 591, 830, 184, 115, 418, 802, 583, 159, 361, 481, 159, 576, 926, 429, 86]"
5,11,4563,6232,5882,0,453,4110,"[31, 52, 1159, 842, 50, 1139, 181, 467, 152, 948, 944, 0, 1146, 240, 742, 822, 799, 1172, 791, 1139, 209, 673, 544, 564, 451, 1235, 293]"
6,11,3743,2121,7504,0,2417,1326,"[104, 306, 341, 67, 417, 285, 42, 70, 258, 9, 318, 0, 239, 186, 213, 130, 290, 137, 103, 214, 84, 313, 112, 211, 363, 156, 433]"
7,11,3735,5208,6031,0,1768,1967,"[176, 462, 387, 469, 91, 365, 243, 435, 125, 499, 230, 0, 149, 242, 48, 297, 130, 221, 484, 190, 487, 251, 225, 252, 184, 113, 271]"
8,11,3796,1626,8201,0,2572,1224,"[266, 348, 152, 389, 61, 88, 149, 162, 251, 78, 205, 0, 230, 332, 331, 39, 247, 147, 34, 330, 373, 344, 311, 337, 398, 120, 374]"
9,11,3059,6239,5021,0,534,2525,"[153, 39, 662, 641, 839, 240, 95, 402, 527, 688, 514, 0, 279, 640, 593, 497, 131, 505, 818, 86, 4, 190, 265, 77, 706, 703, 388]"
10,11,4621,1110,8532,0,3065,1556,"[40, 214, 330, 171, 237, 10, 183, 306, 74, 171, 156, 0, 436, 168, 518, 486, 456, 485, 53, 12, 517, 379, 415, 11, 81, 470, 474]"
11,11,4756,5950,7338,0,4135,621,"[187, 192, 159, 83, 84, 86, 74, 192, 0, 50, 155, 0, 142, 172, 122, 59, 116, 169, 203, 93, 98, 67, 102, 90, 86, 13, 204]"
12,11,4646,5261,6723,0,2530,2116,"[1, 675, 265, 434, 57, 264, 556, 527, 660, 132, 653, 0, 430, 513, 598, 346, 643, 78, 219, 351, 366, 364, 698, 579, 60, 441, 206]"
13,11,3214,1538,8399,0,2668,546,"[152, 7, 71, 35, 149, 131, 52, 153, 46, 18, 167, 0, 174, 178, 157, 69, 75, 158, 4, 145, 150, 163, 105, 99, 127, 44, 42]"
14,11,4403,7045,5757,0,2922,1481,"[243, 28, 426, 131, 101, 412, 44, 138, 366, 398, 246, 0, 366, 443, 289, 90, 419, 435, 288, 247, 186, 391, 65, 395, 245, 229, 183]"
15,11,4483,4125,6115,0,1365,3118,"[5, 287, 19, 17, 207, 544, 735, 438, 707, 691, 666, 0, 183, 253, 719, 493, 848, 840, 31, 891, 407, 677, 987, 872, 484, 710, 137]"
16,11,4751,186,10000,680,2363,2388,"[345, 313, 335, 766, 529, 512, 505, 191, 427, 52, 787, 0, 100, 761, 282, 361, 212, 419, 751, 778, 540, 696, 283, 163, 694, 465, 757]"
17,11,3522,5226,8296,0,1333,2189,"[585, 701, 522, 467, 472, 532, 13, 495, 28, 348, 194, 0, 301, 317, 696, 590, 408, 664, 629, 612, 643, 546, 415, 514, 680, 685, 26]"
18,11,4616,6300,6612,0,3994,622,"[97, 170, 179, 68, 179, 169, 23, 150, 5, 160, 114, 0, 91, 35, 95, 93, 4, 78, 82, 11, 89, 172, 119, 67, 132, 48, 181]"
19,11,3043,506,9149,0,533,2510,"[328, 61, 83, 87, 418, 308, 564, 506, 664, 229, 829, 0, 812, 740, 497, 760, 94, 202, 329, 133, 715, 534, 228, 162, 5, 442, 618]"
20,11,4948,6875,7222,0,4217,731,"[212, 164, 194, 102, 15, 103, 152, 84, 214, 230, 178, 0, 77, 16, 163, 31, 114, 47, 139, 150, 64, 38, 192, 215, 231, 134, 188]"
21,11,4985,6404,5803,0,604,4381,"[1365, 1134, 1405, 356, 1146, 669, 376, 433, 626, 878, 1454, 0, 820, 63, 453, 1101, 1300, 97, 229, 41, 1434, 171, 433, 964, 213, 538, 499]"
22,11,4040,1170,8673,0,3541,499,"[77, 8, 120, 152, 160, 47, 15, 22, 95, 116, 18, 0, 105, 79, 20, 53, 42, 72, 17, 58, 91, 30, 83, 3, 97, 109, 33]"
23,11,4766,5758,7681,0,2849,1917,"[292, 45, 24, 112, 137, 33, 111, 212, 5, 512, 331, 0, 538, 320, 404, 402, 419, 436, 483, 539, 216, 2, 523, 110, 230, 214, 218]"
24,11,3609,6636,4654,0,366,3243,"[29, 529, 651, 508, 392, 59, 685, 234, 576, 391, 411, 0, 883, 683, 509, 810, 513, 108, 608, 1008, 999, 731, 202, 70, 602, 62, 34]"
25,11,3815,150,8319,0,130,3685,"[443, 598, 661, 492, 593, 178, 891, 660, 941, 968, 943, 0, 591, 662, 41, 133, 1085, 96, 1010, 1091, 304, 1184, 890, 844, 763, 203, 1066]"
26,11,4675,5825,7169,0,3283,1392,"[191, 124, 464, 229, 156, 15, 143, 115, 51, 321, 147, 0, 75, 126, 242, 224, 320, 22, 303, 137, 382, 274, 268, 347, 461, 166, 183]"
27,11,4648,5050,6767,0,287,4361,"[102, 767, 906, 909, 1353, 853, 500, 222, 959, 1453, 176, 0, 856, 403, 1257, 1241, 852, 506, 609, 1079, 57, 1303, 1081, 1231, 1049, 794, 544]"
28,11,3033,2713,7087,0,1266,1767,"[49, 87, 586, 318, 178, 336, 233, 392, 102, 11, 107, 0, 420, 40, 266, 140, 332, 284, 245, 193, 446, 333, 135, 270, 534, 188, 547]"
29,11,4261,5356,5992,0,3921,340,"[43, 73, 15, 2, 62, 2, 105, 75, 94, 52, 70, 0, 9, 68, 46, 24, 1, 43, 12, 45, 103, 18, 30, 4, 79, 40, 65]"
30,11,4470,419,10000,43,902,3568,"[1104, 917, 922, 842, 176, 136, 584, 871, 71, 602, 1143, 0, 984, 944, 773, 45, 452, 177, 189, 653, 108, 281, 895, 389, 400, 122, 185]"
31,11,4526,5220,9306,0,170,4356,"[1280, 416, 181, 823, 1431, 316, 174, 270, 1418, 1171, 1182, 0, 140, 725, 607, 233, 579, 1114, 69, 131, 856, 806, 1317, 503, 1216, 196, 1203]"
32,11,3223,5840,6689,0,2797,426,"[16, 42, 25, 136, 115, 134, 51, 133, 104, 130, 51, 0, 106, 46, 48, 34, 89, 12, 93, 91, 49, 53, 4, 86, 20, 117, 133]"
33,11,3328,2474,7543,0,878,2450,"[159, 717, 638, 584, 26, 421, 677, 451, 135, 723, 101, 0, 463, 311, 489, 709, 427, 507, 307, 666, 139, 581, 477, 805, 278, 167, 221]"
34,11,3792,7109,4226,0,438,3354,"[782, 15, 626, 65, 1016, 145, 134, 141, 890, 383, 827, 0, 671, 615, 788, 933, 417, 1118, 186, 432, 893, 758, 754, 1005, 294, 1011, 1111]"
35,11,4534,361,8399,0,2219,2315,"[608, 372, 736, 769, 690, 249, 560, 512, 29, 652, 681, 0, 735, 191, 476, 327, 426, 652, 615, 713, 762, 310, 550, 320, 700, 231, 315]"
36,11,3111,6595,4915,0,160,2951,"[609, 582, 199, 531, 430, 349, 116, 385, 825, 922, 343, 0, 59, 814, 952, 519, 892, 135, 152, 50, 190, 763, 598, 282, 866, 195, 423]"
37,11,4276,2867,6324,0,2442,1834,"[493, 529, 284, 32, 572, 161, 301, 335, 393, 507, 292, 0, 520, 407, 334, 486, 29, 556, 206, 462, 317, 499, 173, 244, 226, 34, 277]"
38,11,3753,1230,8847,0,566,3187,"[1017, 700, 346, 895, 883, 227, 233, 584, 358, 760, 237, 0, 25, 788, 615, 377, 954, 245, 826, 784, 218, 26, 241, 98, 406, 414, 852]"
39,11,3028,5237,6638,0,872,2156,"[125, 367, 450, 65, 9, 146, 207, 562, 483, 641, 84, 0, 488, 39, 716, 463, 259, 263, 708, 214, 682, 521, 346, 268, 320, 705, 382]"
40,11,3974,1345,9267,0,2593,1381,"[193, 420, 281, 347, 97, 42, 106, 160, 49, 353, 442, 0, 176, 443, 107, 101, 66, 49, 11, 277, 147, 8, 317, 321, 331, 171, 452]"
41,11,3310,7290,5287,0,2509,801,"[152, 245, 46, 89, 124, 243, 224, 226, 11, 141, 124, 0, 55, 210, 245, 107, 166, 260, 168, 248, 22, 221, 125, 81, 63, 199, 124]"
42,11,4203,1694,7796,0,973,3230,"[265, 852, 419, 706, 136, 756, 453, 15, 911, 466, 630, 0, 108, 104, 386, 691, 770, 797, 307, 42, 120, 995, 278, 958, 197, 321, 576]"
43,11,4123,6226,5693,0,3290,833,"[109, 17, 74, 263, 237, 242, 164, 4, 271, 121, 61, 0, 170, 272, 150, 18, 246, 116, 100, 201, 168, 245, 96, 162, 14, 235, 188]"
44,11,4106,1949,7850,0,2177,1929,"[526, 54, 505, 480, 353, 356, 2, 581, 492, 51, 457, 0, 83, 193, 395, 197, 383, 344, 196, 249, 626, 569, 601, 205, 561, 224, 81]"
45,11,4925,5401,7374,0,4067,858,"[11, 73, 99, 95, 112, 282, 256, 207, 275, 285, 275, 0, 131, 241, 100, 232, 271, 166, 267, 242, 113, 113, 92, 163, 44, 263, 179]"
46,11,3885,7191,4068,0,395,3490,"[399, 11, 507, 894, 230, 1140, 523, 305, 512, 957, 447, 0, 954, 628, 857, 560, 1060, 143, 645, 614, 1017, 761, 1138, 1084, 457, 705, 752]"
47,11,3173,2984,4257,0,1370,1803,"[60, 351, 392, 318, 521, 552, 198, 403, 303, 120, 13, 0, 33, 420, 280, 390, 192, 537, 384, 126, 231, 184, 189, 214, 178, 403, 338]"
48,11,3278,1859,5676,0,1533,1745,"[84, 296, 206, 367, 471, 461, 518, 158, 233, 442, 239, 0, 67, 299, 160, 220, 573, 204, 138, 166, 47, 302, 345, 433, 331, 402, 393]"
49,11,4166,45,9797,0,2469,1697,"[563, 53, 109, 325, 515, 426, 489, 489, 417, 348, 484, 0, 483, 282, 288, 187, 494, 175, 550, 561, 476, 501, 320, 239, 156, 388, 529]"
50,11,3917,5376,8338,0,2967,950,"[303, 213, 98, 126, 297, 97, 154, 259, 122, 281, 158, 0, 244, 308, 173, 198, 203, 99, 111, 113, 57, 278, 265, 69, 289, 102, 86]"
51,11,3840,6136,6042,0,308,3532,"[938, 634, 94, 88, 339, 608, 219, 580, 373, 976, 210, 0, 280, 204, 1105, 572, 608, 1023, 493, 553, 282, 1154, 206, 158, 131, 974, 321]"
52,11,3499,2814,6727,0,1915,1584,"[141, 233, 1, 379, 112, 211, 414, 519, 32, 315, 452, 0, 301, 8, 25, 453, 480, 256, 318, 334, 296, 315, 350, 19, 264, 368, 524]"
53,11,3847,2477,8097,0,406,3441,"[1116, 1084, 915, 729, 433, 851, 824, 681, 871, 393, 676, 0, 16, 304, 203, 520, 887, 321, 929, 327, 113, 546, 374, 458, 52, 15, 381]"
54,11,3467,5245,6319,0,836,2631,"[467, 709, 428, 712, 298, 95, 477, 57, 325, 620, 24, 0, 315, 835, 227, 827, 335, 689, 464, 24, 848, 272, 844, 66, 286, 687, 37]"
55,11,4323,1598,9044,0,1665,2658,"[881, 2, 477, 379, 466, 400, 176, 386, 368, 58, 325, 0, 42, 2, 363, 107, 100, 76, 337, 264, 758, 258, 89, 719, 77, 606, 218]"
56,11,3624,5482,7186,0,335,3289,"[519, 4, 67, 270, 665, 290, 819, 1084, 223, 770, 667, 0, 529, 606, 489, 504, 1045, 219, 755, 398, 597, 199, 299, 550, 63, 802, 994]"
57,11,3823,6295,4714,0,3376,447,"[96, 126, 15, 4, 54, 44, 104, 137, 112, 28, 3, 0, 2, 137, 120, 59, 44, 116, 105, 21, 104, 78, 41, 41, 18, 112, 104]"
58,11,4422,106,9030,0,114,4308,"[1289, 363, 158, 245, 78, 1239, 1106, 635, 577, 675, 1227, 0, 858, 220, 1270, 326, 696, 714, 1097, 1352, 889, 577, 535, 407, 390, 1405, 1103]"
59,11,4654,5786,7898,0,3213,1441,"[50, 116, 288, 285, 281, 32, 373, 381, 360, 215, 44, 0, 96, 250, 265, 77, 365, 7, 129, 286, 468, 268, 327, 76, 171, 67, 353]"
60,11,4406,6499,5805,0,3228,1178,"[265, 315, 13, 164, 192, 25, 241, 298, 360, 143, 128, 0, 128, 179, 191, 329, 171, 53, 106, 6, 2, 319, 88, 59, 364, 63, 267]"
61,11,3279,278,8806,0,965,2314,"[487, 152, 436, 608, 749, 16, 412, 157, 717, 398, 219, 0, 558, 712, 541, 727, 167, 60, 455, 287, 588, 13, 114, 390, 729, 488, 329]"
62,11,3933,5925,6814,0,3409,524,"[61, 93, 14, 112, 147, 117, 53, 7, 96, 37, 141, 0, 160, 129, 81, 136, 173, 57, 65, 8, 46, 84, 74, 156, 29, 17, 92]"
63,11,4884,5100,6598,0,2583,2301,"[470, 112, 187, 466, 730, 464, 694, 583, 464, 296, 20, 0, 688, 372, 739, 224, 582, 250, 435, 373, 65, 131, 570, 725, 455, 229, 526]"
64,11,4383,2150,8831,0,3548,835,"[7, 138, 221, 4, 77, 219, 203, 224, 184, 119, 143, 0, 153, 212, 278, 112, 10, 116, 238, 139, 253, 84, 24, 61, 28, 221, 195]"
65,11,3549,6076,6304,0,2984,565,"[87, 171, 14, 75, 63, 87, 23, 141, 130, 133, 33, 0, 105, 72, 105, 125, 181, 118, 47, 36, 53, 38, 154, 88, 112, 98, 17]"
66,11,4730,5887,5147,0,4222,508,"[26, 139, 122, 156, 118, 76, 76, 11, 114, 160, 143, 0, 143, 122, 16, 126, 1, 7, 165, 35, 164, 11, 22, 85, 23, 96, 115]"
67,11,4421,2018,7550,0,3536,885,"[67, 239, 274, 119, 281, 261, 256, 105, 24, 109, 171, 0, 254, 90, 279, 114, 242, 139, 13, 39, 208, 237, 41, 222, 36, 252, 24]"
68,11,4689,7246,4993,0,959,3730,"[357, 65, 776, 806, 647, 487, 407, 55, 1096, 190, 46, 0, 104, 274, 334, 852, 447, 728, 108, 781, 822, 423, 893, 451, 1065, 668, 270]"
69,11,4051,2740,6304,0,2510,1541,"[27, 24, 248, 203, 165, 414, 288, 99, 103, 204, 489, 0, 6, 513, 140, 122, 343, 201, 156, 437, 55, 63, 440, 149, 109, 390, 285]"
70,11,4906,6475,4735,0,4592,314,"[48, 74, 48, 2, 65, 94, 23, 102, 1, 20, 27, 0, 81, 75, 95, 14, 97, 11, 41, 60, 77, 80, 52, 15, 55, 28, 101]"
71,11,3429,1879,6285,0,1805,1624,"[249, 344, 143, 288, 250, 251, 289, 267, 139, 401, 10, 0, 255, 252, 325, 283, 290, 428, 481, 450, 492, 38, 352, 155, 252, 144, 236]"
72,11,3118,419,8984,0,2275,843,"[212, 110, 223, 56, 57, 37, 13, 167, 117, 272, 55, 0, 256, 101, 224, 127, 89, 149, 33, 121, 123, 153, 179, 176, 272, 158, 154]"
73,11,4489,7083,6390,0,130,4359,"[878, 1218, 369, 451, 1208, 1416, 189, 735, 28, 787, 1237, 0, 1297, 1250, 1220, 1290, 835, 985, 731, 443, 612, 1445, 1141, 1075, 79, 343, 1152]"
74,11,4870,5339,5921,0,3936,934,"[119, 233, 199, 167, 278, 177, 160, 61, 151, 225, 131, 0, 213, 42, 62, 110, 135, 136, 245, 186, 69, 136, 267, 33, 254, 65, 81]"
75,11,4813,931,9803,0,3291,1522,"[42, 124, 507, 441, 104, 183, 132, 400, 361, 5, 111, 0, 382, 135, 21, 252, 227, 240, 189, 41, 173, 52, 27, 196, 389, 491, 29]"
76,11,3690,6690,6803,0,2962,728,"[153, 129, 54, 215, 140, 133, 174, 60, 13, 160, 127, 0, 157, 135, 113, 137, 2, 102, 170, 118, 128, 120, 83, 172, 23, 152, 187]"
77,11,3650,418,10000,35,546,3104,"[711, 574, 665, 926, 895, 1008, 382, 68, 439, 280, 538, 0, 1020, 194, 832, 404, 55, 12, 358, 417, 653, 382, 28, 720, 169, 950, 116]"
78,11,4721,7370,7351,0,720,4001,"[510, 1226, 1281, 78, 234, 386, 661, 294, 844, 874, 737, 0, 677, 428, 751, 676, 849, 590, 410, 712, 106, 1237, 1280, 691, 819, 624, 658]"
79,11,4368,5169,6550,0,1853,2515,"[93, 385, 441, 461, 352, 414, 91, 95, 428, 189, 448, 0, 198, 571, 94, 448, 279, 519, 709, 284, 390, 676, 115, 803, 539, 477, 157]"
80,11,4734,5510,5774,0,3154,1580,"[268, 103, 116, 162, 205, 446, 137, 212, 380, 511, 249, 0, 86, 140, 232, 154, 247, 159, 336, 147, 481, 333, 440, 347, 373, 302, 250]"
81,11,3767,3255,6286,0,3124,643,"[184, 6, 167, 164, 58, 22, 127, 5, 183, 12, 18, 0, 83, 126, 27, 38, 183, 54, 143, 174, 52, 174, 132, 150, 43, 135, 51]"
82,11,3185,937,8534,0,2810,375,"[36, 69, 96, 74, 76, 24, 121, 24, 34, 32, 65, 0, 107, 41, 29, 115, 40, 97, 26, 6, 0, 23, 98, 7, 123, 46, 120]"
83,11,4043,7480,5097,0,890,3153,"[529, 469, 963, 635, 780, 451, 448, 760, 360, 91, 844, 0, 622, 874, 664, 567, 612, 431, 748, 737, 263, 477, 814, 949, 112, 578, 975]"
84,11,3601,522,8176,0,202,3399,"[979, 684, 756, 603, 349, 24, 11, 375, 196, 1095, 541, 0, 413, 1106, 785, 1083, 58, 746, 502, 488, 266, 592, 588, 970, 423, 192, 7]"
85,11,3701,7278,4599,0,833,2868,"[734, 950, 279, 620, 79, 602, 172, 109, 162, 710, 490, 0, 647, 446, 20, 16, 803, 580, 57, 823, 484, 476, 131, 394, 286, 60, 753]"
86,11,4946,501,9044,0,4037,909,"[220, 43, 225, 240, 274, 70, 93, 280, 271, 65, 142, 0, 193, 192, 151, 210, 91, 223, 44, 287, 52, 15, 193, 203, 129, 217, 37]"
87,11,3306,6741,5609,0,1000,2306,"[25, 70, 577, 732, 712, 665, 517, 696, 590, 86, 373, 0, 270, 741, 67, 82, 2, 647, 295, 244, 432, 280, 633, 380, 270, 672, 606]"
88,11,4058,416,9251,0,955,3103,"[362, 396, 252, 65, 443, 519, 905, 906, 117, 810, 312, 0, 172, 139, 978, 262, 309, 782, 396, 799, 75, 474, 866, 648, 637, 879, 471]"
89,11,4478,6300,7429,0,4308,170,"[42, 23, 6, 14, 9, 50, 17, 28, 55, 25, 52, 0, 16, 23, 46, 14, 5, 11, 18, 12, 42, 20, 37, 53, 50, 19, 17]"
90,11,3087,360,10000,156,719,2368,"[566, 59, 492, 116, 504, 714, 767, 316, 187, 270, 126, 0, 523, 146, 597, 391, 411, 783, 236, 279, 178, 364, 626, 334, 536, 373, 40]"
91,11,4841,5039,9802,0,2661,2180,"[149, 493, 104, 608, 413, 437, 492, 74, 274, 644, 648, 0, 165, 703, 209, 124, 436, 518, 354, 413, 515, 158, 667, 484, 72, 693, 156]"
92,11,3301,6346,6757,0,1582,1719,"[288, 194, 416, 26, 217, 42, 260, 396, 453, 445, 25, 0, 10, 495, 58, 219, 521, 537, 60, 257, 18, 17, 382, 496, 314, 28, 481]"
93,11,4593,5248,6102,0,1722,2871,"[284, 523, 920, 832, 305, 407, 598, 801, 943, 840, 452, 0, 584, 264, 109, 320, 548, 872, 765, 409, 415, 124, 332, 94, 578, 788, 832]"
94,11,3894,1665,8331,0,3051,843,"[133, 244, 152, 140, 110, 101, 40, 60, 141, 99, 21, 0, 16, 204, 51, 97, 276, 196, 138, 219, 38, 197, 130, 142, 257, 60, 153]"
95,11,4849,6310,6870,0,2444,2405,"[338, 240, 669, 206, 795, 687, 308, 615, 705, 446, 800, 0, 308, 780, 202, 692, 478, 438, 673, 650, 638, 296, 551, 279, 243, 686, 565]"
96,11,4390,6675,4585,0,1025,3365,"[1070, 943, 491, 516, 820, 352, 1007, 506, 653, 313, 380, 0, 929, 628, 1094, 862, 397, 870, 1121, 655, 920, 1034, 858, 313, 1117, 388, 303]"
97,11,4976,3619,5942,0,73,4903,"[1284, 677, 944, 142, 1207, 1341, 899, 723, 1627, 492, 944, 0, 1395, 1286, 1595, 479, 342, 288, 652, 803, 903, 1437, 989, 608, 213, 417, 399]"
98,11,4778,193,10000,527,4335,443,"[19, 98, 97, 122, 141, 27, 13, 84, 45, 9, 96, 0, 20, 5, 86, 68, 8, 72, 84, 52, 51, 81, 66, 110, 69, 15, 4]"
99,11,3606,7181,6425,0,513,3093,"[346, 685, 487, 132, 368, 438, 532, 830, 955, 429, 963, 0, 301, 439, 31, 248, 716, 861, 652, 851, 484, 644, 204, 497, 1013, 990, 403]"
100,11,3149,219,9355,0,923,2226,"[120, 641, 11, 117, 426, 285, 287, 207, 188, 27, 563, 0, 536, 140, 349, 416, 703, 579, 578, 54, 643, 701, 367, 102, 16, 451, 609]"
101,11,3477,5136,7696,0,2105,1372,"[353, 17, 67, 444, 3, 258, 338, 196, 21, 454, 173, 0, 239, 152, 293, 61, 376, 429, 46, 396, 366, 56, 291, 244, 447, 376, 254]"
102,11,3901,7131,4466,0,2745,1156,"[342, 366, 3, 176, 10, 259, 103, 30, 83, 140, 353, 0, 332, 295, 40, 286, 297, 384, 240, 129, 180, 192, 165, 39, 67, 188, 4]"
103,11,4064,3595,4935,0,2661,1403,"[60, 35, 63, 318, 351, 113, 203, 23, 428, 376, 198, 0, 465, 198, 143, 15, 358, 49, 66, 191, 37, 293, 130, 172, 429, 203, 195]"
104,11,3510,3165,5280,0,1644,1866,"[27, 164, 245, 356, 179, 11, 468, 529, 509, 403, 617, 0, 244, 546, 451, 610, 219, 360, 321, 223, 367, 423, 168, 424, 54, 316, 95]"
105,11,4388,4326,5342,0,4267,121,"[22, 40, 17, 3, 26, 37, 12, 35, 11, 14, 26, 0, 39, 36, 10, 25, 5, 3, 30, 34, 17, 16, 5, 7, 35, 31, 21]"
106,11,4431,2212,7561,0,2514,1917,"[624, 348, 162, 318, 352, 169, 351, 571, 495, 329, 287, 0, 463, 340, 567, 334, 70, 68, 119, 332, 325, 209, 560, 425, 312, 31, 509]"
107,11,3219,2587,8193,0,487,2732,"[86, 527, 856, 164, 358, 235, 33, 158, 750, 891, 519, 0, 546, 124, 809, 624, 822, 170, 900, 130, 30, 69, 505, 799, 582, 831, 443]"
108,11,3975,5481,6687,0,3197,778,"[153, 110, 192, 94, 38, 15, 94, 171, 228, 65, 129, 0, 147, 230, 179, 228, 197, 125, 229, 259, 167, 23, 166, 29, 76, 177, 107]"
109,11,3475,396,9766,0,2126,1349,"[413, 420, 113, 384, 236, 396, 448, 139, 18, 291, 403, 0, 47, 290, 236, 393, 138, 249, 64, 99, 152, 386, 331, 65, 63, 315, 442]"
110,11,3434,6272,6928,0,2209,1225,"[272, 346, 81, 220, 310, 161, 182, 365, 289, 140, 188, 0, 27, 300, 271, 289, 164, 370, 186, 46, 269, 326, 354, 72, 58, 287, 407]"
111,11,4008,1433,9503,0,3587,421,"[88, 75, 112, 27, 69, 61, 22, 140, 87, 88, 68, 0, 133, 122, 41, 0, 100, 50, 76, 3, 110, 115, 137, 64, 1, 43, 14]"
112,11,3197,6027,6673,0,1621,1576,"[296, 160, 252, 238, 374, 397, 354, 470, 484, 483, 290, 0, 331, 386, 490, 504, 335, 273, 225, 245, 255, 192, 178, 221, 53, 487, 394]"
113,11,3340,2538,7475,0,2798,542,"[147, 36, 153, 30, 173, 33, 5, 109, 35, 85, 42, 0, 42, 54, 9, 110, 162, 58, 171, 43, 66, 78, 133, 45, 45, 160, 175]"
114,11,3573,6883,4165,0,436,3137,"[981, 143, 917, 752, 73, 55, 975, 632, 720, 137, 703, 0, 379, 662, 419, 720, 421, 952, 2, 969, 1033, 231, 853, 913, 164, 997, 213]"
115,11,4293,247,8211,0,948,3345,"[74, 882, 727, 351, 751, 996, 956, 585, 216, 731, 751, 0, 611, 1018, 960, 911, 163, 552, 396, 450, 3, 1009, 399, 81, 823, 1044, 368]"
116,11,4949,7298,5862,0,2386,2563,"[328, 17, 317, 24, 30, 379, 406, 177, 496, 516, 629, 0, 799, 58, 629, 735, 235, 569, 437, 337, 844, 176, 437, 290, 287, 0, 512]"
117,11,4633,4109,6386,0,4240,393,"[120, 28, 106, 40, 122, 110, 53, 101, 67, 82, 96, 0, 48, 68, 70, 85, 55, 25, 36, 118, 71, 101, 60, 106, 19, 44, 72]"
118,11,3476,1639,8223,0,2561,915,"[38, 163, 198, 44, 181, 96, 56, 168, 254, 129, 259, 0, 126, 276, 64, 62, 150, 0, 185, 231, 254, 117, 5, 43, 11, 72, 19]"
119,11,3276,6219,5280,0,937,2339,"[610, 427, 188, 108, 644, 501, 739, 380, 668, 692, 336, 0, 695, 313, 724, 675, 427, 184, 565, 397, 311, 557, 653, 474, 290, 344, 668]"
120,11,3276,842,7714,0,1866,1410,"[26, 378, 269, 317, 384, 63, 22, 188, 108, 51, 461, 0, 5, 11, 201, 418, 13, 458, 280, 403, 421, 375, 203, 265, 50, 297, 197]"
121,11,3402,6569,4547,0,1750,1652,"[530, 151, 101, 77, 449, 528, 163, 179, 255, 240, 383, 0, 491, 381, 426, 79, 45, 396, 522, 37, 347, 148, 132, 214, 318, 235, 270]"
122,11,4372,2301,6618,0,1599,2773,"[877, 447, 40, 288, 847, 293, 472, 552, 228, 618, 423, 0, 149, 213, 553, 911, 587, 185, 774, 825, 891, 704, 138, 241, 897, 521, 303]"
123,11,4356,3697,7277,0,3683,673,"[195, 19, 1, 120, 61, 195, 170, 102, 65, 52, 29, 0, 46, 129, 10, 144, 40, 84, 171, 160, 166, 16, 124, 43, 173, 5, 35]"
124,11,3043,247,10000,73,1535,1508,"[277, 356, 297, 54, 433, 134, 81, 326, 298, 466, 54, 0, 50, 45, 437, 427, 303, 469, 211, 264, 39, 16, 455, 232, 488, 235, 404]"
125,11,3794,6266,7528,0,456,3338,"[1111, 385, 592, 64, 195, 85, 1096, 448, 711, 893, 566, 0, 371, 410, 1048, 909, 792, 296, 704, 12, 598, 742, 279, 672, 818, 906, 177]"
126,11,3598,7263,3863,0,2201,1397,"[138, 125, 32, 14, 184, 129, 33, 73, 3, 129, 302, 0, 215, 116, 341, 15, 371, 457, 420, 281, 315, 115, 69, 380, 105, 5, 62]"
127,11,3243,830,6276,0,1548,1695,"[30, 218, 44, 162, 27, 452, 13, 306, 177, 289, 225, 0, 173, 481, 558, 116, 439, 443, 283, 383, 544, 305, 143, 102, 103, 556, 292]"
128,11,4031,274,10000,33,1862,2169,"[555, 214, 177, 201, 363, 682, 460, 116, 110, 622, 88, 0, 600, 646, 689, 605, 225, 427, 274, 634, 351, 178, 609, 709, 232, 513, 371]"
129,11,3907,5958,7949,0,2013,1894,"[470, 563, 360, 282, 251, 560, 444, 313, 416, 357, 551, 0, 149, 332, 504, 514, 13, 485, 551, 235, 452, 432, 438, 359, 189, 565, 246]"
130,11,3678,6381,5246,0,2596,1082,"[19, 40, 343, 207, 31, 98, 152, 99, 248, 310, 113, 0, 245, 137, 247, 85, 293, 340, 135, 49, 18, 318, 111, 250, 171, 260, 40]"
131,11,3193,711,7728,0,811,2382,"[548, 90, 721, 179, 111, 686, 231, 766, 25, 541, 182, 0, 5, 21, 209, 341, 14, 312, 688, 238, 44, 309, 138, 661, 475, 247, 178]"
132,11,3974,6958,4744,0,2058,1916,"[249, 607, 7, 442, 603, 316, 227, 127, 620, 294, 154, 0, 410, 172, 502, 413, 5, 604, 419, 384, 43, 596, 134, 316, 14, 10, 445]"
133,11,3330,1329,6745,0,3023,307,"[45, 81, 77, 16, 96, 54, 78, 91, 55, 41, 23, 0, 37, 95, 99, 72, 38, 35, 24, 46, 84, 80, 53, 35, 69, 18, 79]"
134,11,4493,6981,4257,0,2700,1793,"[575, 228, 21, 252, 411, 565, 271, 171, 516, 57, 11, 0, 216, 544, 278, 446, 81, 495, 130, 268, 13, 315, 109, 424, 344, 35, 346]"
135,11,3439,391,7305,0,2862,577,"[175, 179, 138, 119, 66, 90, 167, 158, 6, 127, 58, 0, 112, 65, 68, 163, 93, 95, 116, 150, 27, 83, 150, 164, 50, 124, 38]"
136,11,3453,30,10000,728,1046,2407,"[695, 523, 61, 308, 705, 39, 288, 97, 489, 744, 759, 0, 588, 212, 646, 746, 160, 195, 542, 611, 767, 562, 639, 191, 208, 311, 683]"
137,11,3048,7436,5612,0,468,2580,"[339, 31, 785, 76, 422, 441, 257, 406, 573, 179, 60, 0, 453, 778, 481, 774, 109, 214, 333, 208, 29, 553, 620, 495, 857, 151, 439]"
138,11,3334,769,8177,0,1737,1597,"[378, 423, 330, 214, 40, 192, 513, 47, 508, 25, 329, 0, 142, 465, 304, 33, 322, 239, 370, 340, 213, 248, 488, 22, 210, 41, 100]"
139,11,3453,5555,6075,0,2803,650,"[186, 185, 2, 43, 123, 113, 124, 22, 179, 46, 75, 0, 155, 29, 20, 185, 139, 191, 62, 60, 167, 61, 159, 204, 141, 162, 136]"
140,11,4412,3831,6656,0,3764,648,"[144, 155, 52, 55, 29, 205, 182, 112, 182, 22, 82, 0, 212, 68, 195, 182, 86, 56, 66, 33, 57, 110, 15, 100, 50, 11, 176]"
141,11,3120,1734,8042,0,678,2442,"[151, 10, 380, 306, 292, 678, 519, 129, 565, 72, 260, 0, 768, 777, 113, 778, 697, 574, 689, 738, 306, 542, 434, 770, 258, 544, 142]"
142,11,4282,7348,4976,0,3677,605,"[12, 109, 184, 173, 30, 79, 176, 69, 123, 60, 145, 0, 106, 72, 99, 99, 180, 69, 90, 160, 54, 166, 41, 158, 71, 137, 181]"
143,11,4144,159,8961,0,746,3398,"[291, 13, 398, 374, 1129, 39, 868, 312, 468, 970, 1041, 0, 390, 1063, 549, 1037, 116, 735, 96, 919, 728, 703, 1125, 685, 335, 1071, 607]"
144,11,4586,5539,8008,0,1294,3292,"[106, 892, 548, 679, 101, 749, 228, 800, 547, 175, 941, 0, 109, 594, 680, 318, 65, 18, 306, 1017, 912, 30, 783, 133, 492, 478, 429]"
145,11,3397,6156,5249,0,303,3094,"[148, 441, 253, 748, 1015, 962, 797, 888, 950, 891, 945, 0, 575, 55, 580, 95, 1024, 786, 26, 458, 337, 130, 985, 830, 448, 290, 343]"
146,11,4708,1325,8632,0,1365,3343,"[765, 854, 139, 215, 73, 582, 394, 1024, 45, 710, 158, 0, 674, 42, 671, 339, 560, 436, 165, 376, 946, 239, 431, 871, 746, 47, 367]"
147,11,4346,6128,6850,0,2450,1896,"[163, 43, 100, 613, 208, 293, 271, 315, 134, 388, 231, 0, 270, 289, 59, 601, 160, 164, 508, 255, 158, 467, 609, 26, 248, 274, 16]"
148,11,3932,2225,8557,0,408,3524,"[967, 871, 441, 605, 889, 1074, 514, 296, 1031, 730, 812, 0, 360, 832, 141, 1011, 1131, 667, 648, 562, 423, 677, 882, 1129, 130, 1141, 810]"
149,11,4381,7441,5497,0,1655,2726,"[843, 797, 580, 697, 441, 102, 177, 194, 207, 783, 4, 0, 426, 186, 858, 739, 668, 2, 619, 615, 790, 724, 668, 360, 595, 832, 870]"
150,11,4527,2570,7454,0,2857,1670,"[218, 36, 340, 106, 247, 165, 548, 504, 303, 53, 272, 0, 424, 525, 43, 547, 119, 280, 291, 428, 14, 295, 228, 308, 24, 503, 53]"
151,11,4448,5789,6113,0,3845,603,"[84, 76, 180, 41, 25, 120, 73, 98, 85, 51, 33, 0, 80, 197, 172, 20, 55, 74, 58, 31, 143, 129, 100, 82, 130, 49, 200]"
152,11,4495,3694,6914,0,789,3706,"[527, 1201, 1162, 679, 644, 892, 439, 520, 981, 341, 130, 0, 114, 873, 928, 1079, 1072, 1127, 214, 575, 659, 947, 142, 589, 250, 1010, 712]"
153,11,4524,7112,4326,0,3171,1353,"[318, 329, 230, 250, 422, 364, 0, 35, 424, 264, 436, 0, 268, 439, 173, 49, 266, 231, 331, 107, 190, 146, 61, 409, 312, 389, 346]"
154,11,4742,2526,6542,0,4008,734,"[219, 219, 59, 188, 16, 190, 132, 91, 72, 20, 201, 0, 84, 238, 227, 160, 214, 102, 1, 188, 143, 243, 5, 5, 242, 23, 41]"
155,11,4029,677,9894,0,3759,270,"[20, 61, 63, 6, 12, 55, 17, 39, 57, 68, 24, 0, 43, 26, 66, 81, 87, 47, 0, 76, 85, 26, 68, 39, 11, 51, 62]"
156,11,3930,5615,8209,0,1172,2758,"[273, 908, 913, 917, 268, 590, 634, 342, 403, 459, 627, 0, 252, 875, 874, 715, 223, 724, 168, 680, 31, 723, 587, 767, 690, 828, 341]"
157,11,3462,5415,6256,0,3383,79,"[0, 3, 3, 13, 24, 1, 7, 14, 2, 10, 14, 0, 20, 21, 25, 7, 24, 14, 4, 18, 0, 6, 13, 21, 13, 15, 23]"
158,11,3073,1380,7949,0,2448,625,"[28, 206, 77, 117, 147, 55, 17, 82, 15, 164, 175, 0, 141, 7, 198, 85, 91, 69, 108, 149, 38, 69, 101, 132, 28, 142, 39]"
159,11,3636,5039,6546,0,441,3195,"[1054, 360, 703, 221, 524, 188, 421, 916, 738, 156, 130, 0, 115, 872, 503, 60, 69, 906, 725, 18, 942, 872, 598, 279, 168, 21, 162]"
160,11,4859,6391,5014,0,3204,1655,"[226, 65, 259, 408, 144, 473, 247, 401, 25, 130, 484, 0, 357, 495, 281, 240, 273, 100, 80, 341, 392, 163, 263, 66, 528, 375, 201]"
161,11,3541,3451,5104,0,1036,2505,"[736, 503, 329, 474, 678, 828, 641, 362, 56, 831, 500, 0, 547, 539, 257, 537, 343, 574, 419, 711, 224, 656, 137, 576, 774, 604, 270]"
162,11,4820,1026,8898,0,712,4108,"[778, 502, 1250, 756, 511, 53, 878, 891, 451, 302, 802, 0, 59, 397, 1311, 652, 655, 1091, 1137, 349, 629, 933, 1006, 435, 1064, 294, 1240]"
163,11,4603,5149,8352,0,3561,1042,"[45, 92, 291, 254, 313, 310, 284, 230, 28, 80, 219, 0, 289, 345, 338, 332, 258, 337, 234, 25, 251, 19, 253, 298, 233, 5, 25]"
164,11,3263,5476,6139,0,1153,2110,"[370, 183, 341, 86, 632, 634, 280, 474, 245, 557, 245, 0, 289, 527, 502, 538, 242, 185, 596, 321, 464, 659, 234, 583, 348, 300, 126]"
165,11,3769,1793,8115,0,2324,1445,"[430, 58, 395, 176, 249, 273, 234, 205, 346, 342, 53, 0, 444, 233, 277, 263, 322, 318, 6, 219, 367, 287, 281, 167, 178, 75, 442]"
166,11,4333,7418,5030,0,3781,552,"[158, 64, 8, 114, 10, 40, 58, 97, 155, 17, 60, 0, 45, 134, 148, 174, 9, 98, 181, 140, 111, 8, 0, 38, 67, 70, 5]"
167,11,3411,2638,5803,0,2739,672,"[147, 18, 190, 166, 6, 19, 96, 35, 108, 42, 61, 0, 219, 168, 220, 2, 104, 142, 141, 164, 117, 41, 10, 168, 72, 66, 142]"
168,11,3754,781,8776,0,88,3666,"[1079, 125, 1081, 834, 463, 429, 157, 217, 877, 1077, 615, 0, 1068, 1040, 372, 542, 307, 405, 705, 318, 748, 718, 979, 876, 31, 775, 264]"
169,11,4014,6858,5932,0,1882,2132,"[313, 476, 473, 572, 643, 90, 44, 169, 443, 431, 366, 0, 657, 81, 440, 61, 35, 360, 215, 250, 230, 251, 647, 580, 435, 197, 598]"
170,11,3399,1258,8073,0,1499,1900,"[465, 451, 119, 383, 426, 557, 475, 517, 622, 494, 496, 0, 206, 254, 551, 385, 222, 36, 444, 179, 605, 219, 82, 92, 248, 430, 599]"
171,11,4187,6825,5435,0,162,4025,"[1216, 1280, 878, 993, 534, 95, 1324, 1274, 1132, 159, 214, 0, 128, 537, 363, 1143, 995, 885, 235, 917, 493, 560, 1333, 871, 1134, 941, 1277]"
172,11,3893,3169,6159,0,1140,2753,"[258, 599, 357, 878, 288, 519, 57, 259, 568, 403, 346, 0, 823, 386, 438, 749, 434, 850, 500, 660, 823, 547, 290, 104, 311, 645, 905]"
173,11,3241,1793,7607,0,562,2679,"[448, 878, 753, 793, 841, 240, 853, 596, 717, 845, 792, 0, 95, 184, 467, 757, 831, 313, 15, 750, 879, 657, 104, 846, 348, 885, 258]"
174,11,4925,5733,6799,0,4335,590,"[163, 63, 93, 32, 187, 122, 190, 26, 115, 102, 15, 0, 135, 147, 114, 48, 18, 158, 36, 73, 81, 149, 60, 139, 71, 111, 113]"
175,11,4654,6307,5146,0,4583,71,"[11, 19, 5, 23, 6, 12, 4, 19, 3, 12, 1, 0, 2, 4, 4, 16, 22, 21, 1, 17, 22, 17, 7, 23, 22, 2, 14]"
176,11,3098,128,8116,0,2108,990,"[79, 73, 103, 83, 141, 135, 138, 141, 151, 196, 269, 0, 62, 246, 70, 43, 209, 329, 140, 133, 221, 167, 282, 62, 84, 96, 319]"
177,11,4555,6466,6205,0,2643,1912,"[517, 28, 413, 66, 205, 18, 424, 162, 511, 219, 331, 0, 544, 104, 518, 257, 1, 267, 295, 617, 527, 195, 611, 190, 299, 430, 326]"
178,11,4619,3827,6997,0,3140,1479,"[146, 315, 12, 387, 235, 91, 410, 235, 107, 322, 84, 0, 335, 207, 89, 463, 65, 295, 101, 222, 470, 293, 99, 74, 405, 324, 277]"
179,11,3956,2287,8666,0,2265,1691,"[183, 5, 91, 222, 492, 531, 256, 517, 112, 407, 486, 0, 211, 310, 108, 531, 48, 185, 331, 248, 127, 257, 341, 65, 263, 98, 559]"
180,11,3671,7252,5085,0,2994,677,"[99, 182, 72, 152, 76, 206, 60, 198, 50, 103, 101, 0, 169, 118, 119, 122, 50, 144, 50, 185, 194, 106, 141, 128, 47, 74, 158]"
181,11,3576,3285,5376,0,1228,2348,"[0, 732, 409, 66, 276, 693, 61, 332, 708, 97, 384, 0, 782, 209, 415, 709, 703, 23, 537, 295, 371, 246, 400, 530, 551, 585, 337]"
182,11,4086,2564,6898,0,2465,1621,"[356, 465, 13, 424, 243, 36, 527, 37, 424, 124, 261, 0, 1, 450, 206, 354, 38, 330, 75, 198, 147, 112, 180, 283, 393, 357, 67]"
183,11,4349,7073,4174,0,230,4119,"[1153, 572, 958, 360, 1128, 921, 954, 1096, 1178, 644, 1111, 0, 845, 138, 1365, 953, 1304, 222, 1022, 525, 834, 251, 985, 237, 673, 605, 1214]"
184,11,3803,2012,5965,0,1814,1989,"[386, 180, 448, 356, 338, 367, 510, 217, 250, 209, 583, 0, 564, 388, 548, 59, 561, 365, 101, 37, 306, 164, 206, 90, 641, 447, 604]"
185,11,4799,1687,9077,0,3333,1466,"[4, 25, 212, 450, 64, 483, 340, 10, 235, 481, 176, 0, 332, 320, 79, 237, 325, 439, 0, 192, 335, 354, 407, 279, 18, 382, 65]"
186,11,3521,5855,6743,0,1466,2055,"[26, 397, 60, 97, 122, 287, 313, 317, 636, 572, 239, 0, 149, 220, 519, 628, 652, 496, 35, 488, 40, 326, 525, 4, 655, 72, 372]"
187,11,4089,2773,8059,0,1306,2783,"[650, 660, 621, 166, 790, 384, 898, 33, 582, 921, 500, 0, 195, 51, 394, 135, 918, 304, 31, 74, 500, 828, 59, 32, 37, 112, 911]"
188,11,3027,6832,4254,0,1752,1275,"[138, 8, 94, 161, 424, 150, 189, 1, 156, 264, 402, 0, 47, 156, 329, 302, 277, 103, 296, 210, 105, 392, 226, 380, 409, 371, 70]"
189,11,3361,571,7044,0,2958,403,"[122, 47, 117, 36, 5, 90, 39, 90, 116, 111, 118, 0, 40, 120, 11, 71, 15, 60, 82, 124, 44, 133, 125, 96, 132, 102, 67]"
190,11,4677,7062,4659,0,4556,121,"[15, 26, 10, 38, 36, 29, 38, 27, 5, 27, 9, 0, 14, 40, 18, 2, 14, 9, 35, 20, 17, 7, 17, 28, 40, 30, 38]"
191,11,3436,1108,6987,0,672,2764,"[480, 27, 421, 637, 706, 853, 655, 352, 99, 106, 337, 0, 698, 140, 653, 471, 284, 322, 288, 134, 529, 732, 262, 867, 550, 251, 159]"
192,11,4693,7276,4404,0,1151,3542,"[343, 148, 1042, 804, 213, 65, 951, 599, 82, 287, 99, 0, 77, 65, 308, 530, 1155, 199, 291, 888, 429, 680, 1101, 1056, 663, 835, 1018]"
193,11,3068,2975,4497,0,1156,1912,"[441, 390, 31, 300, 309, 593, 302, 162, 351, 573, 422, 0, 281, 254, 53, 414, 280, 297, 378, 325, 129, 509, 137, 403, 604, 586, 609]"
194,11,4753,10,9240,0,2091,2662,"[319, 240, 675, 840, 702, 44, 373, 560, 346, 120, 556, 0, 859, 773, 847, 569, 821, 350, 96, 292, 732, 193, 186, 238, 636, 224, 873]"
195,11,4035,5356,7919,0,2530,1505,"[488, 62, 312, 241, 36, 257, 316, 4, 165, 116, 33, 0, 357, 4, 215, 414, 364, 5, 146, 76, 99, 408, 116, 243, 336, 208, 407]"
196,11,3664,6626,4957,0,2063,1601,"[192, 249, 353, 391, 205, 35, 463, 113, 26, 428, 161, 0, 33, 502, 214, 66, 296, 494, 139, 327, 457, 311, 113, 92, 398, 107, 304]"
197,11,3500,3159,5298,0,3394,106,"[16, 0, 32, 0, 35, 22, 7, 13, 14, 10, 21, 0, 13, 29, 35, 30, 34, 7, 16, 3, 11, 12, 4, 9, 27, 31, 3]"
198,11,4793,244,9847,0,497,4296,"[1374, 623, 772, 967, 61, 315, 1020, 1341, 466, 709, 584, 0, 1116, 189, 842, 301, 724, 1011, 917, 1403, 1025, 1044, 486, 18, 1162, 599, 601]"
199,11,3274,7013,6108,0,2041,1233,"[43, 150, 243, 405, 205, 160, 143, 279, 232, 211, 15, 0, 219, 402, 154, 119, 329, 168, 210, 16, 24, 405, 245, 326, 34, 356, 389]"
200,11,4106,4102,6112,0,654,3452,"[465, 147, 36, 459, 321, 77, 265, 468, 1057, 965, 955, 0, 691, 911, 940, 699, 200, 947, 733, 952, 528, 145, 887, 309, 535, 592, 758]"
201,11,4047,272,9887,0,3670,377,"[99, 1, 67, 114, 83, 33, 8, 125, 118, 63, 3, 0, 63, 99, 8, 20, 123, 100, 94, 15, 80, 2, 47, 14, 20, 104, 10]"
202,11,4396,5079,9204,0,4085,311,"[65, 39, 102, 9, 41, 56, 53, 73, 51, 15, 80, 0, 99, 20, 29, 97, 60, 57, 67, 70, 60, 63, 41, 71, 24, 43, 3]"
203,11,3995,5956,7243,0,2786,1209,"[1, 97, 5, 46, 14, 64, 135, 376, 276, 138, 109, 0, 21, 262, 76, 261, 39, 342, 239, 144, 198, 349, 44, 360, 256, 99, 259]"
204,11,4020,6786,4477,0,882,3138,"[519, 971, 555, 823, 230, 866, 439, 952, 643, 606, 603, 0, 645, 1017, 828, 582, 821, 32, 1012, 919, 724, 658, 226, 850, 803, 182, 956]"
205,11,3814,1251,7040,0,491,3323,"[680, 272, 364, 998, 1042, 780, 416, 1025, 255, 305, 698, 0, 38, 492, 68, 847, 397, 156, 84, 785, 948, 522, 526, 431, 1016, 675, 905]"
206,11,4659,7143,4556,0,3631,1028,"[60, 166, 7, 53, 290, 309, 286, 156, 164, 170, 189, 0, 56, 228, 148, 333, 204, 19, 18, 113, 92, 222, 264, 169, 178, 136, 277]"
207,11,3438,3175,4819,0,2544,894,"[71, 227, 67, 44, 145, 22, 128, 250, 273, 188, 226, 0, 148, 290, 73, 24, 158, 122, 283, 135, 194, 235, 76, 239, 170, 19, 81]"
208,11,4094,483,8430,0,1392,2702,"[289, 388, 224, 20, 551, 469, 368, 18, 190, 708, 715, 0, 674, 744, 894, 264, 512, 297, 187, 660, 481, 186, 335, 888, 432, 156, 458]"
209,11,4807,5966,7271,0,4806,1,"[0, 0, 0, 0, 0, 0, 0, 0, 0, 0, 0, 0, 0, 0, 0, 0, 0, 0, 0, 0, 0, 0, 0, 0, 0, 0, 0]"
210,11,4484,6965,4790,0,1596,2888,"[218, 92, 416, 741, 370, 184, 220, 394, 20, 902, 574, 0, 883, 657, 763, 787, 917, 556, 556, 495, 626, 324, 706, 592, 927, 852, 704]"
211,11,3053,1636,6207,0,1810,1243,"[91, 305, 346, 93, 364, 293, 327, 45, 190, 366, 394, 0, 396, 55, 8, 317, 116, 223, 149, 209, 304, 317, 84, 36, 124, 165, 157]"
212,11,4063,2690,7580,0,792,3271,"[888, 765, 342, 370, 619, 61, 1026, 981, 783, 167, 255, 0, 214, 319, 273, 1078, 474, 235, 495, 799, 1020, 975, 770, 1049, 998, 618, 476]"
213,11,4117,5757,5940,0,2330,1787,"[51, 382, 324, 345, 365, 301, 141, 535, 95, 542, 482, 0, 188, 209, 322, 467, 361, 146, 363, 117, 238, 306, 546, 283, 209, 5, 92]"
214,11,4642,4363,6219,0,2839,1803,"[430, 585, 356, 9, 170, 252, 209, 547, 26, 452, 141, 0, 129, 432, 268, 454, 86, 53, 109, 325, 408, 53, 373, 182, 122, 181, 197]"
215,11,3322,873,8668,0,2686,636,"[13, 60, 123, 204, 101, 126, 209, 176, 113, 36, 29, 0, 62, 155, 206, 161, 189, 53, 52, 194, 163, 0, 128, 162, 197, 96, 21]"
216,11,3826,5301,7193,0,2780,1046,"[231, 115, 18, 291, 13, 294, 294, 260, 137, 26, 273, 0, 217, 152, 243, 314, 312, 272, 210, 253, 332, 208, 145, 69, 195, 134, 276]"
217,11,3857,7167,3883,0,2387,1470,"[286, 312, 71, 344, 175, 67, 365, 280, 190, 234, 211, 0, 106, 179, 93, 4, 387, 126, 84, 144, 2, 416, 316, 301, 133, 313, 364]"
218,11,4718,899,7702,0,1191,3527,"[386, 502, 1004, 203, 1093, 1092, 599, 381, 31, 370, 1053, 0, 1123, 549, 951, 946, 1134, 785, 614, 270, 409, 664, 905, 405, 1107, 845, 43]"
219,11,3139,2984,7857,0,1504,1635,"[398, 504, 360, 397, 218, 245, 157, 285, 406, 397, 459, 0, 422, 67, 354, 436, 83, 411, 313, 405, 399, 286, 53, 47, 492, 271, 520]"
220,11,3327,6850,4334,0,2581,746,"[54, 181, 91, 37, 109, 27, 147, 114, 244, 29, 215, 0, 184, 179, 64, 90, 36, 56, 162, 220, 178, 74, 155, 244, 3, 156, 146]"
221,11,3042,2836,4540,0,2251,791,"[44, 34, 95, 86, 206, 101, 113, 12, 20, 204, 24, 0, 62, 148, 149, 161, 7, 87, 116, 101, 56, 183, 247, 227, 83, 21, 165]"
222,11,3309,3270,4579,0,2452,857,"[20, 253, 230, 170, 276, 116, 87, 278, 163, 33, 108, 0, 69, 244, 55, 100, 126, 102, 111, 238, 71, 138, 138, 246, 200, 20, 34]"
223,11,3066,2173,5472,0,1355,1711,"[544, 235, 565, 380, 476, 399, 402, 277, 51, 530, 36, 0, 284, 208, 31, 516, 141, 487, 545, 527, 526, 200, 439, 374, 112, 148, 205]"
224,11,3134,1890,6716,0,1247,1887,"[337, 222, 587, 339, 190, 493, 272, 139, 132, 9, 192, 0, 426, 237, 550, 450, 352, 462, 548, 82, 218, 171, 72, 451, 81, 482, 420]"
225,11,4294,7347,3663,0,163,4131,"[146, 590, 1025, 431, 1282, 592, 935, 991, 155, 1032, 1293, 0, 548, 564, 33, 386, 892, 630, 284, 646, 947, 834, 46, 1160, 1214, 946, 1028]"
226,11,4610,3493,4780,0,528,4082,"[396, 545, 569, 336, 909, 750, 1069, 961, 1226, 800, 204, 0, 747, 1294, 836, 265, 345, 450, 543, 1055, 1123, 166, 17, 934, 1308, 743, 1047]"
227,11,4319,2478,6621,0,3571,748,"[199, 192, 246, 242, 91, 184, 60, 85, 167, 10, 62, 0, 60, 90, 131, 89, 67, 232, 84, 19, 133, 209, 94, 121, 97, 191, 117]"
228,11,3443,1004,9060,0,1490,1953,"[215, 239, 59, 409, 361, 114, 337, 562, 108, 184, 15, 0, 21, 154, 324, 350, 461, 175, 314, 202, 246, 111, 561, 630, 219, 187, 239]"
229,11,3703,6636,6127,0,2901,802,"[17, 160, 65, 117, 196, 117, 67, 106, 190, 155, 3, 0, 106, 57, 77, 160, 250, 152, 183, 127, 226, 140, 235, 95, 54, 19, 49]"
230,11,4611,1635,9103,0,3880,731,"[227, 169, 150, 185, 154, 198, 176, 197, 177, 0, 27, 0, 86, 121, 44, 128, 43, 20, 97, 51, 33, 177, 211, 192, 97, 204, 183]"
231,11,4503,5210,8396,0,1640,2863,"[665, 728, 127, 393, 752, 187, 890, 777, 769, 487, 718, 0, 951, 131, 269, 222, 460, 808, 185, 27, 111, 712, 707, 202, 568, 506, 885]"
232,11,4136,6533,5999,0,3288,848,"[236, 164, 207, 158, 277, 230, 84, 236, 241, 186, 259, 0, 187, 282, 240, 231, 278, 202, 267, 257, 49, 132, 166, 265, 7, 78, 150]"
233,11,3298,643,8654,0,1444,1854,"[510, 369, 218, 533, 510, 137, 36, 57, 114, 360, 46, 0, 378, 258, 178, 287, 287, 24, 100, 305, 134, 314, 523, 166, 99, 60, 399]"
234,11,4781,5082,8353,0,1973,2808,"[148, 646, 341, 437, 591, 668, 746, 544, 688, 23, 124, 0, 746, 252, 889, 854, 517, 45, 657, 748, 261, 866, 390, 878, 138, 387, 526]"
235,11,4519,5431,7441,0,2843,1676,"[498, 99, 53, 108, 350, 512, 263, 102, 251, 499, 191, 0, 524, 37, 318, 165, 100, 305, 301, 329, 270, 182, 263, 62, 490, 260, 46]"
236,11,4100,7136,4405,0,2597,1503,"[234, 38, 100, 50, 278, 415, 449, 131, 155, 231, 210, 0, 368, 422, 370, 378, 251, 335, 446, 242, 416, 483, 412, 297, 327, 394, 329]"
237,11,4893,3775,5523,0,51,4842,"[839, 751, 810, 282, 167, 1077, 201, 939, 713, 242, 242, 0, 831, 1061, 1166, 161, 469, 1352, 1350, 942, 384, 603, 873, 1111, 1173, 1511, 67]"
238,11,4982,1041,9464,0,4300,682,"[38, 44, 7, 22, 86, 175, 166, 30, 173, 227, 11, 0, 66, 51, 122, 30, 205, 203, 30, 23, 95, 14, 224, 226, 217, 106, 109]"
239,11,4460,7107,6817,0,1516,2944,"[896, 909, 210, 764, 311, 718, 244, 240, 779, 329, 361, 0, 80, 222, 675, 911, 149, 858, 61, 747, 598, 238, 229, 633, 625, 506, 211]"
240,11,4365,6011,5171,0,288,4077,"[346, 235, 1098, 754, 14, 81, 922, 862, 445, 1031, 1025, 0, 1222, 1328, 1029, 239, 972, 1247, 366, 1006, 1191, 177, 341, 116, 128, 764, 1288]"
241,11,4582,4270,5483,0,4458,124,"[34, 0, 18, 22, 30, 7, 10, 23, 1, 4, 32, 0, 10, 35, 7, 17, 7, 22, 35, 1, 35, 33, 2, 27, 11, 10, 8]"
242,11,4330,165,9648,0,752,3578,"[1092, 404, 374, 20, 62, 547, 1109, 87, 1025, 722, 361, 0, 1013, 42, 648, 971, 371, 195, 697, 302, 601, 527, 158, 129, 808, 952, 246]"
243,11,3844,5882,7610,0,2179,1665,"[78, 392, 181, 353, 121, 405, 537, 125, 458, 49, 98, 0, 450, 418, 193, 396, 103, 407, 214, 552, 128, 421, 494, 339, 483, 96, 486]"
244,11,3904,7080,4434,0,2291,1613,"[246, 329, 92, 82, 5, 51, 310, 27, 337, 216, 115, 0, 204, 258, 255, 405, 104, 96, 299, 339, 378, 285, 298, 259, 132, 521, 399]"
245,11,4050,358,8126,0,3925,125,"[23, 15, 21, 5, 37, 0, 5, 8, 20, 27, 30, 0, 34, 11, 21, 17, 38, 12, 36, 41, 12, 24, 20, 16, 11, 41, 11]"
246,11,3739,6124,5741,0,1312,2427,"[367, 778, 183, 624, 63, 659, 381, 633, 10, 35, 536, 0, 453, 427, 544, 681, 753, 618, 685, 326, 326, 678, 752, 715, 402, 386, 123]"
247,11,4644,3185,7200,0,948,3696,"[261, 233, 276, 43, 688, 582, 631, 860, 262, 838, 1127, 0, 60, 1065, 255, 1219, 251, 301, 515, 993, 1154, 814, 836, 1003, 286, 539, 296]"
248,11,4604,5045,6759,0,1098,3506,"[362, 513, 824, 1111, 479, 841, 484, 240, 288, 216, 447, 0, 272, 143, 88, 484, 1074, 920, 247, 1118, 1161, 517, 1104, 925, 907, 596, 748]"
249,11,3768,1889,8638,0,2116,1652,"[47, 177, 499, 512, 519, 291, 306, 375, 162, 544, 211, 0, 521, 289, 426, 345, 33, 355, 254, 105, 379, 154, 156, 212, 303, 293, 31]"
250,11,3350,6801,5187,0,2246,1104,"[165, 70, 204, 224, 9, 204, 318, 68, 182, 86, 350, 0, 180, 127, 254, 154, 190, 326, 198, 335, 22, 364, 280, 349, 120, 243, 318]"
251,11,4956,1853,8290,0,2218,2738,"[852, 721, 846, 556, 346, 378, 376, 457, 384, 125, 204, 0, 501, 757, 438, 668, 52, 836, 903, 780, 601, 831, 148, 474, 453, 665, 434]"
252,11,4007,5113,7184,0,2717,1290,"[148, 424, 302, 111, 99, 396, 282, 120, 384, 216, 17, 0, 214, 161, 183, 401, 114, 105, 401, 42, 288, 75, 36, 216, 151, 334, 68]"
253,11,3997,7059,4122,0,3635,362,"[85, 108, 66, 1, 15, 13, 43, 120, 47, 47, 65, 0, 29, 8, 116, 44, 107, 75, 108, 25, 66, 113, 106, 94, 34, 80, 74]"
254,11,3272,1858,5536,0,722,2550,"[754, 749, 413, 682, 526, 610, 838, 422, 782, 77, 164, 0, 394, 740, 540, 396, 245, 88, 189, 8, 113, 209, 493, 664, 184, 10, 420]"
255,11,4959,1157,9338,0,3294,1665,"[365, 59, 18, 107, 39, 344, 302, 160, 373, 369, 286, 0, 414, 170, 440, 449, 433, 415, 157, 418, 462, 348, 262, 34, 346, 70, 377]"
256,11,3148,6883,5603,0,2746,402,"[66, 75, 16, 10, 126, 91, 43, 27, 112, 103, 102, 0, 33, 31, 15, 102, 130, 110, 71, 3, 124, 11, 79, 23, 25, 101, 129]"
257,11,4536,4281,5858,0,3040,1496,"[166, 449, 279, 265, 468, 443, 356, 184, 232, 198, 275, 0, 490, 205, 443, 420, 405, 255, 90, 290, 430, 8, 298, 163, 487, 192, 155]"
258,11,4569,3993,6434,0,1306,3263,"[936, 89, 432, 87, 600, 658, 348, 813, 437, 981, 764, 0, 657, 538, 1072, 942, 16, 51, 1000, 760, 51, 1069, 152, 673, 767, 61, 248]"
259,11,3557,1840,8151,0,2306,1251,"[114, 178, 45, 377, 7, 392, 265, 147, 371, 322, 309, 0, 140, 81, 231, 255, 235, 345, 348, 269, 12, 68, 363, 216, 185, 99, 97]"
260,11,3173,6982,4342,0,2538,635,"[188, 100, 28, 55, 108, 20, 5, 76, 202, 158, 7, 0, 132, 149, 128, 186, 163, 105, 200, 158, 134, 107, 146, 13, 36, 204, 192]"
261,11,3442,322,7462,0,3119,323,"[48, 8, 86, 105, 22, 96, 28, 55, 31, 105, 35, 0, 87, 59, 63, 98, 13, 103, 9, 75, 60, 81, 64, 52, 3, 77, 98]"
262,11,4097,6975,4584,0,3950,147,"[47, 48, 12, 21, 0, 3, 6, 23, 29, 15, 36, 0, 35, 20, 22, 34, 39, 16, 45, 19, 16, 5, 15, 2, 3, 0, 24]"
263,11,4404,3536,5452,0,2594,1810,"[51, 443, 264, 121, 403, 248, 506, 291, 232, 355, 538, 0, 387, 511, 329, 15, 85, 437, 160, 384, 595, 149, 102, 331, 45, 588, 123]"
264,11,4974,2649,7777,0,258,4716,"[620, 447, 1061, 789, 1376, 216, 666, 961, 1017, 716, 1324, 0, 68, 1526, 637, 107, 1107, 157, 1483, 1329, 461, 444, 1092, 1246, 100, 1536, 1526]"
265,11,4775,6501,6051,0,2339,2436,"[183, 697, 138, 617, 326, 52, 233, 466, 791, 27, 622, 0, 655, 288, 475, 435, 57, 104, 811, 366, 584, 589, 66, 465, 109, 758, 734]"
266,11,4860,788,10000,123,3994,866,"[69, 260, 129, 215, 218, 7, 267, 180, 114, 255, 166, 0, 148, 182, 219, 284, 28, 71, 141, 111, 37, 50, 1, 78, 32, 151, 102]"
267,11,4341,6855,7486,0,4020,321,"[48, 104, 41, 24, 50, 96, 81, 87, 71, 70, 26, 0, 32, 35, 87, 104, 70, 74, 22, 100, 52, 16, 51, 95, 37, 27, 36]"
268,11,3659,6533,4612,0,3427,232,"[3, 28, 32, 12, 50, 73, 22, 29, 50, 15, 58, 0, 33, 5, 62, 73, 75, 2, 38, 61, 40, 71, 24, 71, 73, 55, 66]"
269,11,4216,1035,7793,0,1729,2487,"[138, 69, 592, 212, 306, 649, 409, 821, 329, 414, 458, 0, 362, 742, 694, 275, 470, 238, 328, 554, 546, 581, 466, 31, 619, 476, 743]"
270,11,4824,7495,5122,0,3051,1773,"[575, 125, 41, 141, 414, 485, 294, 72, 409, 323, 375, 0, 550, 368, 517, 172, 411, 51, 514, 520, 356, 271, 424, 104, 202, 312, 361]"
271,11,3744,3099,5767,0,1913,1831,"[402, 74, 424, 146, 320, 509, 426, 407, 43, 318, 180, 0, 21, 472, 343, 129, 520, 556, 575, 545, 294, 280, 72, 142, 266, 472, 285]"
272,11,4278,2106,7939,0,2415,1863,"[596, 517, 112, 429, 313, 255, 421, 213, 78, 450, 336, 0, 476, 306, 539, 603, 425, 44, 569, 161, 321, 617, 24, 398, 405, 620, 518]"
273,11,4153,6346,5746,0,2916,1237,"[168, 153, 383, 91, 270, 132, 60, 77, 76, 323, 167, 0, 368, 402, 138, 327, 130, 66, 232, 409, 121, 261, 194, 193, 172, 291, 155]"
274,11,4200,2964,6982,0,2905,1295,"[286, 383, 270, 79, 8, 305, 405, 309, 208, 183, 50, 0, 179, 155, 288, 76, 78, 59, 194, 237, 123, 385, 190, 361, 94, 423, 104]"
275,11,4985,7369,4598,0,3445,1540,"[60, 182, 260, 22, 81, 258, 373, 379, 350, 434, 167, 0, 272, 459, 240, 487, 451, 251, 397, 410, 115, 99, 340, 117, 150, 127, 294]"
276,11,4272,1857,7013,0,192,4080,"[183, 720, 248, 851, 113, 991, 1091, 1181, 772, 406, 997, 0, 93, 522, 1180, 9, 1244, 220, 145, 1307, 25, 882, 119, 489, 320, 914, 1005]"
277,11,3913,2812,8114,0,1776,2137,"[352, 581, 557, 562, 306, 556, 191, 298, 580, 191, 270, 0, 583, 448, 643, 472, 426, 324, 229, 40, 599, 464, 638, 690, 517, 508, 406]"
278,11,3828,7004,4938,0,822,3006,"[451, 322, 628, 468, 962, 461, 208, 733, 397, 845, 354, 0, 377, 386, 223, 685, 83, 188, 298, 104, 256, 737, 218, 547, 810, 918, 452]"
279,11,4349,326,8961,0,4188,161,"[7, 11, 37, 43, 44, 35, 23, 8, 8, 13, 47, 0, 17, 43, 43, 2, 49, 49, 15, 51, 21, 46, 12, 27, 44, 41, 36]"
280,11,4043,5055,7949,0,3275,768,"[95, 226, 140, 8, 202, 70, 154, 60, 72, 16, 183, 0, 155, 197, 137, 0, 215, 179, 114, 141, 160, 147, 71, 96, 176, 107, 234]"
281,11,3374,7118,4205,0,1628,1746,"[512, 567, 386, 486, 357, 251, 234, 377, 427, 228, 400, 0, 331, 538, 234, 142, 425, 159, 23, 362, 434, 226, 109, 12, 412, 506, 249]"
282,11,3845,3832,4218,0,2452,1393,"[201, 235, 237, 227, 86, 127, 448, 121, 277, 349, 286, 0, 10, 360, 228, 408, 336, 354, 143, 217, 225, 450, 244, 142, 214, 428, 146]"
283,11,3826,1792,6252,0,1632,2194,"[572, 31, 651, 431, 588, 426, 370, 341, 494, 317, 691, 0, 208, 470, 618, 178, 202, 332, 392, 40, 204, 527, 586, 340, 117, 135, 176]"
284,11,4395,407,10000,240,2416,1979,"[107, 426, 577, 630, 511, 346, 96, 351, 209, 51, 580, 0, 145, 294, 546, 125, 537, 455, 269, 658, 100, 53, 103, 374, 531, 295, 267]"
285,11,4354,5479,8875,0,1108,3246,"[120, 254, 326, 818, 175, 135, 871, 526, 41, 350, 533, 0, 219, 757, 723, 15, 9, 306, 169, 273, 525, 793, 254, 322, 25, 772, 257]"
286,11,4221,7226,5870,0,1529,2692,"[697, 773, 697, 188, 298, 19, 209, 584, 199, 51, 106, 0, 335, 211, 201, 795, 495, 887, 321, 855, 738, 59, 81, 818, 686, 77, 738]"
287,11,3307,1345,7832,0,211,3096,"[391, 151, 512, 685, 17, 83, 746, 361, 677, 762, 998, 0, 47, 738, 680, 1024, 680, 702, 330, 911, 693, 376, 707, 376, 800, 116, 451]"
288,11,4460,5406,6886,0,1005,3455,"[174, 899, 729, 943, 532, 174, 706, 1120, 476, 835, 650, 0, 493, 64, 857, 379, 946, 478, 837, 526, 879, 753, 669, 1126, 721, 366, 846]"
289,11,3488,911,9463,0,1479,2009,"[563, 325, 461, 470, 265, 647, 611, 93, 41, 593, 158, 0, 66, 409, 469, 196, 286, 267, 338, 504, 502, 327, 581, 524, 663, 147, 349]"
290,11,4139,7135,6467,0,150,3989,"[1238, 1060, 261, 1233, 712, 1002, 500, 1139, 1120, 951, 563, 0, 83, 668, 1167, 848, 617, 350, 444, 221, 101, 85, 1289, 331, 1176, 1112, 1317]"
291,11,3471,165,9773,0,2811,660,"[74, 138, 42, 121, 95, 85, 213, 101, 34, 72, 100, 0, 218, 160, 157, 23, 61, 169, 74, 105, 90, 104, 6, 207, 71, 13, 74]"
292,11,3668,6003,7438,0,1860,1808,"[592, 5, 482, 154, 533, 451, 412, 99, 451, 300, 425, 0, 457, 518, 362, 224, 331, 503, 511, 248, 386, 264, 134, 74, 439, 70, 31]"
293,11,3363,2474,8327,0,2741,622,"[0, 64, 165, 174, 198, 12, 153, 58, 53, 148, 202, 0, 121, 62, 185, 53, 2, 10, 27, 173, 44, 126, 93, 159, 164, 63, 146]"
294,11,3430,5273,6484,0,1033,2397,"[20, 799, 503, 315, 129, 71, 259, 772, 278, 33, 28, 0, 768, 44, 295, 129, 264, 93, 623, 276, 298, 450, 699, 7, 430, 678, 3]"
295,11,3908,2156,8236,0,2743,1165,"[45, 178, 168, 240, 76, 343, 242, 303, 362, 199, 211, 0, 264, 82, 309, 133, 85, 211, 335, 309, 202, 51, 160, 203, 100, 15, 189]"
296,11,3861,5443,6654,0,1199,2662,"[861, 489, 132, 89, 268, 558, 269, 716, 633, 176, 31, 0, 322, 822, 841, 546, 448, 730, 695, 750, 751, 303, 59, 551, 367, 175, 103]"
297,11,3165,7,9812,0,582,2583,"[708, 358, 167, 501, 570, 566, 25, 608, 473, 182, 624, 0, 368, 699, 384, 155, 133, 153, 635, 343, 786, 182, 614, 668, 428, 477, 741]"
298,11,4608,7423,6997,0,1569,3039,"[258, 470, 239, 703, 968, 756, 713, 757, 657, 341, 370, 0, 263, 211, 528, 731, 495, 103, 128, 428, 378, 41, 731, 186, 188, 212, 345]"
299,11,4452,5357,6092,0,2485,1967,"[496, 624, 637, 249, 85, 390, 503, 85, 123, 430, 344, 0, 324, 179, 334, 10, 12, 577, 353, 5, 289, 209, 589, 337, 650, 277, 114]"
0,12,14,0,14,0,11,3,"[0, 0, 1, 1, 1, 0, 1, 1, 1, 1, 0, 0, 0, 0, 0, 1, 0, 0, 0, 1, 0, 0, 0, 0, 0, 1, 1]"
1,12,72,17,69,0,61,11,"[0, 2, 1, 2, 1, 2, 2, 0, 2, 1, 3, 0, 3, 0, 1, 3, 3, 2, 2, 1, 3, 3, 3, 1, 2, 0, 0]"
2,12,70,69,70,0,2,68,"[2, 6, 21, 15, 7, 20, 4, 6, 15, 0, 9, 0, 8, 2, 22, 16, 8, 10, 2, 1, 14, 20, 19, 6, 9, 11, 1]"
3,12,56,33,93,0,4,52,"[1, 12, 9, 16, 14, 1, 0, 0, 0, 7, 17, 0, 3, 9, 3, 13, 8, 5, 7, 4, 3, 16, 7, 7, 2, 9, 3]"
4,12,84,79,98,0,37,47,"[0, 15, 3, 12, 1, 3, 2, 6, 6, 1, 11, 0, 11, 10, 10, 1, 9, 7, 10, 7, 3, 14, 10, 14, 4, 6, 3]"
5,12,12,7,103,0,6,6,"[1, 2, 2, 2, 1, 1, 0, 0, 1, 1, 0, 0, 1, 0, 2, 2, 1, 2, 2, 0, 2, 1, 0, 1, 0, 0, 1]"
6,12,39,23,119,0,23,16,"[3, 1, 1, 3, 3, 2, 4, 3, 1, 4, 0, 0, 0, 3, 4, 5, 0, 5, 4, 1, 0, 4, 0, 0, 4, 1, 1]"
7,12,90,69,140,0,15,75,"[10, 22, 2, 12, 12, 2, 9, 24, 22, 15, 13, 0, 12, 2, 2, 2, 6, 25, 23, 17, 12, 14, 21, 0, 15, 22, 11]"
8,12,59,53,146,0,14,45,"[8, 15, 12, 2, 0, 9, 1, 4, 0, 3, 9, 0, 13, 11, 9, 13, 15, 4, 9, 13, 8, 14, 2, 7, 15, 2, 11]"
9,12,85,19,212,0,56,29,"[9, 7, 9, 6, 3, 3, 5, 3, 6, 6, 7, 0, 7, 6, 8, 5, 7, 4, 5, 2, 2, 0, 1, 0, 4, 3, 9]"
10,12,34,1,245,0,24,10,"[3, 2, 2, 1, 1, 3, 2, 2, 2, 3, 2, 0, 1, 2, 2, 3, 3, 2, 1, 2, 0, 3, 3, 1, 3, 2, 1]"
11,12,14,5,254,0,13,1,"[0, 0, 0, 0, 0, 0, 0, 0, 0, 0, 0, 0, 0, 0, 0, 0, 0, 0, 0, 0, 0, 0, 0, 0, 0, 0, 0]"
12,12,8,8,254,0,1,7,"[1, 1, 1, 2, 2, 1, 2, 2, 2, 2, 2, 0, 1, 2, 2, 2, 2, 2, 2, 1, 0, 1, 0, 1, 2, 2, 1]"
13,12,78,57,275,0,47,31,"[3, 7, 9, 6, 2, 6, 5, 4, 10, 8, 3, 0, 1, 8, 8, 7, 0, 10, 8, 0, 9, 7, 9, 9, 6, 6, 6]"
14,12,55,30,300,0,16,39,"[8, 7, 3, 6, 3, 0, 4, 0, 1, 4, 2, 0, 1, 6, 0, 12, 4, 2, 5, 3, 9, 2, 7, 1, 11, 10, 11]"
15,12,10,8,302,0,6,4,"[0, 1, 1, 1, 0, 0, 0, 1, 1, 1, 0, 0, 0, 0, 1, 0, 0, 1, 1, 0, 0, 1, 1, 1, 0, 0, 0]"
16,12,46,39,309,0,34,12,"[0, 3, 1, 1, 3, 3, 0, 3, 3, 3, 4, 0, 1, 3, 1, 2, 1, 4, 4, 3, 4, 3, 2, 1, 0, 0, 3]"
17,12,34,32,311,0,16,18,"[1, 5, 5, 4, 5, 4, 0, 2, 4, 0, 5, 0, 0, 1, 1, 6, 6, 2, 3, 2, 5, 3, 0, 1, 4, 5, 2]"
18,12,39,18,332,0,2,37,"[6, 2, 12, 10, 0, 6, 11, 4, 3, 6, 0, 0, 5, 8, 9, 1, 11, 8, 10, 7, 6, 12, 8, 10, 12, 3, 1]"
19,12,14,14,332,0,2,12,"[3, 2, 0, 3, 1, 2, 3, 4, 4, 3, 1, 0, 2, 2, 0, 4, 4, 0, 2, 4, 4, 1, 4, 2, 3, 4, 4]"
20,12,45,27,350,0,17,28,"[2, 0, 2, 2, 6, 5, 3, 9, 4, 5, 0, 0, 8, 1, 9, 9, 6, 2, 8, 3, 8, 5, 2, 5, 4, 6, 4]"
21,12,90,88,352,0,22,68,"[5, 22, 21, 18, 5, 0, 10, 0, 18, 17, 17, 0, 10, 3, 12, 2, 19, 17, 9, 16, 4, 3, 9, 10, 19, 22, 1]"
22,12,44,19,377,0,12,32,"[7, 9, 0, 6, 0, 9, 8, 9, 9, 3, 5, 0, 0, 8, 8, 5, 8, 7, 8, 5, 10, 3, 9, 8, 3, 5, 2]"
23,12,78,63,392,0,64,14,"[3, 1, 3, 1, 1, 0, 4, 0, 3, 4, 1, 0, 4, 4, 3, 4, 4, 0, 0, 0, 2, 1, 4, 3, 2, 1, 1]"
24,12,90,2,480,0,58,32,"[1, 4, 10, 3, 8, 9, 6, 3, 1, 9, 10, 0, 4, 2, 6, 8, 6, 5, 8, 9, 7, 9, 4, 7, 10, 4, 0]"
25,12,5,3,482,0,2,3,"[1, 1, 1, 0, 0, 1, 0, 0, 1, 1, 0, 0, 1, 0, 0, 0, 1, 1, 1, 1, 0, 0, 0, 0, 0, 1, 0]"
26,12,94,29,547,0,83,11,"[0, 3, 0, 1, 2, 1, 1, 2, 2, 1, 1, 0, 3, 1, 0, 1, 0, 3, 3, 2, 2, 3, 2, 2, 0, 2, 2]"
27,12,27,11,563,0,1,26,"[4, 7, 1, 8, 2, 7, 8, 0, 3, 7, 6, 0, 3, 5, 0, 8, 0, 8, 5, 1, 0, 2, 4, 8, 1, 6, 1]"
28,12,99,47,615,0,1,98,"[29, 0, 16, 25, 4, 17, 12, 19, 32, 18, 14, 0, 13, 29, 26, 22, 31, 0, 32, 10, 3, 2, 30, 3, 13, 16, 31]"
29,12,15,3,627,0,0,15,"[2, 5, 5, 2, 1, 0, 5, 3, 1, 3, 1, 0, 1, 3, 5, 4, 3, 2, 2, 2, 4, 2, 4, 2, 4, 1, 5]"
30,12,33,21,639,0,4,29,"[9, 5, 6, 4, 2, 5, 7, 0, 5, 3, 4, 0, 7, 3, 2, 3, 3, 0, 6, 3, 1, 7, 4, 4, 1, 8, 9]"
31,12,7,6,640,0,2,5,"[0, 1, 1, 1, 0, 1, 1, 0, 0, 1, 0, 0, 0, 0, 0, 0, 1, 0, 0, 1, 0, 0, 0, 1, 0, 0, 1]"
32,12,62,52,650,0,39,23,"[5, 7, 0, 7, 5, 2, 6, 5, 2, 6, 0, 0, 7, 5, 3, 0, 4, 0, 5, 4, 7, 7, 7, 4, 6, 4, 7]"
33,12,44,17,677,0,1,43,"[4, 13, 12, 12, 6, 3, 6, 11, 4, 0, 14, 0, 2, 9, 3, 5, 6, 6, 14, 9, 1, 3, 8, 12, 9, 6, 4]"
34,12,67,6,738,0,5,62,"[11, 20, 9, 20, 11, 14, 16, 0, 16, 20, 7, 0, 13, 14, 1, 9, 6, 1, 3, 2, 11, 16, 5, 7, 12, 19, 9]"
35,12,47,29,756,0,23,24,"[5, 0, 4, 3, 2, 7, 5, 1, 0, 7, 8, 0, 0, 0, 0, 4, 3, 6, 7, 5, 3, 0, 5, 3, 1, 6, 7]"
36,12,41,32,765,0,19,22,"[3, 6, 5, 3, 0, 4, 0, 7, 5, 4, 3, 0, 5, 0, 7, 3, 0, 5, 0, 5, 6, 0, 3, 3, 1, 4, 3]"
37,12,21,8,778,0,5,16,"[4, 5, 5, 2, 3, 2, 4, 2, 4, 3, 1, 0, 2, 4, 3, 3, 1, 0, 3, 4, 2, 5, 3, 1, 0, 3, 1]"
38,12,70,15,833,0,50,20,"[3, 5, 3, 2, 0, 6, 5, 1, 0, 6, 2, 0, 2, 4, 0, 6, 0, 6, 4, 4, 0, 5, 2, 6, 5, 4, 6]"
39,12,22,10,845,0,15,7,"[1, 0, 0, 0, 1, 0, 1, 2, 2, 1, 1, 0, 2, 0, 2, 1, 2, 2, 0, 2, 1, 2, 0, 2, 1, 2, 0]"
40,12,58,48,855,0,16,42,"[10, 8, 9, 6, 12, 5, 9, 10, 11, 3, 10, 0, 8, 5, 4, 3, 14, 8, 11, 6, 11, 9, 3, 12, 14, 14, 0]"
41,12,45,9,891,0,32,13,"[1, 4, 2, 3, 3, 4, 1, 2, 4, 4, 1, 0, 0, 3, 1, 1, 1, 1, 3, 0, 1, 3, 1, 3, 3, 1, 2]"
42,12,64,60,895,0,9,55,"[17, 9, 6, 7, 4, 18, 6, 18, 16, 13, 18, 0, 17, 16, 18, 3, 0, 18, 13, 18, 14, 8, 16, 10, 8, 10, 3]"
43,12,37,33,899,0,1,36,"[3, 0, 0, 9, 8, 9, 8, 8, 10, 7, 12, 0, 8, 6, 12, 12, 8, 3, 2, 10, 4, 6, 11, 10, 2, 5, 0]"
44,12,9,7,901,0,8,1,"[0, 0, 0, 0, 0, 0, 0, 0, 0, 0, 0, 0, 0, 0, 0, 0, 0, 0, 0, 0, 0, 0, 0, 0, 0, 0, 0]"
45,12,7,1,907,0,2,5,"[1, 0, 1, 0, 1, 1, 0, 0, 1, 1, 0, 0, 0, 1, 0, 1, 1, 0, 1, 0, 0, 1, 0, 1, 0, 0, 1]"
46,12,95,14,988,0,57,38,"[6, 6, 7, 6, 9, 4, 3, 12, 1, 11, 1, 0, 3, 11, 11, 4, 4, 1, 12, 0, 9, 3, 7, 11, 6, 7, 10]"
47,12,54,26,1016,0,6,48,"[5, 5, 11, 5, 13, 16, 15, 1, 16, 5, 8, 0, 11, 16, 6, 14, 2, 10, 0, 14, 12, 7, 14, 15, 0, 16, 10]"
48,12,59,30,1045,0,58,1,"[0, 0, 0, 0, 0, 0, 0, 0, 0, 0, 0, 0, 0, 0, 0, 0, 0, 0, 0, 0, 0, 0, 0, 0, 0, 0, 0]"
49,12,81,1,1125,0,64,17,"[3, 5, 3, 3, 2, 5, 1, 0, 5, 1, 0, 0, 1, 5, 3, 3, 3, 0, 1, 3, 4, 5, 4, 1, 0, 0, 1]"
50,12,58,32,1151,0,41,17,"[5, 3, 3, 1, 1, 5, 5, 2, 1, 2, 4, 0, 5, 2, 1, 1, 5, 2, 4, 2, 5, 5, 0, 1, 0, 1, 2]"
51,12,75,18,1208,0,19,56,"[14, 11, 14, 15, 16, 14, 6, 0, 18, 14, 5, 0, 5, 15, 16, 10, 12, 14, 11, 13, 10, 8, 16, 9, 18, 11, 13]"
52,12,14,2,1220,0,7,7,"[1, 0, 0, 0, 2, 1, 0, 1, 0, 2, 2, 0, 1, 2, 0, 2, 0, 0, 1, 0, 0, 0, 1, 1, 0, 2, 0]"
53,12,92,90,1222,0,73,19,"[4, 2, 1, 5, 3, 1, 3, 3, 5, 4, 3, 0, 0, 0, 6, 0, 0, 1, 2, 6, 1, 4, 4, 5, 0, 0, 4]"
54,12,0,0,1222,0,0,0,"[0, 0, 0, 0, 0, 0, 0, 0, 0, 0, 0, 0, 0, 0, 0, 0, 0, 0, 0, 0, 0, 0, 0, 0, 0, 0, 0]"
55,12,15,7,1230,0,11,4,"[0, 1, 1, 0, 0, 1, 0, 0, 1, 0, 0, 0, 0, 1, 0, 0, 0, 1, 1, 0, 1, 0, 0, 0, 0, 0, 1]"
56,12,98,57,1271,0,58,40,"[5, 2, 3, 10, 4, 1, 2, 3, 11, 11, 5, 0, 11, 13, 8, 4, 3, 7, 11, 2, 4, 3, 4, 4, 9, 1, 2]"
57,12,48,25,1294,0,4,44,"[1, 9, 14, 4, 3, 9, 6, 9, 3, 4, 14, 0, 14, 12, 0, 8, 1, 10, 2, 0, 14, 0, 12, 9, 6, 10, 9]"
58,12,75,68,1301,0,75,0,"[0, 0, 0, 0, 0, 0, 0, 0, 0, 0, 0, 0, 0, 0, 0, 0, 0, 0, 0, 0, 0, 0, 0, 0, 0, 0, 0]"
59,12,84,51,1334,0,25,59,"[3, 6, 6, 9, 16, 12, 3, 5, 17, 3, 3, 0, 14, 17, 0, 4, 7, 1, 11, 4, 19, 3, 11, 4, 10, 10, 12]"
60,12,98,41,1391,0,97,1,"[0, 0, 0, 0, 0, 0, 0, 0, 0, 0, 0, 0, 0, 0, 0, 0, 0, 0, 0, 0, 0, 0, 0, 0, 0, 0, 0]"
61,12,26,10,1407,0,10,16,"[1, 4, 1, 0, 1, 5, 1, 5, 4, 1, 0, 0, 5, 5, 3, 2, 2, 0, 2, 3, 3, 5, 5, 4, 5, 2, 1]"
62,12,17,7,1417,0,3,14,"[2, 4, 0, 4, 4, 3, 2, 1, 0, 1, 2, 0, 1, 0, 1, 3, 3, 4, 4, 1, 2, 0, 2, 3, 1, 4, 0]"
63,12,49,37,1429,0,42,7,"[0, 0, 0, 0, 1, 0, 2, 2, 0, 1, 0, 0, 0, 2, 0, 1, 2, 0, 2, 1, 2, 2, 2, 2, 2, 1, 1]"
64,12,42,13,1458,0,35,7,"[2, 2, 1, 0, 0, 1, 2, 2, 1, 0, 0, 0, 0, 2, 0, 1, 0, 0, 1, 1, 2, 0, 0, 0, 1, 1, 1]"
65,12,9,1,1466,0,4,5,"[0, 1, 0, 1, 0, 1, 1, 1, 1, 1, 1, 0, 0, 1, 0, 1, 0, 0, 1, 0, 1, 0, 0, 0, 0, 1, 1]"
66,12,50,11,1505,0,26,24,"[5, 5, 7, 7, 8, 2, 8, 7, 6, 3, 7, 0, 4, 5, 1, 6, 4, 7, 0, 1, 1, 5, 0, 4, 7, 5, 5]"
67,12,10,0,1515,0,7,3,"[1, 1, 0, 1, 0, 1, 1, 0, 0, 1, 0, 0, 0, 1, 1, 0, 1, 1, 1, 0, 1, 1, 0, 1, 0, 0, 0]"
68,12,42,18,1539,0,5,37,"[3, 11, 11, 1, 5, 12, 5, 6, 8, 2, 1, 0, 2, 3, 11, 8, 4, 2, 5, 7, 6, 1, 1, 11, 5, 1, 9]"
69,12,51,51,1539,0,6,45,"[1, 13, 7, 3, 12, 2, 11, 11, 9, 14, 4, 0, 4, 11, 7, 7, 9, 3, 11, 13, 13, 12, 6, 8, 0, 10, 1]"
70,12,13,11,1541,0,5,8,"[0, 0, 0, 0, 0, 0, 2, 2, 0, 1, 1, 0, 1, 0, 1, 2, 2, 0, 0, 0, 0, 0, 2, 0, 0, 1, 2]"
71,12,66,20,1587,0,66,0,"[0, 0, 0, 0, 0, 0, 0, 0, 0, 0, 0, 0, 0, 0, 0, 0, 0, 0, 0, 0, 0, 0, 0, 0, 0, 0, 0]"
72,12,2,0,1589,0,0,2,"[0, 0, 0, 0, 0, 0, 0, 0, 0, 0, 0, 0, 0, 0, 0, 0, 0, 0, 0, 0, 0, 0, 0, 0, 0, 0, 0]"
73,12,8,4,1593,0,4,4,"[0, 0, 0, 0, 0, 1, 1, 0, 1, 0, 0, 0, 1, 1, 0, 0, 0, 0, 0, 0, 1, 0, 0, 1, 0, 1, 1]"
74,12,67,49,1611,0,45,22,"[4, 2, 6, 7, 7, 6, 1, 4, 3, 5, 2, 0, 5, 5, 3, 1, 3, 7, 6, 1, 0, 4, 5, 0, 5, 5, 6]"
75,12,15,6,1620,0,14,1,"[0, 0, 0, 0, 0, 0, 0, 0, 0, 0, 0, 0, 0, 0, 0, 0, 0, 0, 0, 0, 0, 0, 0, 0, 0, 0, 0]"
76,12,6,6,1620,0,5,1,"[0, 0, 0, 0, 0, 0, 0, 0, 0, 0, 0, 0, 0, 0, 0, 0, 0, 0, 0, 0, 0, 0, 0, 0, 0, 0, 0]"
77,12,97,53,1664,0,92,5,"[0, 0, 1, 0, 0, 1, 1, 0, 1, 0, 0, 0, 1, 1, 1, 0, 0, 1, 1, 0, 1, 0, 1, 0, 0, 1, 0]"
78,12,25,19,1670,0,15,10,"[1, 3, 3, 3, 3, 3, 2, 2, 3, 2, 0, 0, 3, 3, 1, 3, 1, 1, 2, 0, 0, 1, 0, 0, 3, 1, 0]"
79,12,68,21,1717,0,49,19,"[0, 1, 5, 2, 4, 5, 4, 0, 2, 3, 1, 0, 3, 4, 3, 4, 0, 3, 5, 1, 6, 4, 6, 3, 6, 3, 1]"
80,12,67,2,1782,0,52,15,"[4, 5, 5, 4, 1, 2, 1, 1, 0, 4, 4, 0, 2, 0, 3, 5, 1, 5, 5, 4, 1, 5, 4, 0, 4, 4, 1]"
81,12,92,61,1813,0,1,91,"[0, 11, 10, 3, 25, 7, 30, 23, 11, 0, 21, 0, 7, 17, 2, 9, 4, 4, 3, 10, 14, 26, 20, 16, 25, 20, 16]"
82,12,37,11,1839,0,23,14,"[2, 3, 2, 3, 0, 3, 3, 0, 1, 0, 1, 0, 1, 0, 2, 2, 4, 3, 1, 2, 4, 4, 4, 3, 4, 4, 1]"
83,12,82,36,1885,0,2,80,"[15, 11, 7, 8, 8, 25, 12, 15, 23, 8, 21, 0, 2, 9, 18, 13, 23, 25, 25, 3, 10, 4, 25, 12, 26, 5, 25]"
84,12,71,43,1913,0,46,25,"[3, 3, 7, 7, 2, 6, 3, 3, 4, 5, 1, 0, 2, 7, 2, 7, 5, 7, 0, 8, 8, 6, 0, 7, 0, 0, 8]"
85,12,9,2,1920,0,4,5,"[0, 0, 1, 0, 1, 0, 1, 0, 0, 1, 0, 0, 1, 0, 1, 0, 1, 1, 1, 1, 1, 0, 0, 0, 0, 1, 0]"
86,12,21,2,1939,0,12,9,"[1, 2, 3, 3, 3, 0, 0, 3, 2, 0, 1, 0, 3, 2, 0, 3, 0, 0, 2, 3, 2, 0, 2, 0, 1, 3, 2]"
87,12,40,31,1948,0,39,1,"[0, 0, 0, 0, 0, 0, 0, 0, 0, 0, 0, 0, 0, 0, 0, 0, 0, 0, 0, 0, 0, 0, 0, 0, 0, 0, 0]"
88,12,12,10,1950,0,2,10,"[0, 0, 1, 0, 0, 1, 0, 0, 3, 2, 1, 0, 0, 0, 1, 0, 3, 0, 0, 0, 1, 0, 2, 0, 1, 2, 1]"
89,12,37,8,1979,0,15,22,"[0, 5, 1, 0, 4, 1, 6, 3, 7, 6, 7, 0, 5, 3, 5, 3, 6, 1, 5, 4, 3, 5, 7, 6, 0, 2, 3]"
90,12,5,4,1980,0,3,2,"[0, 0, 0, 0, 0, 0, 0, 0, 0, 0, 0, 0, 0, 0, 0, 0, 0, 0, 0, 0, 0, 0, 0, 0, 0, 0, 0]"
91,12,31,31,1980,0,21,10,"[3, 3, 1, 0, 3, 2, 3, 3, 2, 2, 1, 0, 3, 2, 0, 0, 3, 3, 3, 1, 0, 3, 1, 2, 0, 3, 2]"
92,12,43,42,1981,0,21,22,"[5, 2, 2, 2, 2, 4, 5, 7, 0, 5, 1, 0, 6, 4, 5, 0, 5, 3, 2, 1, 6, 6, 7, 6, 5, 3, 4]"
93,12,61,20,2022,0,28,33,"[6, 3, 3, 4, 1, 0, 4, 3, 5, 9, 2, 0, 7, 11, 11, 8, 1, 1, 2, 4, 2, 8, 10, 4, 6, 2, 7]"
94,12,27,13,2036,0,3,24,"[4, 5, 3, 0, 4, 2, 6, 7, 6, 0, 7, 0, 0, 6, 1, 7, 4, 3, 2, 0, 6, 3, 6, 5, 3, 5, 2]"
95,12,32,13,2055,0,11,21,"[0, 4, 5, 6, 4, 1, 7, 1, 0, 1, 2, 0, 4, 6, 0, 7, 7, 6, 7, 2, 6, 1, 2, 2, 3, 4, 2]"
96,12,54,32,2077,0,41,13,"[1, 3, 3, 1, 1, 1, 4, 0, 1, 1, 1, 0, 0, 3, 4, 2, 0, 3, 3, 4, 0, 2, 1, 1, 0, 0, 4]"
97,12,26,4,2099,0,11,15,"[1, 5, 0, 5, 5, 2, 1, 3, 3, 5, 3, 0, 2, 0, 2, 0, 2, 0, 1, 4, 1, 2, 2, 5, 5, 2, 2]"
98,12,86,67,2118,0,4,82,"[20, 12, 11, 10, 2, 18, 24, 2, 22, 26, 10, 0, 0, 21, 5, 3, 26, 15, 8, 24, 22, 22, 25, 14, 4, 22, 1]"
99,12,37,17,2138,0,8,29,"[6, 3, 1, 3, 5, 4, 4, 0, 0, 0, 5, 0, 9, 0, 4, 6, 6, 8, 6, 0, 4, 8, 7, 7, 8, 3, 1]"
100,12,59,9,2188,0,52,7,"[1, 0, 1, 1, 0, 2, 2, 0, 1, 2, 0, 0, 1, 1, 2, 0, 2, 0, 1, 2, 1, 2, 0, 1, 0, 0, 2]"
101,12,39,34,2193,0,3,36,"[10, 9, 4, 4, 0, 4, 4, 4, 6, 5, 1, 0, 11, 6, 6, 8, 1, 9, 8, 4, 10, 2, 9, 9, 6, 3, 3]"
102,12,2,1,2194,0,0,2,"[0, 0, 0, 0, 0, 0, 0, 0, 0, 0, 0, 0, 0, 0, 0, 0, 0, 0, 0, 0, 0, 0, 0, 0, 0, 0, 0]"
103,12,98,15,2277,0,88,10,"[2, 1, 1, 1, 0, 1, 1, 0, 1, 3, 2, 0, 0, 0, 3, 3, 1, 0, 2, 2, 1, 2, 1, 0, 0, 2, 2]"
104,12,15,7,2285,0,1,14,"[0, 0, 3, 2, 3, 3, 4, 0, 2, 0, 2, 0, 0, 0, 4, 0, 4, 3, 2, 0, 3, 2, 3, 4, 4, 0, 2]"
105,12,24,18,2291,0,6,18,"[5, 6, 5, 0, 0, 5, 5, 0, 1, 0, 4, 0, 4, 1, 5, 4, 5, 5, 0, 3, 6, 5, 5, 3, 5, 2, 0]"
106,12,54,16,2329,0,24,30,"[3, 6, 5, 8, 2, 5, 3, 10, 6, 9, 10, 0, 5, 1, 10, 9, 1, 7, 0, 0, 0, 5, 3, 10, 1, 2, 2]"
107,12,84,0,2413,0,18,66,"[14, 20, 4, 12, 17, 2, 4, 18, 2, 14, 16, 0, 22, 2, 4, 3, 22, 21, 19, 19, 7, 13, 9, 17, 20, 19, 14]"
108,12,95,57,2451,0,16,79,"[15, 5, 0, 26, 5, 14, 25, 17, 16, 8, 18, 0, 14, 6, 4, 4, 8, 21, 15, 9, 14, 21, 21, 25, 0, 26, 14]"
109,12,55,18,2488,0,2,53,"[4, 4, 12, 14, 2, 1, 14, 2, 14, 4, 4, 0, 16, 16, 15, 9, 9, 2, 17, 0, 17, 4, 14, 1, 15, 0, 10]"
110,12,99,75,2512,0,68,31,"[4, 3, 1, 2, 2, 10, 10, 4, 5, 2, 4, 0, 7, 5, 5, 8, 1, 8, 2, 1, 6, 6, 1, 0, 0, 0, 0]"
111,12,50,22,2540,0,41,9,"[2, 0, 2, 1, 1, 1, 0, 3, 0, 1, 3, 0, 2, 0, 1, 1, 2, 3, 3, 2, 2, 3, 2, 3, 0, 3, 1]"
112,12,90,59,2571,0,23,67,"[22, 11, 5, 3, 11, 10, 1, 2, 14, 19, 12, 0, 17, 20, 1, 22, 1, 6, 15, 11, 21, 18, 9, 17, 17, 4, 20]"
113,12,20,11,2580,0,6,14,"[3, 2, 2, 4, 4, 0, 0, 1, 1, 0, 4, 0, 2, 3, 1, 1, 3, 0, 0, 0, 3, 1, 1, 3, 3, 1, 3]"
114,12,11,10,2581,0,4,7,"[0, 0, 2, 0, 0, 2, 2, 0, 1, 1, 1, 0, 0, 1, 1, 0, 2, 0, 0, 0, 1, 2, 2, 1, 0, 2, 2]"
115,12,15,4,2592,0,12,3,"[0, 1, 0, 0, 0, 0, 0, 1, 1, 1, 1, 0, 0, 0, 1, 1, 1, 0, 0, 1, 0, 0, 0, 1, 1, 1, 1]"
116,12,45,15,2622,0,41,4,"[1, 1, 1, 0, 0, 1, 1, 1, 0, 0, 1, 0, 0, 0, 0, 1, 0, 1, 1, 1, 1, 1, 0, 0, 1, 1, 0]"
117,12,48,42,2628,0,28,20,"[2, 4, 2, 3, 4, 5, 0, 0, 0, 2, 2, 0, 4, 0, 2, 2, 0, 1, 3, 5, 5, 5, 1, 2, 1, 4, 6]"
118,12,59,24,2663,0,28,31,"[2, 0, 3, 7, 4, 9, 1, 2, 1, 0, 9, 0, 10, 6, 2, 9, 3, 9, 0, 7, 0, 9, 10, 9, 9, 2, 6]"
119,12,18,9,2672,0,0,18,"[4, 0, 6, 3, 1, 3, 3, 3, 1, 4, 2, 0, 6, 6, 4, 2, 2, 1, 6, 1, 4, 1, 5, 0, 6, 4, 1]"
120,12,74,42,2704,0,6,68,"[14, 2, 20, 1, 7, 2, 18, 8, 9, 16, 1, 0, 10, 3, 2, 3, 12, 17, 1, 15, 17, 13, 3, 5, 5, 21, 20]"
121,12,3,0,2707,0,3,0,"[0, 0, 0, 0, 0, 0, 0, 0, 0, 0, 0, 0, 0, 0, 0, 0, 0, 0, 0, 0, 0, 0, 0, 0, 0, 0, 0]"
122,12,18,12,2713,0,9,9,"[0, 1, 2, 1, 2, 2, 2, 1, 3, 1, 0, 0, 1, 0, 1, 2, 2, 0, 1, 2, 1, 3, 0, 0, 2, 3, 2]"
123,12,14,0,2727,0,7,7,"[0, 0, 0, 2, 1, 2, 2, 1, 0, 1, 0, 0, 0, 1, 1, 0, 2, 2, 0, 0, 0, 1, 1, 1, 2, 2, 1]"
124,12,33,19,2741,0,14,19,"[0, 4, 0, 1, 0, 1, 6, 1, 5, 1, 1, 0, 4, 2, 2, 4, 2, 5, 5, 2, 2, 2, 1, 4, 0, 0, 0]"
125,12,53,35,2759,0,3,50,"[0, 11, 3, 15, 7, 9, 12, 1, 9, 11, 14, 0, 5, 1, 12, 12, 16, 0, 5, 6, 10, 15, 16, 12, 14, 5, 1]"
126,12,8,6,2761,0,6,2,"[0, 0, 0, 0, 0, 0, 0, 0, 0, 0, 0, 0, 0, 0, 0, 0, 0, 0, 0, 0, 0, 0, 0, 0, 0, 0, 0]"
127,12,49,35,2775,0,24,25,"[4, 3, 6, 0, 1, 5, 2, 4, 1, 3, 8, 0, 1, 3, 1, 4, 3, 5, 1, 8, 2, 3, 1, 0, 5, 8, 0]"
128,12,46,46,2775,0,8,38,"[10, 2, 7, 11, 7, 3, 1, 3, 2, 2, 3, 0, 1, 11, 7, 8, 4, 7, 0, 5, 10, 12, 0, 0, 2, 2, 0]"
129,12,90,67,2798,0,19,71,"[12, 16, 19, 12, 19, 2, 14, 12, 2, 13, 1, 0, 2, 5, 3, 5, 7, 22, 21, 7, 15, 5, 16, 12, 2, 11, 17]"
130,12,25,16,2807,0,3,22,"[2, 0, 2, 3, 4, 5, 3, 5, 0, 1, 6, 0, 0, 7, 5, 0, 5, 1, 4, 5, 1, 7, 6, 7, 4, 7, 4]"
131,12,25,7,2825,0,1,24,"[0, 5, 7, 6, 6, 6, 8, 5, 3, 4, 5, 0, 5, 3, 1, 8, 0, 8, 8, 0, 8, 2, 8, 8, 0, 7, 4]"
132,12,20,7,2838,0,14,6,"[2, 1, 1, 0, 1, 1, 0, 1, 2, 2, 0, 0, 2, 2, 0, 2, 1, 0, 2, 0, 2, 2, 1, 0, 1, 2, 1]"
133,12,40,20,2858,0,9,31,"[5, 2, 7, 9, 9, 10, 10, 0, 8, 7, 0, 0, 1, 6, 7, 3, 3, 2, 4, 1, 1, 7, 4, 1, 9, 10, 9]"
134,12,92,21,2929,0,60,32,"[0, 9, 9, 8, 6, 9, 1, 1, 7, 5, 10, 0, 8, 5, 5, 5, 0, 6, 4, 6, 7, 7, 2, 3, 3, 8, 10]"
135,12,94,47,2976,0,59,35,"[7, 3, 0, 1, 7, 3, 8, 4, 6, 0, 0, 0, 0, 7, 3, 4, 10, 8, 11, 9, 8, 6, 6, 11, 4, 3, 6]"
136,12,38,12,3002,0,30,8,"[2, 1, 1, 1, 1, 0, 1, 1, 0, 2, 2, 0, 1, 1, 0, 0, 1, 0, 0, 2, 2, 2, 1, 0, 2, 1, 1]"
137,12,92,60,3034,0,75,17,"[0, 1, 5, 5, 5, 2, 2, 5, 5, 4, 1, 0, 0, 1, 2, 5, 1, 5, 2, 1, 1, 2, 5, 4, 4, 2, 3]"
138,12,74,51,3057,0,9,65,"[17, 7, 7, 16, 15, 15, 11, 20, 15, 0, 4, 0, 10, 11, 21, 7, 6, 19, 8, 13, 14, 3, 2, 15, 19, 9, 16]"
139,12,83,44,3096,0,83,0,"[0, 0, 0, 0, 0, 0, 0, 0, 0, 0, 0, 0, 0, 0, 0, 0, 0, 0, 0, 0, 0, 0, 0, 0, 0, 0, 0]"
140,12,81,53,3124,0,15,66,"[20, 3, 17, 3, 0, 11, 22, 14, 11, 12, 11, 0, 16, 18, 8, 13, 10, 14, 6, 20, 12, 8, 2, 19, 22, 2, 4]"
141,12,78,72,3130,0,53,25,"[4, 7, 1, 3, 1, 1, 6, 4, 4, 0, 6, 0, 7, 0, 4, 2, 1, 3, 6, 8, 8, 3, 4, 4, 3, 1, 8]"
142,12,69,19,3180,0,36,33,"[1, 6, 8, 1, 3, 9, 10, 2, 8, 10, 9, 0, 0, 2, 8, 8, 11, 0, 3, 8, 10, 0, 10, 5, 10, 1, 0]"
143,12,87,61,3206,0,46,41,"[9, 7, 0, 7, 0, 12, 5, 2, 9, 9, 0, 0, 11, 8, 7, 11, 2, 6, 6, 0, 12, 4, 8, 3, 11, 1, 13]"
144,12,2,1,3207,0,2,0,"[0, 0, 0, 0, 0, 0, 0, 0, 0, 0, 0, 0, 0, 0, 0, 0, 0, 0, 0, 0, 0, 0, 0, 0, 0, 0, 0]"
145,12,21,14,3214,0,13,8,"[2, 0, 1, 2, 1, 1, 2, 0, 2, 1, 0, 0, 0, 0, 0, 0, 2, 1, 1, 2, 0, 2, 0, 1, 0, 2, 1]"
146,12,6,2,3218,0,2,4,"[0, 0, 1, 0, 1, 1, 1, 0, 0, 0, 0, 0, 0, 0, 1, 0, 1, 1, 1, 1, 1, 0, 0, 0, 1, 1, 0]"
147,12,65,63,3220,0,9,56,"[3, 9, 15, 8, 11, 14, 14, 9, 8, 17, 13, 0, 10, 6, 2, 18, 18, 7, 7, 15, 12, 3, 9, 6, 1, 0, 5]"
148,12,52,12,3260,0,21,31,"[0, 1, 7, 4, 1, 2, 7, 4, 2, 1, 5, 0, 0, 3, 3, 2, 5, 2, 5, 2, 3, 1, 10, 7, 1, 6, 0]"
149,12,30,2,3288,0,1,29,"[0, 2, 9, 4, 7, 2, 3, 2, 5, 3, 0, 0, 6, 5, 8, 7, 2, 2, 3, 8, 3, 6, 8, 1, 5, 9, 4]"
150,12,36,3,3321,0,23,13,"[3, 4, 2, 1, 0, 1, 0, 1, 4, 2, 0, 0, 0, 4, 3, 2, 4, 1, 4, 3, 0, 2, 1, 2, 3, 1, 0]"
151,12,36,29,3328,0,11,25,"[2, 1, 7, 2, 4, 1, 1, 5, 5, 5, 1, 0, 8, 1, 1, 3, 6, 1, 3, 5, 4, 0, 8, 7, 1, 5, 5]"
152,12,95,62,3361,0,0,95,"[25, 7, 28, 24, 7, 8, 7, 0, 1, 25, 21, 0, 15, 21, 1, 20, 21, 27, 21, 29, 13, 27, 26, 6, 22, 22, 24]"
153,12,39,34,3366,0,28,11,"[0, 1, 1, 0, 1, 3, 2, 0, 2, 3, 3, 0, 2, 2, 0, 1, 0, 1, 0, 2, 1, 1, 3, 2, 1, 1, 0]"
154,12,2,2,3366,0,1,1,"[0, 0, 0, 0, 0, 0, 0, 0, 0, 0, 0, 0, 0, 0, 0, 0, 0, 0, 0, 0, 0, 0, 0, 0, 0, 0, 0]"
155,12,91,9,3448,0,62,29,"[3, 9, 8, 7, 1, 4, 4, 8, 2, 5, 5, 0, 6, 1, 4, 4, 4, 6, 4, 3, 3, 3, 6, 5, 1, 9, 5]"
156,12,36,12,3472,0,27,9,"[2, 0, 0, 3, 3, 1, 2, 1, 2, 2, 3, 0, 2, 1, 1, 0, 3, 1, 3, 1, 2, 0, 1, 2, 0, 3, 2]"
157,12,77,35,3514,0,36,41,"[2, 2, 11, 7, 0, 2, 13, 5, 8, 13, 3, 0, 4, 1, 1, 11, 6, 13, 5, 1, 1, 3, 9, 4, 10, 5, 6]"
158,12,57,10,3561,0,2,55,"[11, 5, 10, 1, 11, 1, 8, 10, 17, 10, 18, 0, 17, 1, 0, 14, 15, 4, 2, 6, 8, 5, 5, 13, 1, 6, 6]"
159,12,17,7,3571,0,11,6,"[1, 0, 0, 2, 0, 0, 1, 2, 1, 1, 2, 0, 1, 2, 2, 2, 2, 0, 0, 0, 2, 0, 0, 2, 0, 1, 2]"
160,12,98,59,3610,0,36,62,"[0, 13, 4, 20, 4, 0, 14, 11, 14, 15, 17, 0, 1, 16, 17, 13, 8, 2, 16, 5, 18, 11, 5, 18, 1, 19, 11]"
161,12,61,38,3633,0,3,58,"[18, 13, 0, 0, 0, 0, 0, 16, 15, 1, 12, 0, 2, 2, 11, 6, 12, 16, 1, 14, 9, 7, 0, 14, 7, 18, 3]"
162,12,31,11,3653,0,29,2,"[0, 0, 0, 0, 0, 0, 0, 0, 0, 0, 0, 0, 0, 0, 0, 0, 0, 0, 0, 0, 0, 0, 0, 0, 0, 0, 0]"
163,12,96,23,3726,0,4,92,"[18, 21, 30, 5, 16, 16, 15, 21, 2, 11, 1, 0, 19, 6, 25, 20, 8, 3, 18, 24, 18, 13, 23, 28, 7, 24, 17]"
164,12,60,22,3764,0,50,10,"[0, 2, 1, 1, 2, 2, 0, 2, 0, 2, 3, 0, 0, 1, 2, 1, 0, 3, 2, 1, 2, 1, 3, 2, 3, 1, 0]"
165,12,35,23,3776,0,17,18,"[0, 2, 0, 3, 4, 5, 4, 4, 2, 6, 4, 0, 4, 3, 0, 4, 5, 4, 2, 4, 2, 4, 2, 4, 1, 4, 5]"
166,12,29,4,3801,0,20,9,"[0, 2, 0, 1, 1, 1, 2, 3, 1, 2, 0, 0, 1, 0, 1, 2, 2, 2, 3, 3, 2, 0, 0, 3, 2, 2, 3]"
167,12,31,0,3832,0,15,16,"[3, 1, 5, 5, 1, 1, 0, 5, 3, 3, 1, 0, 0, 0, 1, 4, 3, 2, 2, 0, 4, 2, 0, 0, 0, 3, 0]"
168,12,16,4,3844,0,4,12,"[3, 0, 4, 1, 3, 0, 1, 0, 2, 4, 4, 0, 0, 1, 4, 4, 3, 0, 0, 4, 3, 3, 2, 3, 2, 4, 3]"
169,12,37,23,3858,0,9,28,"[3, 4, 8, 5, 5, 1, 1, 3, 8, 8, 4, 0, 3, 4, 3, 8, 6, 5, 4, 8, 2, 2, 3, 8, 3, 4, 8]"
170,12,32,16,3874,0,17,15,"[2, 3, 3, 5, 4, 4, 5, 0, 5, 1, 4, 0, 3, 4, 0, 1, 3, 1, 3, 4, 1, 0, 0, 2, 0, 2, 2]"
171,12,12,1,3885,0,1,11,"[0, 0, 3, 2, 2, 0, 0, 1, 1, 1, 0, 0, 1, 1, 3, 2, 0, 1, 1, 1, 2, 1, 1, 0, 3, 1, 1]"
172,12,7,2,3890,0,5,2,"[0, 0, 0, 0, 0, 0, 0, 0, 0, 0, 0, 0, 0, 0, 0, 0, 0, 0, 0, 0, 0, 0, 0, 0, 0, 0, 0]"
173,12,75,17,3948,0,11,64,"[18, 21, 21, 3, 9, 2, 10, 3, 8, 6, 1, 0, 11, 16, 11, 2, 8, 8, 10, 19, 19, 18, 11, 11, 20, 8, 12]"
174,12,68,12,4004,0,47,21,"[1, 4, 4, 0, 5, 1, 7, 7, 5, 0, 1, 0, 1, 3, 3, 5, 0, 1, 7, 0, 5, 5, 7, 6, 1, 7, 0]"
175,12,69,8,4065,0,42,27,"[4, 7, 5, 8, 4, 0, 2, 3, 5, 5, 0, 0, 1, 4, 5, 6, 4, 3, 7, 0, 9, 7, 8, 8, 8, 7, 5]"
176,12,3,0,4068,0,0,3,"[1, 1, 1, 0, 1, 1, 0, 0, 1, 1, 0, 0, 1, 1, 1, 0, 0, 0, 1, 1, 0, 0, 0, 1, 1, 1, 0]"
177,12,91,59,4100,0,52,39,"[0, 8, 9, 6, 12, 4, 13, 4, 10, 10, 3, 0, 7, 2, 0, 4, 3, 10, 4, 2, 7, 11, 0, 10, 2, 1, 9]"
178,12,97,84,4113,0,64,33,"[3, 1, 11, 1, 5, 10, 8, 10, 5, 0, 7, 0, 6, 6, 1, 6, 4, 4, 9, 1, 11, 8, 11, 9, 10, 7, 5]"
179,12,73,68,4118,0,33,40,"[1, 9, 9, 6, 12, 1, 10, 7, 13, 9, 5, 0, 8, 6, 12, 11, 12, 7, 10, 9, 8, 5, 6, 4, 9, 6, 8]"
180,12,78,10,4186,0,33,45,"[4, 2, 10, 2, 11, 7, 2, 10, 15, 1, 0, 0, 7, 0, 0, 1, 13, 5, 11, 11, 7, 11, 8, 11, 14, 15, 13]"
181,12,92,25,4253,0,17,75,"[19, 7, 19, 16, 10, 18, 17, 17, 22, 4, 14, 0, 14, 12, 19, 21, 25, 20, 1, 22, 4, 21, 23, 24, 12, 6, 21]"
182,12,64,49,4268,0,44,20,"[0, 1, 2, 5, 0, 5, 5, 4, 5, 2, 1, 0, 5, 5, 2, 2, 0, 4, 6, 3, 1, 5, 6, 1, 0, 6, 3]"
183,12,20,18,4270,0,9,11,"[1, 0, 0, 0, 1, 1, 3, 3, 2, 2, 3, 0, 0, 3, 2, 2, 2, 2, 3, 0, 3, 2, 1, 2, 2, 1, 3]"
184,12,80,36,4314,0,48,32,"[2, 8, 5, 5, 10, 9, 9, 3, 10, 8, 8, 0, 10, 10, 4, 10, 10, 8, 9, 0, 3, 9, 0, 1, 9, 0, 6]"
185,12,10,6,4318,0,0,10,"[1, 1, 3, 2, 3, 1, 1, 0, 2, 2, 1, 0, 1, 2, 2, 2, 2, 0, 1, 3, 0, 1, 1, 1, 1, 1, 3]"
186,12,39,15,4342,0,16,23,"[7, 1, 1, 2, 5, 0, 5, 1, 2, 4, 4, 0, 1, 2, 4, 0, 0, 5, 6, 0, 4, 2, 2, 3, 7, 6, 2]"
187,12,29,29,4342,0,9,20,"[2, 2, 2, 4, 3, 4, 5, 3, 0, 2, 4, 0, 5, 6, 1, 4, 4, 6, 2, 0, 6, 1, 6, 6, 2, 1, 3]"
188,12,16,13,4345,0,9,7,"[1, 1, 2, 0, 2, 1, 1, 0, 1, 2, 0, 0, 2, 1, 2, 1, 1, 2, 0, 2, 1, 1, 1, 2, 0, 2, 0]"
189,12,87,43,4389,0,35,52,"[14, 5, 5, 17, 5, 17, 1, 2, 3, 16, 2, 0, 0, 4, 15, 9, 13, 9, 16, 4, 10, 13, 15, 3, 10, 16, 17]"
190,12,70,28,4431,0,46,24,"[1, 1, 0, 7, 0, 3, 1, 4, 0, 0, 6, 0, 6, 2, 1, 8, 6, 0, 3, 8, 0, 3, 4, 5, 2, 7, 0]"
191,12,10,10,4431,0,5,5,"[1, 0, 1, 1, 0, 1, 1, 0, 0, 1, 1, 0, 1, 1, 1, 0, 1, 1, 0, 1, 1, 0, 0, 0, 0, 1, 0]"
192,12,96,96,4431,0,1,95,"[24, 25, 2, 31, 16, 17, 20, 10, 1, 0, 0, 0, 16, 20, 3, 0, 27, 19, 20, 14, 24, 29, 8, 22, 9, 28, 15]"
193,12,42,17,4456,0,15,27,"[6, 1, 7, 8, 5, 4, 7, 7, 2, 4, 7, 0, 1, 0, 3, 6, 2, 1, 1, 8, 7, 8, 7, 2, 5, 5, 2]"
194,12,20,9,4467,0,16,4,"[1, 1, 0, 1, 1, 0, 1, 1, 0, 1, 1, 0, 0, 1, 1, 0, 1, 0, 1, 1, 0, 1, 1, 1, 0, 1, 1]"
195,12,38,12,4493,0,2,36,"[6, 9, 8, 12, 2, 2, 4, 8, 9, 11, 12, 0, 9, 2, 3, 1, 10, 6, 6, 2, 8, 10, 7, 2, 4, 7, 11]"
196,12,62,27,4528,0,9,53,"[14, 14, 11, 8, 6, 5, 4, 16, 3, 7, 13, 0, 15, 2, 12, 9, 8, 14, 1, 9, 2, 16, 8, 4, 3, 8, 2]"
197,12,0,0,4528,0,0,0,"[0, 0, 0, 0, 0, 0, 0, 0, 0, 0, 0, 0, 0, 0, 0, 0, 0, 0, 0, 0, 0, 0, 0, 0, 0, 0, 0]"
198,12,87,27,4588,0,49,38,"[2, 9, 6, 10, 3, 0, 11, 7, 6, 12, 12, 0, 8, 10, 3, 8, 8, 10, 9, 6, 0, 2, 3, 1, 0, 8, 7]"
199,12,8,5,4591,0,6,2,"[0, 0, 0, 0, 0, 0, 0, 0, 0, 0, 0, 0, 0, 0, 0, 0, 0, 0, 0, 0, 0, 0, 0, 0, 0, 0, 0]"
200,12,41,21,4611,0,39,2,"[0, 0, 0, 0, 0, 0, 0, 0, 0, 0, 0, 0, 0, 0, 0, 0, 0, 0, 0, 0, 0, 0, 0, 0, 0, 0, 0]"
201,12,83,73,4621,0,50,33,"[7, 7, 1, 6, 0, 5, 1, 0, 6, 10, 2, 0, 0, 11, 7, 3, 3, 4, 0, 10, 4, 5, 9, 4, 1, 3, 5]"
202,12,25,11,4635,0,1,24,"[2, 4, 1, 8, 1, 6, 1, 2, 2, 6, 1, 0, 5, 2, 5, 2, 1, 1, 3, 1, 2, 2, 5, 1, 4, 8, 2]"
203,12,21,20,4636,0,20,1,"[0, 0, 0, 0, 0, 0, 0, 0, 0, 0, 0, 0, 0, 0, 0, 0, 0, 0, 0, 0, 0, 0, 0, 0, 0, 0, 0]"
204,12,48,34,4650,0,14,34,"[9, 8, 7, 1, 4, 2, 9, 0, 8, 3, 8, 0, 6, 0, 6, 3, 11, 7, 5, 2, 10, 2, 9, 4, 8, 5, 0]"
205,12,74,68,4656,0,72,2,"[0, 0, 0, 0, 0, 0, 0, 0, 0, 0, 0, 0, 0, 0, 0, 0, 0, 0, 0, 0, 0, 0, 0, 0, 0, 0, 0]"
206,12,42,19,4679,0,15,27,"[2, 4, 3, 3, 2, 2, 1, 2, 1, 9, 7, 0, 7, 1, 3, 2, 2, 3, 6, 5, 8, 7, 3, 1, 4, 3, 3]"
207,12,6,0,4685,0,0,6,"[0, 2, 1, 0, 0, 1, 0, 1, 1, 0, 1, 0, 1, 1, 2, 0, 2, 0, 1, 1, 1, 1, 2, 2, 2, 1, 2]"
208,12,80,69,4696,0,17,63,"[3, 19, 13, 14, 14, 18, 1, 9, 14, 9, 18, 0, 4, 11, 14, 8, 14, 7, 2, 3, 13, 17, 0, 20, 0, 13, 2]"
209,12,10,8,4698,0,9,1,"[0, 0, 0, 0, 0, 0, 0, 0, 0, 0, 0, 0, 0, 0, 0, 0, 0, 0, 0, 0, 0, 0, 0, 0, 0, 0, 0]"
210,12,13,7,4704,0,9,4,"[1, 0, 0, 0, 0, 0, 0, 0, 0, 1, 0, 0, 0, 0, 0, 1, 1, 0, 1, 1, 0, 1, 1, 1, 0, 0, 0]"
211,12,22,5,4721,0,2,20,"[2, 0, 5, 2, 4, 3, 4, 2, 4, 6, 6, 0, 5, 1, 3, 4, 1, 3, 6, 6, 1, 4, 4, 4, 0, 1, 6]"
212,12,95,5,4811,0,53,42,"[11, 12, 5, 12, 8, 9, 5, 0, 13, 1, 11, 0, 11, 7, 0, 12, 10, 7, 12, 2, 6, 5, 11, 13, 1, 7, 8]"
213,12,35,11,4835,0,27,8,"[1, 2, 2, 1, 0, 1, 0, 1, 1, 1, 0, 0, 0, 2, 0, 0, 2, 2, 1, 0, 1, 1, 2, 1, 2, 0, 1]"
214,12,73,35,4873,0,12,61,"[20, 6, 19, 15, 5, 14, 8, 9, 1, 9, 2, 0, 16, 18, 9, 18, 1, 5, 16, 1, 1, 5, 13, 5, 12, 20, 8]"
215,12,96,67,4902,0,65,31,"[4, 6, 3, 6, 10, 1, 2, 1, 10, 5, 5, 0, 1, 1, 2, 8, 4, 9, 6, 9, 7, 9, 10, 5, 1, 10, 8]"
216,12,9,8,4903,0,4,5,"[0, 0, 0, 1, 0, 1, 1, 0, 0, 1, 1, 0, 0, 0, 1, 0, 0, 1, 0, 1, 0, 0, 1, 1, 0, 0, 1]"
217,12,72,57,4918,0,35,37,"[11, 10, 11, 2, 6, 9, 4, 0, 10, 3, 10, 0, 11, 0, 4, 2, 2, 2, 3, 9, 11, 12, 9, 3, 6, 1, 11]"
218,12,28,18,4928,0,6,22,"[7, 2, 3, 3, 7, 0, 5, 4, 2, 0, 2, 0, 7, 4, 4, 2, 5, 6, 5, 6, 1, 3, 0, 3, 3, 0, 1]"
219,12,26,10,4944,0,19,7,"[1, 2, 2, 1, 2, 2, 1, 2, 2, 1, 1, 0, 2, 1, 0, 0, 0, 0, 1, 2, 2, 1, 0, 2, 2, 1, 2]"
220,12,64,62,4946,0,19,45,"[15, 11, 15, 15, 6, 8, 13, 8, 2, 11, 15, 0, 5, 10, 9, 3, 14, 5, 4, 2, 10, 8, 7, 15, 11, 15, 15]"
221,12,99,84,4961,0,18,81,"[12, 0, 27, 2, 20, 9, 9, 15, 12, 17, 17, 0, 27, 18, 9, 18, 18, 0, 15, 25, 6, 7, 12, 8, 8, 23, 22]"
222,12,45,14,4992,0,38,7,"[1, 2, 1, 1, 2, 1, 0, 2, 2, 2, 2, 0, 2, 0, 2, 1, 0, 0, 1, 0, 0, 0, 1, 1, 1, 1, 0]"
223,12,26,0,5018,0,9,17,"[1, 3, 0, 2, 3, 5, 1, 1, 4, 2, 3, 0, 1, 2, 0, 3, 4, 4, 4, 5, 0, 1, 2, 0, 5, 0, 3]"
224,12,74,57,5035,0,51,23,"[6, 7, 7, 1, 0, 3, 3, 0, 1, 4, 5, 0, 0, 3, 5, 0, 0, 6, 0, 0, 3, 6, 6, 6, 7, 2, 3]"
225,12,25,7,5053,0,10,15,"[3, 1, 1, 2, 2, 1, 4, 0, 1, 1, 1, 0, 3, 5, 4, 3, 4, 4, 3, 1, 4, 0, 1, 0, 5, 2, 3]"
226,12,42,21,5074,0,16,26,"[0, 6, 3, 8, 3, 2, 7, 2, 2, 8, 5, 0, 4, 4, 8, 4, 3, 2, 6, 1, 6, 8, 5, 8, 3, 2, 6]"
227,12,69,5,5138,0,61,8,"[1, 1, 0, 1, 2, 2, 1, 1, 1, 1, 1, 0, 2, 0, 2, 2, 1, 1, 0, 2, 2, 1, 2, 1, 0, 2, 0]"
228,12,69,43,5164,0,35,34,"[0, 5, 10, 3, 8, 1, 6, 9, 5, 0, 10, 0, 8, 0, 3, 6, 11, 3, 4, 2, 1, 10, 0, 8, 6, 11, 10]"
229,12,15,11,5168,0,12,3,"[1, 0, 1, 0, 0, 0, 0, 0, 0, 1, 0, 0, 0, 1, 1, 1, 1, 1, 1, 0, 0, 1, 0, 1, 0, 0, 1]"
230,12,20,18,5170,0,3,17,"[1, 5, 4, 1, 1, 0, 0, 3, 3, 4, 1, 0, 4, 2, 3, 0, 2, 3, 2, 1, 0, 3, 5, 1, 1, 3, 3]"
231,12,52,20,5202,0,8,44,"[12, 2, 13, 4, 1, 8, 5, 14, 3, 7, 8, 0, 10, 11, 12, 8, 2, 4, 5, 7, 8, 10, 6, 7, 13, 10, 12]"
232,12,77,34,5245,0,33,44,"[11, 1, 6, 8, 4, 6, 6, 12, 12, 0, 2, 0, 4, 5, 9, 14, 11, 2, 5, 2, 7, 3, 2, 12, 12, 14, 10]"
233,12,0,0,5245,0,0,0,"[0, 0, 0, 0, 0, 0, 0, 0, 0, 0, 0, 0, 0, 0, 0, 0, 0, 0, 0, 0, 0, 0, 0, 0, 0, 0, 0]"
234,12,65,64,5246,0,12,53,"[10, 17, 6, 7, 13, 17, 9, 15, 7, 10, 7, 0, 7, 5, 13, 4, 3, 13, 10, 9, 13, 11, 1, 16, 4, 3, 9]"
235,12,33,18,5261,0,28,5,"[1, 0, 1, 0, 0, 1, 1, 1, 1, 1, 1, 0, 1, 1, 0, 0, 1, 0, 1, 0, 1, 0, 0, 0, 0, 0, 1]"
236,12,19,13,5267,0,2,17,"[0, 5, 0, 3, 3, 4, 3, 2, 5, 1, 0, 0, 4, 3, 1, 2, 0, 3, 1, 3, 2, 1, 0, 0, 3, 4, 3]"
237,12,10,6,5271,0,1,9,"[3, 0, 0, 0, 1, 0, 0, 1, 1, 2, 3, 0, 1, 1, 2, 2, 2, 0, 1, 1, 2, 2, 1, 0, 2, 3, 0]"
238,12,93,81,5283,0,19,74,"[3, 3, 12, 19, 24, 21, 18, 3, 10, 13, 24, 0, 12, 22, 8, 18, 24, 17, 16, 18, 8, 23, 24, 15, 21, 9, 17]"
239,12,28,18,5293,0,18,10,"[3, 0, 3, 0, 1, 1, 2, 1, 0, 1, 2, 0, 3, 3, 2, 3, 3, 0, 0, 3, 1, 2, 1, 3, 0, 2, 2]"
240,12,31,10,5314,0,0,31,"[6, 7, 4, 1, 6, 10, 10, 0, 4, 4, 3, 0, 4, 9, 3, 9, 1, 4, 3, 7, 8, 6, 3, 5, 0, 7, 0]"
241,12,94,27,5381,0,36,58,"[5, 3, 14, 11, 18, 19, 16, 17, 6, 3, 3, 0, 9, 4, 13, 1, 4, 3, 9, 14, 12, 17, 18, 0, 4, 18, 6]"
242,12,99,56,5424,0,19,80,"[4, 24, 2, 5, 2, 11, 15, 19, 13, 3, 12, 0, 0, 2, 4, 14, 2, 23, 19, 5, 16, 11, 6, 24, 26, 18, 11]"
243,12,64,11,5477,0,58,6,"[1, 1, 0, 1, 2, 1, 2, 2, 2, 0, 0, 0, 1, 0, 2, 2, 2, 1, 1, 1, 0, 0, 1, 2, 1, 2, 0]"
244,12,97,83,5491,0,66,31,"[1, 6, 3, 0, 3, 10, 2, 0, 0, 8, 5, 0, 9, 9, 10, 3, 2, 6, 1, 9, 3, 10, 3, 5, 7, 7, 10]"
245,12,71,13,5549,0,42,29,"[3, 5, 5, 6, 2, 2, 9, 2, 2, 7, 2, 0, 8, 2, 1, 0, 5, 0, 8, 6, 0, 7, 5, 6, 2, 4, 2]"
246,12,32,30,5551,0,26,6,"[0, 2, 1, 2, 1, 1, 0, 2, 2, 1, 1, 0, 2, 1, 0, 0, 2, 2, 1, 0, 1, 1, 0, 2, 2, 1, 0]"
247,12,9,0,5560,0,0,9,"[2, 1, 3, 3, 1, 2, 1, 0, 2, 1, 1, 0, 1, 0, 0, 1, 1, 1, 1, 0, 2, 1, 0, 1, 0, 2, 1]"
248,12,94,2,5652,0,44,50,"[3, 11, 7, 4, 13, 3, 14, 6, 8, 14, 0, 0, 11, 10, 9, 9, 5, 2, 11, 10, 10, 6, 14, 8, 11, 12, 3]"
249,12,56,14,5694,0,43,13,"[4, 1, 0, 2, 1, 3, 2, 2, 1, 0, 3, 0, 1, 4, 1, 4, 2, 4, 0, 4, 1, 1, 1, 4, 1, 3, 0]"
250,12,38,31,5701,0,11,27,"[5, 9, 9, 0, 4, 7, 6, 7, 0, 8, 9, 0, 2, 6, 8, 4, 1, 4, 4, 4, 1, 4, 4, 2, 0, 6, 2]"
251,12,9,1,5709,0,7,2,"[0, 0, 0, 0, 0, 0, 0, 0, 0, 0, 0, 0, 0, 0, 0, 0, 0, 0, 0, 0, 0, 0, 0, 0, 0, 0, 0]"
252,12,78,73,5714,0,35,43,"[6, 11, 11, 11, 8, 10, 7, 6, 11, 8, 3, 0, 4, 11, 4, 10, 5, 13, 9, 14, 3, 12, 8, 6, 2, 13, 1]"
253,12,24,17,5721,0,8,16,"[5, 3, 3, 2, 4, 3, 1, 5, 3, 1, 1, 0, 2, 3, 5, 2, 3, 3, 1, 5, 4, 4, 4, 0, 5, 0, 1]"
254,12,37,2,5756,0,12,25,"[0, 7, 0, 1, 4, 4, 4, 3, 2, 6, 6, 0, 6, 6, 0, 3, 5, 3, 6, 5, 0, 4, 8, 7, 5, 0, 8]"
255,12,41,28,5769,0,9,32,"[9, 10, 1, 2, 6, 7, 9, 9, 10, 8, 7, 0, 2, 0, 8, 10, 7, 7, 5, 2, 9, 0, 1, 0, 3, 0, 7]"
256,12,74,13,5830,0,24,50,"[9, 12, 3, 4, 14, 10, 9, 7, 7, 16, 1, 0, 15, 8, 5, 16, 16, 0, 12, 3, 1, 12, 8, 14, 1, 3, 1]"
257,12,33,20,5843,0,26,7,"[2, 1, 0, 1, 1, 1, 0, 0, 2, 2, 2, 0, 0, 1, 0, 2, 0, 1, 0, 1, 1, 2, 2, 2, 0, 1, 2]"
258,12,15,2,5856,0,11,4,"[1, 0, 0, 1, 1, 0, 0, 0, 1, 0, 1, 0, 0, 1, 1, 1, 1, 0, 1, 1, 0, 0, 1, 0, 0, 0, 0]"
259,12,64,61,5859,0,47,17,"[3, 1, 3, 5, 4, 2, 3, 0, 2, 3, 1, 0, 5, 0, 3, 3, 1, 4, 5, 5, 5, 4, 0, 5, 1, 5, 5]"
260,12,14,1,5872,0,2,12,"[4, 2, 1, 3, 0, 2, 0, 4, 1, 3, 2, 0, 2, 4, 4, 1, 2, 0, 1, 2, 0, 0, 2, 2, 4, 3, 4]"
261,12,15,2,5885,0,11,4,"[1, 0, 1, 0, 1, 0, 0, 0, 0, 1, 1, 0, 0, 0, 0, 1, 1, 1, 1, 0, 1, 0, 0, 0, 1, 1, 0]"
262,12,34,16,5903,0,25,9,"[1, 3, 3, 2, 2, 3, 3, 2, 1, 3, 3, 0, 1, 0, 3, 2, 2, 0, 0, 0, 0, 0, 3, 2, 1, 0, 1]"
263,12,45,16,5932,0,44,1,"[0, 0, 0, 0, 0, 0, 0, 0, 0, 0, 0, 0, 0, 0, 0, 0, 0, 0, 0, 0, 0, 0, 0, 0, 0, 0, 0]"
264,12,32,10,5954,0,23,9,"[2, 3, 3, 2, 1, 0, 0, 2, 3, 1, 0, 0, 2, 2, 1, 2, 0, 2, 2, 2, 2, 0, 2, 2, 2, 1, 2]"
265,12,89,69,5974,0,15,74,"[4, 11, 18, 23, 6, 3, 11, 23, 17, 20, 19, 0, 14, 12, 2, 3, 20, 3, 18, 20, 9, 0, 8, 20, 1, 5, 7]"
266,12,1,0,5955,0,1,0,"[0, 0, 0, 0, 0, 0, 0, 0, 0, 0, 0, 0, 0, 0, 0, 0, 0, 0, 0, 0, 0, 0, 0, 0, 0, 0, 0]"
267,12,26,24,5957,0,16,10,"[1, 0, 1, 1, 3, 2, 0, 3, 2, 1, 1, 0, 3, 3, 1, 0, 0, 0, 2, 1, 1, 3, 0, 2, 3, 3, 2]"
268,12,24,8,5973,0,9,15,"[2, 1, 3, 5, 4, 5, 3, 3, 0, 0, 3, 0, 4, 4, 5, 3, 2, 0, 4, 5, 2, 5, 4, 2, 5, 3, 3]"
269,12,88,38,6023,0,85,3,"[0, 1, 1, 1, 1, 0, 1, 0, 0, 0, 0, 0, 0, 0, 0, 1, 1, 0, 0, 1, 0, 0, 0, 0, 0, 0, 1]"
270,12,19,9,6033,0,19,0,"[0, 0, 0, 0, 0, 0, 0, 0, 0, 0, 0, 0, 0, 0, 0, 0, 0, 0, 0, 0, 0, 0, 0, 0, 0, 0, 0]"
271,12,3,0,6036,0,1,2,"[0, 0, 0, 0, 0, 0, 0, 0, 0, 0, 0, 0, 0, 0, 0, 0, 0, 0, 0, 0, 0, 0, 0, 0, 0, 0, 0]"
272,12,97,49,6084,0,13,84,"[12, 3, 13, 8, 16, 6, 14, 1, 10, 11, 21, 0, 24, 21, 18, 18, 1, 16, 11, 26, 22, 23, 22, 24, 18, 12, 27]"
273,12,64,48,6100,0,39,25,"[2, 5, 1, 1, 7, 2, 5, 8, 5, 0, 1, 0, 8, 1, 0, 2, 7, 6, 6, 2, 3, 3, 2, 8, 5, 3, 2]"
274,12,44,5,6139,0,40,4,"[0, 1, 1, 0, 1, 1, 0, 0, 1, 1, 1, 0, 1, 1, 0, 1, 1, 0, 1, 1, 1, 1, 0, 0, 0, 0, 0]"
275,12,82,3,6218,0,68,14,"[2, 2, 2, 0, 4, 2, 2, 4, 3, 2, 2, 0, 4, 4, 4, 3, 4, 4, 3, 2, 0, 4, 0, 2, 0, 2, 3]"
276,12,98,72,6244,0,49,49,"[6, 9, 9, 9, 16, 5, 8, 0, 4, 10, 3, 0, 1, 3, 5, 6, 15, 5, 3, 9, 2, 10, 10, 7, 3, 11, 15]"
277,12,7,7,6244,0,2,5,"[1, 1, 0, 0, 1, 1, 1, 1, 0, 0, 1, 0, 1, 0, 1, 1, 0, 1, 1, 1, 0, 0, 1, 1, 1, 0, 0]"
278,12,90,83,6251,0,48,42,"[4, 3, 14, 4, 4, 11, 12, 10, 5, 10, 10, 0, 10, 10, 5, 5, 12, 14, 3, 9, 12, 11, 3, 5, 4, 14, 2]"
279,12,96,35,6312,0,40,56,"[11, 8, 3, 5, 15, 1, 1, 9, 1, 15, 4, 0, 16, 3, 14, 3, 16, 2, 6, 0, 12, 4, 3, 15, 14, 16, 0]"
280,12,34,11,6335,0,11,23,"[5, 2, 2, 3, 2, 7, 1, 4, 4, 7, 2, 0, 2, 0, 7, 3, 0, 2, 4, 3, 7, 2, 1, 6, 1, 7, 7]"
281,12,51,17,6369,0,42,9,"[1, 2, 2, 1, 3, 0, 2, 0, 2, 3, 1, 0, 0, 3, 1, 0, 0, 2, 3, 0, 3, 3, 0, 2, 1, 3, 1]"
282,12,88,44,6413,0,27,61,"[16, 3, 0, 20, 15, 0, 10, 5, 20, 2, 10, 0, 18, 16, 1, 19, 19, 20, 10, 7, 5, 18, 9, 0, 7, 3, 5]"
283,12,98,6,6505,0,47,51,"[12, 5, 2, 2, 17, 16, 7, 7, 16, 8, 15, 0, 1, 16, 6, 10, 0, 4, 13, 5, 1, 11, 11, 16, 4, 6, 3]"
284,12,99,94,6510,0,12,87,"[18, 28, 5, 20, 10, 19, 1, 9, 29, 18, 3, 0, 10, 23, 27, 21, 12, 20, 12, 25, 11, 14, 28, 20, 27, 12, 4]"
285,12,0,0,6510,0,0,0,"[0, 0, 0, 0, 0, 0, 0, 0, 0, 0, 0, 0, 0, 0, 0, 0, 0, 0, 0, 0, 0, 0, 0, 0, 0, 0, 0]"
286,12,61,4,6567,0,52,9,"[3, 3, 0, 0, 0, 3, 2, 2, 0, 0, 0, 0, 3, 1, 2, 0, 3, 0, 3, 0, 3, 3, 2, 0, 1, 0, 0]"
287,12,30,8,6589,0,16,14,"[2, 3, 0, 1, 1, 1, 1, 1, 0, 3, 3, 0, 2, 1, 4, 0, 1, 2, 4, 0, 2, 0, 1, 1, 2, 1, 4]"
288,12,29,11,6607,0,8,21,"[7, 4, 7, 2, 4, 5, 5, 2, 6, 6, 7, 0, 0, 0, 4, 5, 7, 4, 7, 5, 2, 7, 1, 4, 2, 7, 1]"
289,12,21,10,6618,0,12,9,"[0, 0, 3, 1, 0, 3, 1, 3, 3, 0, 2, 0, 0, 3, 0, 1, 1, 0, 2, 0, 1, 3, 1, 1, 2, 0, 2]"
290,12,11,9,6620,0,5,6,"[1, 1, 0, 0, 0, 2, 0, 1, 2, 2, 1, 0, 1, 0, 1, 1, 0, 1, 2, 0, 1, 0, 1, 2, 0, 1, 0]"
291,12,18,8,6630,0,11,7,"[1, 2, 0, 1, 2, 0, 1, 2, 2, 0, 0, 0, 2, 2, 0, 1, 2, 0, 2, 0, 1, 1, 2, 2, 0, 0, 1]"
292,12,67,61,6636,0,20,47,"[0, 10, 11, 10, 1, 2, 12, 5, 12, 8, 0, 0, 10, 8, 10, 10, 4, 6, 10, 11, 3, 1, 2, 2, 7, 1, 15]"
293,12,18,3,6651,0,7,11,"[0, 1, 1, 1, 0, 2, 1, 1, 1, 1, 0, 0, 3, 3, 2, 3, 2, 1, 2, 1, 2, 0, 2, 1, 3, 2, 2]"
294,12,11,3,6659,0,5,6,"[1, 0, 1, 1, 2, 2, 1, 2, 1, 1, 2, 0, 0, 0, 2, 2, 2, 1, 1, 1, 1, 1, 2, 1, 0, 2, 1]"
295,12,88,39,6708,0,72,16,"[2, 4, 0, 0, 5, 0, 2, 1, 3, 3, 2, 0, 5, 4, 3, 1, 0, 3, 0, 2, 5, 2, 4, 0, 3, 3, 5]"
296,12,70,30,6748,0,48,22,"[5, 0, 5, 5, 0, 3, 6, 3, 7, 6, 4, 0, 7, 7, 1, 6, 1, 4, 6, 6, 4, 2, 4, 1, 7, 7, 4]"
297,12,77,33,6792,0,31,46,"[7, 11, 15, 7, 1, 7, 6, 4, 15, 4, 14, 0, 3, 0, 5, 8, 6, 6, 14, 3, 9, 4, 7, 1, 3, 4, 3]"
298,12,62,38,6816,0,46,16,"[4, 0, 2, 2, 4, 3, 0, 0, 1, 4, 3, 0, 3, 0, 2, 4, 5, 1, 3, 2, 0, 1, 0, 1, 0, 0, 4]"
299,12,88,20,6884,0,68,20,"[5, 6, 2, 2, 1, 0, 4, 4, 2, 2, 3, 0, 3, 6, 1, 0, 3, 0, 4, 6, 5, 2, 2, 5, 5, 0, 5]"
0,13,3230,0,3230,0,1912,1318,"[227, 49, 200, 245, 25, 23, 321, 410, 284, 334, 234, 218, 409, 0, 344, 326, 137, 18, 116, 342, 297, 340, 226, 136, 240, 400, 275]"
1,13,4663,1410,6483,0,1214,3449,"[224, 1127, 474, 452, 558, 306, 805, 1077, 464, 251, 601, 975, 886, 0, 665, 890, 770, 1098, 42, 88, 600, 16, 55, 858, 1029, 506, 9]"
2,13,3942,153,10000,272,1989,1953,"[131, 151, 305, 614, 442, 408, 25, 601, 191, 144, 215, 347, 643, 0, 468, 228, 153, 204, 598, 488, 331, 24, 208, 626, 255, 3, 61]"
3,13,3225,5070,8155,0,426,2799,"[528, 809, 687, 296, 810, 636, 130, 238, 315, 633, 309, 180, 284, 0, 103, 892, 169, 871, 550, 290, 345, 708, 235, 900, 307, 586, 286]"
4,13,3901,5690,6366,0,3007,894,"[114, 70, 165, 6, 31, 43, 213, 55, 88, 108, 184, 227, 287, 0, 200, 213, 75, 211, 123, 228, 246, 137, 65, 236, 259, 218, 223]"
5,13,4282,2985,7663,0,1287,2995,"[863, 670, 5, 979, 72, 721, 650, 143, 224, 153, 560, 521, 147, 0, 81, 74, 907, 198, 843, 828, 313, 334, 905, 716, 920, 712, 904]"
6,13,4854,5528,6989,0,882,3972,"[829, 1141, 525, 1132, 673, 740, 296, 381, 973, 458, 282, 396, 381, 0, 72, 1074, 996, 38, 849, 285, 61, 251, 93, 957, 862, 800, 755]"
7,13,3954,2415,8528,0,1240,2714,"[353, 227, 689, 230, 773, 396, 508, 802, 674, 648, 776, 703, 402, 0, 459, 150, 653, 808, 367, 466, 792, 152, 779, 98, 271, 609, 160]"
8,13,4087,5791,6824,0,1916,2171,"[551, 170, 547, 579, 141, 136, 350, 396, 563, 363, 153, 580, 92, 0, 307, 624, 718, 17, 615, 391, 586, 674, 323, 398, 107, 99, 148]"
9,13,4252,5694,5382,0,3079,1173,"[73, 377, 376, 253, 199, 386, 238, 165, 134, 303, 360, 215, 27, 0, 303, 34, 143, 346, 297, 109, 319, 380, 294, 320, 304, 266, 124]"
10,13,3999,700,8681,0,3656,343,"[2, 88, 39, 41, 99, 102, 15, 49, 110, 88, 73, 62, 99, 0, 47, 12, 3, 48, 24, 30, 71, 7, 99, 107, 86, 77, 3]"
11,13,4554,7345,5890,0,2022,2532,"[348, 33, 321, 528, 820, 444, 281, 61, 598, 778, 744, 811, 105, 0, 332, 397, 722, 549, 597, 102, 636, 273, 97, 571, 671, 732, 152]"
12,13,4159,1428,8621,0,196,3963,"[802, 1225, 173, 196, 190, 749, 609, 510, 751, 618, 1287, 386, 896, 0, 270, 613, 243, 233, 53, 921, 1090, 198, 231, 1091, 1173, 420, 913]"
13,13,4774,5385,8010,0,1466,3308,"[625, 281, 506, 850, 865, 797, 65, 416, 1020, 893, 1022, 967, 394, 0, 1068, 593, 299, 365, 113, 995, 665, 133, 276, 244, 481, 793, 918]"
14,13,4413,6847,5576,0,1531,2882,"[573, 814, 859, 307, 21, 290, 481, 509, 464, 488, 181, 258, 924, 0, 630, 695, 655, 488, 273, 10, 364, 480, 37, 285, 196, 92, 921]"
15,13,4584,1153,9007,0,3746,838,"[31, 64, 9, 230, 195, 193, 187, 160, 155, 273, 277, 10, 147, 0, 183, 31, 133, 140, 279, 15, 30, 213, 62, 121, 54, 186, 70]"
16,13,3211,6164,6054,0,1029,2182,"[155, 141, 350, 190, 480, 345, 379, 14, 530, 603, 111, 666, 179, 0, 234, 127, 694, 4, 430, 417, 368, 435, 531, 142, 578, 387, 613]"
17,13,3174,2681,6547,0,1748,1426,"[390, 246, 384, 86, 148, 79, 276, 444, 346, 306, 337, 296, 6, 0, 394, 180, 137, 333, 154, 76, 176, 338, 390, 458, 188, 329, 269]"
18,13,3025,668,8904,0,389,2636,"[768, 815, 514, 368, 116, 413, 706, 693, 730, 266, 185, 319, 864, 0, 545, 248, 188, 662, 275, 445, 125, 819, 71, 643, 611, 864, 228]"
19,13,4550,7166,6288,0,1522,3028,"[614, 599, 201, 734, 745, 224, 914, 331, 791, 371, 396, 630, 730, 0, 191, 438, 910, 126, 914, 179, 273, 529, 974, 84, 300, 80, 713]"
20,13,4545,2207,8626,0,2106,2439,"[9, 63, 139, 809, 623, 66, 177, 742, 585, 749, 20, 27, 602, 0, 445, 491, 395, 744, 173, 620, 529, 455, 341, 447, 401, 217, 744]"
21,13,3317,7007,4936,0,3104,213,"[26, 28, 35, 45, 1, 33, 26, 19, 16, 57, 36, 17, 45, 0, 14, 35, 34, 64, 43, 59, 65, 58, 32, 32, 59, 16, 32]"
22,13,4517,42,9411,0,839,3678,"[1022, 531, 50, 1188, 337, 324, 305, 1200, 26, 111, 1162, 1017, 649, 0, 1138, 213, 559, 934, 292, 746, 658, 305, 82, 1209, 237, 348, 464]"
23,13,4278,5601,8088,0,1535,2743,"[765, 737, 800, 397, 860, 25, 120, 486, 790, 426, 209, 140, 318, 0, 203, 526, 623, 793, 841, 567, 864, 259, 59, 263, 243, 487, 323]"
24,13,4570,6099,6559,0,723,3847,"[1253, 1248, 115, 356, 378, 172, 405, 75, 856, 1257, 536, 1226, 852, 0, 780, 562, 50, 554, 674, 1267, 21, 757, 1084, 339, 277, 470, 127]"
25,13,4597,6419,4737,0,2430,2167,"[663, 406, 614, 437, 500, 103, 160, 87, 207, 282, 176, 635, 34, 0, 145, 4, 668, 74, 193, 216, 50, 560, 447, 48, 573, 469, 260]"
26,13,3128,2303,5562,0,1398,1730,"[330, 395, 303, 466, 468, 478, 106, 431, 370, 363, 214, 329, 492, 0, 66, 236, 248, 275, 283, 343, 398, 457, 344, 457, 256, 509, 228]"
27,13,4062,2309,7315,0,2769,1293,"[414, 97, 366, 237, 6, 305, 378, 81, 64, 4, 205, 405, 261, 0, 261, 109, 261, 311, 162, 78, 11, 222, 93, 418, 255, 144, 286]"
28,13,4408,5449,6274,0,2487,1921,"[73, 322, 393, 450, 19, 577, 60, 198, 330, 305, 353, 395, 93, 0, 315, 551, 356, 506, 98, 17, 501, 174, 307, 369, 122, 370, 143]"
29,13,3950,1544,8680,0,546,3404,"[701, 783, 828, 653, 534, 121, 480, 694, 650, 225, 711, 839, 1012, 0, 142, 554, 136, 388, 612, 435, 907, 130, 661, 682, 473, 718, 51]"
30,13,4419,5493,7606,0,2091,2328,"[698, 601, 242, 257, 525, 775, 211, 472, 36, 421, 146, 488, 95, 0, 71, 761, 376, 683, 282, 195, 735, 744, 80, 38, 283, 516, 197]"
31,13,3934,5559,5981,0,3645,289,"[84, 68, 51, 84, 66, 39, 39, 67, 79, 54, 76, 31, 32, 0, 62, 71, 74, 74, 11, 3, 40, 83, 93, 90, 71, 40, 48]"
32,13,3547,3419,6109,0,2733,814,"[110, 175, 252, 1, 259, 44, 203, 240, 83, 139, 203, 42, 95, 0, 220, 36, 260, 154, 44, 221, 190, 213, 35, 161, 257, 246, 258]"
33,13,3305,111,9303,0,1197,2108,"[441, 138, 524, 15, 83, 66, 479, 104, 479, 114, 600, 143, 610, 0, 600, 450, 643, 290, 506, 688, 468, 415, 435, 52, 413, 576, 217]"
34,13,4051,7016,6338,0,1154,2897,"[802, 747, 701, 319, 82, 297, 536, 81, 795, 889, 607, 615, 407, 0, 350, 598, 799, 821, 185, 109, 595, 254, 214, 401, 309, 306, 67]"
35,13,4826,5756,5408,0,1886,2940,"[21, 100, 201, 332, 784, 16, 192, 753, 970, 4, 463, 722, 777, 0, 446, 58, 962, 711, 127, 499, 855, 46, 798, 905, 974, 78, 415]"
36,13,3754,3110,6052,0,1911,1843,"[455, 195, 510, 319, 408, 3, 451, 134, 544, 439, 275, 256, 497, 0, 378, 249, 72, 95, 239, 605, 170, 17, 200, 561, 276, 127, 185]"
37,13,3392,2922,6522,0,270,3122,"[509, 303, 799, 626, 213, 160, 508, 665, 1010, 177, 1003, 722, 993, 0, 5, 889, 855, 237, 655, 451, 282, 552, 668, 702, 436, 895, 265]"
38,13,3680,2086,8116,0,513,3167,"[894, 662, 963, 567, 311, 708, 868, 955, 236, 853, 490, 370, 723, 0, 872, 130, 170, 615, 356, 21, 292, 676, 959, 599, 596, 624, 866]"
39,13,4368,6183,6301,0,1176,3192,"[224, 393, 537, 236, 304, 445, 731, 959, 928, 102, 912, 260, 230, 0, 94, 1009, 672, 313, 395, 542, 110, 231, 684, 966, 528, 178, 550]"
40,13,3888,1254,8935,0,2355,1533,"[128, 433, 131, 396, 124, 276, 490, 367, 86, 161, 292, 36, 313, 0, 203, 203, 169, 334, 377, 108, 460, 139, 293, 303, 252, 506, 430]"
41,13,3970,7385,5520,0,602,3368,"[155, 676, 527, 949, 1012, 567, 1008, 428, 1073, 843, 407, 500, 388, 0, 418, 211, 57, 3, 786, 487, 196, 297, 537, 93, 554, 555, 543]"
42,13,4169,224,9465,0,443,3726,"[474, 171, 203, 133, 810, 64, 394, 282, 573, 233, 140, 309, 1083, 0, 714, 1053, 1165, 441, 233, 1079, 541, 815, 46, 180, 339, 850, 1051]"
43,13,3426,5734,7157,0,839,2587,"[532, 123, 857, 354, 667, 95, 784, 792, 135, 195, 137, 727, 36, 0, 147, 579, 350, 462, 580, 477, 731, 287, 185, 586, 465, 460, 29]"
44,13,3680,1330,9507,0,2746,934,"[68, 28, 76, 303, 305, 300, 231, 107, 186, 86, 118, 146, 28, 0, 191, 169, 73, 304, 49, 161, 124, 287, 175, 126, 290, 223, 12]"
45,13,4594,5196,8905,0,827,3767,"[909, 767, 281, 944, 909, 754, 325, 325, 921, 52, 1154, 113, 996, 0, 1182, 1254, 56, 840, 764, 61, 639, 41, 736, 1074, 933, 59, 155]"
46,13,3195,5925,6175,0,3113,82,"[24, 1, 1, 7, 27, 6, 12, 7, 8, 7, 7, 1, 20, 0, 5, 7, 0, 13, 6, 1, 5, 3, 14, 26, 26, 19, 8]"
47,13,4135,3562,6748,0,3331,804,"[245, 57, 89, 166, 263, 138, 207, 255, 13, 42, 122, 221, 59, 0, 121, 170, 106, 240, 46, 142, 6, 247, 87, 32, 182, 164, 143]"
48,13,4744,5736,5756,0,100,4644,"[1251, 442, 1460, 1466, 1217, 1009, 93, 303, 336, 278, 1546, 1476, 1090, 0, 174, 1113, 901, 575, 784, 373, 1036, 86, 869, 1363, 1212, 398, 687]"
49,13,3697,3298,6155,0,1466,2231,"[212, 124, 46, 33, 157, 495, 722, 144, 667, 12, 193, 344, 3, 0, 502, 444, 510, 352, 437, 438, 312, 382, 306, 229, 656, 253, 445]"
50,13,4490,4387,6258,0,407,4083,"[603, 375, 498, 538, 1300, 1214, 296, 1054, 973, 216, 1134, 824, 1168, 0, 582, 655, 109, 1221, 850, 488, 823, 725, 176, 966, 1139, 461, 112]"
51,13,3080,1628,7710,0,740,2340,"[117, 91, 611, 453, 680, 212, 643, 386, 40, 554, 683, 351, 672, 0, 491, 780, 85, 727, 524, 285, 402, 507, 693, 17, 272, 225, 766]"
52,13,4495,6467,5738,0,2121,2374,"[12, 278, 32, 131, 253, 148, 575, 537, 365, 166, 675, 251, 775, 0, 27, 239, 555, 0, 520, 710, 639, 585, 248, 368, 591, 757, 193]"
53,13,3607,2350,6995,0,2099,1508,"[248, 21, 57, 376, 76, 384, 110, 318, 462, 106, 149, 436, 389, 0, 437, 45, 378, 163, 137, 24, 117, 174, 484, 371, 292, 40, 282]"
54,13,4311,5762,5544,0,840,3471,"[1051, 45, 829, 977, 626, 986, 912, 789, 226, 359, 379, 354, 682, 0, 31, 636, 97, 908, 397, 568, 482, 1144, 571, 791, 413, 101, 490]"
55,13,4640,1174,9010,0,2986,1654,"[110, 492, 399, 153, 239, 482, 388, 181, 73, 514, 207, 118, 119, 0, 406, 270, 293, 7, 390, 465, 247, 210, 239, 476, 291, 384, 276]"
56,13,4967,6682,7295,0,3295,1672,"[446, 458, 303, 188, 335, 294, 522, 437, 123, 191, 141, 437, 156, 0, 10, 159, 447, 263, 147, 460, 19, 34, 338, 536, 451, 62, 118]"
57,13,3275,2477,8093,0,1137,2138,"[209, 465, 287, 59, 108, 145, 186, 112, 86, 484, 695, 549, 535, 0, 579, 423, 534, 546, 534, 36, 666, 550, 389, 396, 332, 676, 28]"
58,13,4003,6216,5880,0,3564,439,"[41, 118, 90, 24, 94, 60, 145, 96, 84, 129, 86, 14, 43, 0, 64, 34, 62, 47, 50, 114, 81, 15, 0, 41, 106, 118, 124]"
59,13,3169,2748,6301,0,1415,1754,"[171, 133, 516, 407, 269, 17, 224, 307, 480, 89, 122, 233, 231, 0, 206, 376, 250, 256, 312, 335, 465, 498, 366, 508, 21, 50, 534]"
60,13,4466,2002,8765,0,3570,896,"[147, 188, 239, 137, 162, 217, 153, 187, 37, 246, 63, 276, 276, 0, 168, 152, 61, 290, 259, 158, 75, 192, 273, 265, 226, 26, 147]"
61,13,3717,5622,6860,0,3347,370,"[7, 65, 93, 11, 10, 96, 98, 81, 59, 117, 117, 105, 32, 0, 31, 50, 13, 35, 77, 116, 42, 29, 52, 90, 65, 97, 16]"
62,13,4522,6221,5161,0,2141,2381,"[29, 381, 253, 248, 776, 747, 28, 128, 29, 386, 521, 658, 602, 0, 336, 563, 579, 202, 448, 644, 192, 400, 235, 241, 555, 216, 739]"
63,13,3582,2468,6275,0,869,2713,"[312, 135, 286, 628, 742, 495, 870, 417, 871, 892, 254, 462, 673, 0, 674, 317, 244, 151, 714, 387, 386, 648, 351, 696, 217, 725, 553]"
64,13,4454,2263,8466,0,1638,2816,"[342, 129, 871, 170, 343, 69, 142, 902, 618, 391, 110, 917, 840, 0, 411, 892, 839, 704, 58, 344, 722, 101, 6, 746, 49, 738, 831]"
65,13,4976,5005,8437,0,4849,127,"[41, 16, 7, 31, 30, 4, 17, 29, 16, 19, 18, 9, 42, 0, 8, 38, 1, 14, 20, 36, 3, 38, 37, 20, 39, 34, 16]"
66,13,4128,7493,5072,0,3360,768,"[8, 32, 203, 189, 101, 154, 210, 162, 130, 18, 177, 100, 169, 0, 213, 164, 47, 76, 243, 242, 112, 113, 76, 21, 177, 234, 100]"
67,13,3993,2839,6226,0,3295,698,"[81, 138, 30, 90, 33, 194, 130, 167, 229, 111, 231, 180, 132, 0, 179, 2, 134, 22, 219, 175, 13, 213, 5, 40, 230, 221, 17]"
68,13,4274,1299,9201,0,3244,1030,"[225, 321, 187, 230, 268, 112, 187, 25, 135, 30, 45, 254, 263, 0, 306, 246, 3, 253, 5, 316, 295, 43, 342, 130, 125, 257, 192]"
69,13,4280,5274,8207,0,1362,2918,"[876, 271, 465, 628, 742, 830, 465, 22, 542, 682, 328, 563, 485, 0, 108, 720, 538, 182, 337, 558, 592, 682, 225, 489, 875, 776, 970]"
70,13,3616,6721,5102,0,335,3281,"[259, 22, 365, 1013, 395, 261, 526, 658, 328, 258, 71, 1044, 457, 0, 75, 294, 55, 246, 597, 492, 365, 619, 456, 748, 876, 663, 343]"
71,13,4147,1495,7754,0,2682,1465,"[437, 145, 228, 461, 68, 100, 146, 294, 383, 338, 15, 124, 176, 0, 67, 250, 342, 320, 265, 107, 445, 306, 160, 398, 161, 293, 385]"
72,13,3320,5268,5806,0,3075,245,"[12, 0, 72, 77, 46, 54, 70, 20, 4, 68, 10, 5, 45, 0, 80, 7, 60, 37, 29, 14, 53, 60, 59, 5, 44, 48, 2]"
73,13,4229,4217,5818,0,1789,2440,"[118, 750, 419, 776, 617, 91, 114, 579, 503, 393, 138, 723, 720, 0, 717, 58, 596, 479, 542, 167, 747, 744, 173, 105, 10, 678, 811]"
74,13,3535,1422,7931,0,1447,2088,"[59, 368, 496, 402, 430, 676, 479, 101, 526, 526, 430, 564, 239, 0, 657, 634, 103, 446, 609, 348, 492, 175, 178, 280, 33, 558, 32]"
75,13,4763,7333,5361,0,4094,669,"[112, 72, 174, 165, 187, 181, 1, 14, 202, 146, 4, 177, 104, 0, 169, 27, 1, 44, 49, 174, 170, 132, 124, 26, 194, 4, 107]"
76,13,3649,248,8762,0,2940,709,"[174, 103, 14, 76, 98, 34, 7, 13, 102, 178, 81, 164, 85, 0, 101, 61, 186, 137, 98, 104, 167, 141, 98, 12, 62, 185, 116]"
77,13,3333,6899,5196,0,2287,1046,"[30, 94, 85, 110, 113, 20, 20, 25, 116, 88, 94, 275, 108, 0, 347, 137, 53, 270, 69, 51, 89, 108, 203, 138, 13, 320, 170]"
78,13,4610,197,9609,0,1755,2855,"[158, 425, 889, 135, 116, 153, 947, 761, 796, 83, 778, 283, 426, 0, 267, 122, 299, 51, 656, 391, 725, 513, 414, 776, 9, 272, 501]"
79,13,3565,6143,7031,0,3077,488,"[150, 116, 54, 55, 101, 117, 13, 35, 12, 3, 30, 129, 106, 0, 32, 137, 79, 51, 41, 148, 30, 144, 13, 123, 89, 49, 123]"
80,13,3282,1749,8564,0,1568,1714,"[182, 446, 268, 271, 211, 467, 228, 517, 219, 26, 567, 264, 248, 0, 329, 246, 363, 229, 452, 441, 159, 253, 17, 496, 205, 431, 260]"
81,13,3832,6535,5861,0,2838,994,"[157, 266, 311, 274, 231, 265, 242, 248, 252, 299, 99, 110, 187, 0, 18, 290, 261, 287, 272, 235, 229, 299, 189, 144, 202, 117, 163]"
82,13,4472,2464,7869,0,264,4208,"[1241, 1366, 1256, 226, 36, 1036, 951, 876, 921, 191, 742, 1393, 348, 0, 974, 211, 1251, 833, 1347, 600, 1322, 187, 532, 219, 383, 495, 1080]"
83,13,4639,6582,5926,0,947,3692,"[570, 910, 1207, 908, 586, 753, 273, 1206, 1152, 656, 745, 518, 818, 0, 628, 915, 858, 641, 623, 155, 26, 168, 635, 8, 845, 630, 481]"
84,13,3397,1205,8118,0,1784,1613,"[343, 352, 126, 141, 426, 151, 307, 135, 182, 41, 378, 343, 48, 0, 488, 361, 313, 233, 218, 347, 136, 325, 298, 71, 446, 377, 88]"
85,13,3755,6277,5596,0,1125,2630,"[598, 141, 104, 779, 774, 356, 63, 498, 49, 585, 491, 474, 129, 0, 13, 754, 668, 741, 19, 707, 262, 636, 649, 392, 7, 278, 711]"
86,13,4882,3617,6861,0,3015,1867,"[594, 365, 572, 177, 346, 248, 235, 33, 404, 394, 197, 126, 267, 0, 427, 149, 285, 619, 376, 294, 579, 433, 548, 255, 384, 67, 356]"
87,13,3097,1895,8063,0,209,2888,"[11, 326, 961, 16, 800, 254, 237, 214, 11, 642, 765, 682, 716, 0, 559, 757, 255, 590, 277, 81, 762, 462, 841, 886, 550, 56, 301]"
88,13,3028,6591,4500,0,1403,1625,"[201, 150, 344, 317, 315, 435, 87, 376, 286, 538, 301, 247, 298, 0, 187, 347, 168, 69, 514, 470, 264, 344, 475, 294, 395, 72, 127]"
89,13,3537,3454,4583,0,2716,821,"[136, 218, 187, 150, 226, 104, 209, 55, 95, 266, 211, 125, 175, 0, 103, 43, 93, 71, 158, 248, 259, 158, 14, 29, 61, 28, 159]"
90,13,3509,2441,5651,0,1360,2149,"[677, 10, 669, 403, 251, 325, 678, 295, 533, 625, 538, 547, 520, 0, 349, 707, 267, 387, 307, 58, 55, 509, 692, 676, 562, 432, 446]"
91,13,4006,3770,5887,0,2748,1258,"[192, 26, 43, 374, 227, 78, 97, 206, 204, 249, 235, 293, 314, 0, 288, 185, 303, 59, 43, 135, 222, 5, 197, 257, 58, 400, 305]"
92,13,4762,2274,8375,0,147,4615,"[440, 348, 1304, 1461, 876, 1112, 476, 74, 1041, 805, 1342, 1379, 73, 0, 1327, 89, 709, 469, 604, 372, 505, 280, 1153, 283, 259, 470, 501]"
93,13,3119,5733,5761,0,3039,80,"[3, 23, 0, 9, 2, 10, 20, 25, 25, 18, 19, 4, 6, 0, 10, 9, 19, 0, 21, 7, 0, 19, 15, 18, 24, 8, 22]"
94,13,3684,1234,8211,0,2188,1496,"[261, 225, 412, 398, 64, 347, 75, 407, 354, 445, 234, 331, 449, 0, 405, 106, 265, 289, 338, 276, 14, 393, 23, 243, 61, 17, 455]"
95,13,4539,7383,5367,0,1964,2575,"[424, 340, 173, 100, 841, 330, 622, 819, 218, 355, 334, 290, 682, 0, 234, 334, 299, 476, 282, 279, 828, 779, 434, 580, 524, 6, 26]"
96,13,4564,1791,8140,0,2103,2461,"[363, 220, 644, 399, 491, 728, 67, 349, 459, 325, 596, 58, 495, 0, 386, 787, 56, 137, 173, 280, 26, 759, 247, 251, 380, 127, 579]"
97,13,4899,6833,6206,0,4377,522,"[52, 124, 64, 153, 167, 172, 9, 62, 114, 164, 83, 75, 82, 0, 55, 25, 86, 60, 12, 160, 163, 169, 141, 99, 146, 38, 80]"
98,13,3393,1851,7748,0,2638,755,"[91, 6, 177, 75, 106, 82, 236, 232, 79, 18, 108, 121, 179, 0, 27, 198, 13, 66, 101, 99, 238, 188, 26, 109, 235, 209, 78]"
99,13,4976,6506,6218,0,2488,2488,"[255, 749, 650, 595, 463, 75, 666, 828, 601, 689, 47, 772, 822, 0, 569, 552, 280, 62, 784, 310, 217, 275, 283, 712, 497, 290, 192]"
100,13,3774,507,9485,0,1733,2041,"[516, 229, 224, 433, 603, 161, 457, 521, 652, 532, 27, 512, 123, 0, 653, 72, 67, 307, 612, 550, 402, 319, 641, 249, 368, 465, 216]"
101,13,3686,5834,7337,0,1096,2590,"[359, 207, 255, 100, 95, 142, 48, 438, 537, 216, 110, 244, 806, 0, 50, 379, 451, 482, 283, 707, 457, 90, 201, 202, 473, 738, 18]"
102,13,4548,7239,4646,0,2773,1775,"[392, 329, 455, 213, 148, 501, 268, 274, 227, 399, 518, 434, 1, 0, 80, 154, 62, 373, 132, 5, 587, 75, 458, 94, 390, 341, 486]"
103,13,3850,1792,6704,0,1783,2067,"[146, 430, 99, 560, 392, 398, 80, 394, 6, 375, 546, 142, 481, 0, 541, 449, 417, 64, 620, 132, 36, 630, 567, 210, 627, 516, 271]"
104,13,3816,1841,8679,0,3353,463,"[119, 83, 78, 70, 11, 100, 152, 41, 69, 116, 85, 116, 124, 0, 29, 61, 91, 5, 111, 93, 60, 152, 135, 132, 8, 152, 112]"
105,13,4044,5466,7257,0,1909,2135,"[424, 615, 251, 299, 380, 386, 77, 435, 123, 176, 491, 274, 636, 0, 237, 84, 396, 267, 192, 81, 6, 541, 227, 546, 651, 647, 144]"
106,13,3524,1728,9053,0,910,2614,"[780, 452, 387, 712, 450, 714, 53, 610, 44, 611, 234, 71, 548, 0, 26, 230, 656, 293, 67, 169, 209, 290, 104, 582, 779, 495, 3]"
107,13,3796,6364,6485,0,3715,81,"[5, 23, 18, 1, 4, 17, 26, 16, 6, 15, 17, 6, 17, 0, 25, 18, 21, 11, 9, 18, 23, 17, 17, 11, 11, 20, 11]"
108,13,3625,2655,7455,0,1909,1716,"[501, 152, 525, 19, 131, 364, 416, 198, 258, 436, 269, 127, 14, 0, 188, 74, 386, 268, 296, 475, 172, 69, 428, 135, 452, 470, 46]"
109,13,3665,7357,3763,0,3419,246,"[33, 2, 60, 31, 72, 20, 10, 7, 50, 27, 61, 15, 70, 0, 5, 69, 48, 19, 73, 49, 29, 76, 49, 13, 71, 33, 76]"
110,13,4485,2398,5850,0,3651,834,"[198, 194, 72, 42, 156, 220, 113, 261, 235, 30, 251, 168, 211, 0, 120, 76, 271, 23, 92, 89, 201, 202, 125, 108, 70, 115, 218]"
111,13,3588,755,8683,0,2431,1157,"[107, 83, 106, 223, 188, 68, 204, 134, 257, 145, 105, 189, 12, 0, 176, 52, 201, 369, 370, 58, 14, 66, 163, 348, 341, 371, 203]"
112,13,4743,5827,7599,0,821,3922,"[1275, 429, 489, 1021, 795, 936, 550, 662, 1259, 1089, 897, 986, 241, 0, 1085, 615, 435, 145, 1288, 276, 953, 534, 901, 1168, 1059, 121, 1125]"
113,13,4862,7204,5257,0,1245,3617,"[323, 186, 147, 934, 970, 923, 824, 271, 492, 833, 257, 1044, 253, 0, 789, 294, 1177, 754, 143, 943, 55, 831, 586, 827, 144, 250, 702]"
114,13,3492,2228,6521,0,391,3101,"[196, 985, 41, 531, 562, 881, 98, 76, 561, 384, 779, 591, 33, 0, 633, 902, 17, 61, 105, 813, 653, 995, 561, 134, 1014, 838, 688]"
115,13,4054,303,10000,272,550,3504,"[282, 207, 532, 440, 347, 590, 199, 172, 609, 682, 80, 405, 1018, 0, 181, 1142, 553, 177, 431, 224, 642, 84, 35, 729, 25, 965, 628]"
116,13,3614,6809,6805,0,1942,1672,"[164, 309, 75, 366, 101, 403, 372, 167, 58, 5, 144, 329, 537, 0, 367, 313, 432, 38, 498, 239, 104, 313, 114, 485, 71, 420, 192]"
117,13,4945,7058,4692,0,896,4049,"[1233, 1188, 730, 959, 283, 1162, 649, 1047, 581, 609, 1131, 763, 359, 0, 796, 441, 323, 636, 877, 1034, 865, 78, 524, 1280, 475, 1131, 895]"
118,13,3481,386,7787,0,2786,695,"[113, 144, 66, 153, 224, 0, 65, 94, 116, 69, 151, 168, 39, 0, 155, 226, 20, 141, 134, 174, 90, 201, 32, 70, 218, 129, 74]"
119,13,3822,7261,4348,0,116,3706,"[203, 308, 1231, 124, 574, 253, 390, 495, 756, 61, 105, 297, 1208, 0, 628, 963, 514, 849, 190, 1173, 565, 149, 987, 561, 398, 1219, 203]"
120,13,3389,660,7077,0,1171,2218,"[623, 280, 47, 403, 457, 556, 527, 175, 157, 656, 526, 533, 453, 0, 255, 140, 526, 94, 406, 113, 597, 459, 60, 119, 632, 582, 298]"
121,13,3317,1274,9120,0,1057,2260,"[367, 571, 381, 180, 674, 242, 257, 676, 655, 570, 611, 298, 508, 0, 138, 56, 241, 643, 503, 595, 475, 736, 35, 585, 324, 707, 127]"
122,13,3696,6539,6277,0,2135,1561,"[270, 143, 324, 137, 334, 322, 323, 407, 316, 283, 303, 48, 116, 0, 29, 134, 68, 144, 421, 245, 212, 59, 48, 437, 36, 221, 192]"
123,13,4372,2271,8378,0,3274,1098,"[116, 227, 18, 245, 136, 129, 300, 165, 37, 177, 151, 283, 336, 0, 282, 238, 55, 16, 183, 17, 78, 247, 19, 114, 313, 152, 178]"
124,13,3393,5531,6240,0,946,2447,"[370, 478, 363, 166, 576, 693, 52, 546, 577, 727, 805, 715, 64, 0, 38, 621, 514, 490, 377, 240, 3, 537, 610, 667, 509, 101, 175]"
125,13,3263,3218,6285,0,1364,1899,"[3, 428, 214, 289, 599, 292, 388, 42, 55, 578, 13, 411, 155, 0, 373, 372, 442, 599, 43, 523, 471, 93, 318, 220, 348, 579, 604]"
126,13,3068,2985,6368,0,3000,68,"[2, 22, 1, 7, 9, 14, 15, 5, 16, 8, 11, 9, 4, 0, 7, 14, 8, 5, 20, 5, 15, 5, 2, 3, 14, 21, 17]"
127,13,3693,417,9644,0,1297,2396,"[20, 133, 144, 730, 599, 367, 124, 508, 124, 742, 378, 20, 391, 0, 293, 484, 280, 117, 14, 20, 535, 548, 5, 15, 6, 169, 634]"
128,13,4563,7031,7176,0,787,3776,"[118, 825, 902, 486, 145, 1207, 60, 14, 752, 1099, 1138, 957, 931, 0, 412, 543, 371, 251, 887, 236, 106, 208, 1054, 419, 805, 142, 469]"
129,13,3871,6892,4155,0,216,3655,"[806, 307, 997, 82, 702, 1083, 588, 208, 1213, 925, 502, 1191, 519, 0, 756, 449, 1, 763, 1207, 998, 578, 204, 208, 543, 897, 202, 754]"
130,13,3569,1450,6274,0,3237,332,"[53, 44, 97, 17, 103, 110, 58, 39, 53, 12, 71, 40, 5, 0, 75, 44, 66, 16, 40, 98, 91, 72, 107, 109, 107, 84, 76]"
131,13,3942,2332,7884,0,2525,1417,"[43, 344, 399, 467, 21, 390, 276, 281, 1, 18, 91, 319, 220, 0, 413, 235, 402, 366, 465, 16, 175, 285, 179, 241, 239, 434, 3]"
132,13,4596,6907,5573,0,3242,1354,"[259, 97, 16, 335, 201, 225, 389, 105, 142, 367, 256, 104, 432, 0, 379, 83, 113, 411, 64, 100, 370, 278, 118, 217, 323, 244, 214]"
133,13,3594,38,9129,0,977,2617,"[185, 182, 148, 259, 339, 464, 221, 762, 152, 510, 450, 0, 78, 0, 695, 817, 173, 740, 75, 67, 391, 324, 729, 340, 175, 341, 78]"
134,13,3396,6454,6071,0,1529,1867,"[206, 130, 62, 341, 56, 227, 154, 46, 569, 254, 394, 54, 34, 0, 386, 305, 357, 300, 520, 327, 376, 591, 594, 21, 284, 619, 319]"
135,13,3094,2874,6291,0,2024,1070,"[97, 275, 175, 64, 72, 164, 163, 285, 342, 263, 261, 134, 319, 0, 255, 68, 54, 147, 212, 138, 62, 145, 35, 169, 257, 352, 185]"
136,13,3017,994,8314,0,1414,1603,"[145, 292, 366, 41, 1, 158, 77, 61, 213, 416, 391, 80, 313, 0, 488, 374, 14, 485, 412, 267, 358, 224, 105, 191, 112, 420, 287]"
137,13,3758,5844,6228,0,3344,414,"[130, 114, 88, 17, 70, 137, 92, 64, 93, 68, 123, 31, 134, 0, 110, 1, 132, 49, 68, 98, 128, 105, 41, 34, 106, 89, 84]"
138,13,4729,3450,7507,0,2019,2710,"[341, 248, 55, 502, 64, 208, 623, 824, 283, 247, 677, 786, 23, 0, 420, 482, 378, 411, 417, 324, 691, 160, 435, 785, 428, 380, 640]"
139,13,4949,6542,5914,0,3112,1837,"[243, 201, 184, 108, 499, 64, 109, 358, 539, 477, 406, 160, 312, 0, 249, 565, 81, 274, 42, 546, 471, 199, 178, 422, 398, 12, 409]"
140,13,4619,831,9702,0,1990,2629,"[573, 338, 472, 420, 745, 690, 299, 640, 536, 611, 419, 437, 772, 0, 804, 84, 686, 790, 541, 627, 624, 839, 6, 364, 677, 113, 343]"
141,13,4143,6435,7410,0,3818,325,"[5, 54, 15, 78, 22, 26, 62, 20, 82, 18, 45, 76, 82, 0, 79, 48, 103, 37, 5, 46, 83, 43, 19, 82, 90, 98, 44]"
142,13,3238,2029,8619,0,2271,967,"[114, 118, 225, 149, 295, 273, 304, 79, 151, 229, 210, 118, 222, 0, 135, 65, 142, 103, 255, 176, 80, 243, 308, 61, 37, 29, 309]"
143,13,3185,5062,6742,0,946,2239,"[251, 516, 290, 664, 331, 456, 678, 120, 677, 591, 131, 85, 689, 0, 623, 209, 97, 113, 19, 574, 224, 290, 199, 265, 158, 486, 380]"
144,13,4232,3494,7480,0,245,3987,"[612, 1226, 788, 219, 1300, 769, 551, 865, 435, 805, 1158, 1158, 776, 0, 944, 580, 335, 1115, 867, 624, 333, 1281, 867, 114, 1155, 1275, 173]"
145,13,3989,7354,4115,0,2134,1855,"[123, 185, 295, 423, 23, 5, 510, 477, 215, 469, 524, 446, 324, 0, 51, 300, 295, 85, 54, 101, 321, 615, 250, 286, 118, 537, 561]"
146,13,4718,4461,4372,0,369,4349,"[137, 622, 1026, 439, 555, 669, 1009, 419, 1200, 471, 220, 918, 1369, 0, 778, 490, 991, 366, 354, 911, 395, 954, 1075, 151, 461, 413, 1158]"
147,13,4308,993,7687,0,2191,2117,"[442, 265, 392, 453, 540, 395, 440, 42, 466, 91, 289, 552, 188, 0, 186, 94, 262, 673, 445, 42, 6, 293, 410, 661, 144, 209, 150]"
148,13,3631,5353,5965,0,3474,157,"[30, 3, 7, 24, 19, 20, 39, 11, 0, 21, 28, 38, 1, 0, 19, 23, 1, 39, 34, 13, 12, 47, 27, 2, 11, 25, 38]"
149,13,4532,1245,9252,0,2333,2199,"[542, 283, 26, 701, 101, 225, 36, 348, 509, 596, 529, 159, 641, 0, 243, 281, 213, 32, 123, 450, 185, 486, 38, 359, 468, 494, 684]"
150,13,3088,6997,5343,0,1964,1124,"[95, 128, 248, 197, 24, 133, 325, 305, 313, 371, 311, 152, 230, 0, 200, 234, 156, 294, 301, 93, 260, 51, 349, 66, 7, 205, 224]"
151,13,3665,955,8053,0,2013,1652,"[489, 351, 306, 242, 221, 87, 549, 48, 73, 15, 348, 158, 398, 0, 232, 419, 374, 483, 69, 43, 503, 503, 46, 273, 382, 462, 6]"
152,13,4260,7190,5123,0,2800,1460,"[157, 467, 136, 388, 58, 153, 429, 397, 401, 383, 336, 98, 180, 0, 212, 433, 298, 403, 11, 87, 303, 68, 303, 462, 248, 296, 146]"
153,13,4958,4865,5216,0,1064,3894,"[367, 876, 307, 874, 996, 287, 1201, 491, 226, 1277, 682, 1100, 134, 0, 222, 649, 756, 836, 285, 1120, 263, 316, 1083, 308, 758, 300, 881]"
154,13,3372,589,7999,0,334,3038,"[816, 441, 343, 983, 314, 148, 667, 967, 811, 160, 118, 618, 533, 0, 986, 126, 142, 451, 194, 274, 257, 519, 418, 129, 851, 769, 901]"
155,13,3641,6486,5154,0,1094,2547,"[185, 47, 485, 744, 847, 117, 254, 217, 114, 161, 47, 519, 5, 0, 227, 114, 25, 405, 286, 728, 457, 687, 619, 194, 735, 840, 572]"
156,13,4809,384,9579,0,1888,2921,"[892, 593, 162, 631, 240, 785, 144, 343, 583, 868, 633, 355, 290, 0, 281, 779, 234, 200, 475, 540, 45, 386, 73, 341, 301, 14, 893]"
157,13,4815,6217,8177,0,4067,748,"[128, 20, 66, 183, 181, 32, 101, 93, 44, 55, 101, 166, 194, 0, 120, 119, 186, 28, 157, 73, 59, 222, 213, 193, 13, 115, 101]"
158,13,3659,7310,4526,0,1417,2242,"[323, 218, 197, 511, 534, 522, 422, 215, 625, 694, 583, 590, 736, 0, 504, 572, 429, 565, 438, 352, 430, 505, 171, 299, 14, 46, 689]"
159,13,3505,1424,6607,0,2905,600,"[133, 147, 83, 23, 67, 94, 43, 182, 85, 79, 121, 39, 0, 0, 196, 69, 39, 164, 29, 32, 7, 159, 12, 160, 119, 82, 55]"
160,13,3886,931,9562,0,1899,1987,"[591, 593, 549, 223, 652, 490, 159, 216, 57, 180, 294, 115, 363, 0, 95, 184, 387, 409, 349, 315, 432, 112, 137, 627, 548, 9, 82]"
161,13,4277,7169,6670,0,513,3764,"[370, 771, 228, 964, 106, 1043, 361, 475, 88, 444, 404, 892, 545, 0, 1252, 581, 670, 1188, 658, 511, 340, 392, 575, 596, 720, 340, 900]"
162,13,4608,5152,6126,0,3613,995,"[321, 272, 145, 161, 86, 329, 88, 31, 323, 258, 251, 137, 64, 0, 244, 146, 11, 16, 216, 73, 78, 163, 74, 118, 160, 82, 287]"
163,13,3254,1472,7908,0,1010,2244,"[504, 462, 674, 482, 286, 230, 746, 544, 448, 458, 625, 737, 45, 0, 131, 435, 36, 311, 64, 597, 667, 579, 528, 747, 456, 323, 529]"
164,13,3420,6056,5272,0,1592,1828,"[462, 601, 236, 337, 483, 121, 461, 520, 568, 38, 129, 162, 202, 0, 283, 556, 334, 53, 92, 386, 545, 77, 510, 558, 72, 416, 311]"
165,13,4302,2650,6924,0,429,3873,"[899, 580, 1055, 943, 610, 605, 487, 699, 786, 429, 962, 1141, 616, 0, 91, 749, 598, 417, 960, 923, 943, 692, 1018, 575, 1106, 1085, 315]"
166,13,4838,5112,6650,0,3160,1678,"[226, 481, 501, 329, 45, 287, 54, 489, 10, 517, 544, 58, 161, 0, 414, 86, 23, 198, 102, 190, 213, 284, 511, 546, 409, 440, 322]"
167,13,4513,7399,3764,0,1400,3113,"[851, 198, 469, 240, 867, 222, 392, 81, 606, 272, 945, 287, 963, 0, 929, 838, 313, 433, 361, 218, 1031, 27, 835, 459, 141, 594, 901]"
168,13,3418,3255,3927,0,654,2764,"[597, 149, 291, 652, 545, 37, 20, 154, 407, 163, 618, 632, 867, 0, 642, 677, 634, 19, 426, 785, 673, 832, 599, 701, 781, 714, 852]"
169,13,4693,1642,6978,0,763,3930,"[249, 354, 87, 955, 1151, 620, 37, 1188, 1118, 861, 766, 1136, 1170, 0, 47, 594, 459, 279, 567, 716, 457, 884, 968, 139, 92, 906, 1289]"
170,13,4435,5593,5820,0,1298,3137,"[967, 898, 986, 396, 1, 824, 596, 98, 731, 688, 932, 17, 45, 0, 539, 564, 394, 579, 992, 56, 486, 527, 658, 989, 424, 839, 246]"
171,13,4222,689,9353,0,2249,1973,"[606, 358, 440, 443, 515, 620, 256, 140, 371, 334, 134, 645, 36, 0, 24, 518, 99, 70, 314, 580, 606, 55, 151, 441, 322, 472, 349]"
172,13,4508,7024,6837,0,3713,795,"[259, 62, 199, 93, 120, 104, 118, 209, 8, 177, 65, 79, 68, 0, 70, 194, 151, 96, 62, 190, 238, 77, 198, 164, 64, 89, 62]"
173,13,4229,7254,3812,0,997,3232,"[224, 975, 931, 501, 102, 657, 494, 198, 567, 162, 279, 854, 909, 0, 610, 111, 319, 965, 289, 889, 805, 922, 401, 231, 19, 572, 575]"
174,13,4078,2635,5255,0,1045,3033,"[783, 890, 952, 109, 397, 829, 795, 25, 781, 15, 568, 35, 633, 0, 213, 171, 547, 600, 981, 353, 806, 278, 23, 983, 398, 904, 102]"
175,13,3747,1313,7689,0,3414,333,"[44, 41, 46, 99, 22, 65, 89, 18, 29, 101, 96, 76, 85, 0, 8, 73, 13, 93, 32, 27, 39, 48, 79, 76, 106, 95, 103]"
176,13,4957,6129,6517,0,4050,907,"[4, 32, 231, 43, 8, 151, 103, 57, 166, 225, 23, 157, 74, 0, 188, 120, 184, 130, 246, 76, 189, 291, 209, 145, 216, 12, 24]"
177,13,4429,4096,6850,0,3783,646,"[29, 82, 132, 205, 157, 166, 130, 93, 31, 205, 214, 30, 128, 0, 129, 204, 84, 184, 184, 64, 11, 141, 202, 86, 18, 100, 53]"
178,13,3662,278,10000,234,1885,1777,"[140, 21, 203, 88, 253, 460, 30, 488, 67, 9, 539, 404, 59, 0, 99, 340, 586, 312, 294, 173, 444, 486, 319, 83, 365, 365, 206]"
179,13,4823,5330,9493,0,709,4114,"[665, 268, 394, 936, 637, 292, 190, 836, 841, 27, 1068, 961, 1265, 0, 143, 20, 867, 317, 410, 811, 1199, 795, 589, 989, 175, 565, 381]"
180,13,4901,5251,9143,0,3253,1648,"[149, 254, 14, 84, 34, 83, 321, 228, 181, 20, 303, 427, 124, 0, 104, 420, 202, 442, 294, 466, 169, 365, 411, 266, 486, 537, 360]"
181,13,3255,7367,5031,0,2303,952,"[74, 233, 177, 186, 111, 83, 213, 26, 127, 140, 3, 107, 189, 0, 9, 274, 280, 168, 106, 102, 290, 21, 73, 279, 293, 249, 54]"
182,13,3991,3416,5606,0,475,3516,"[921, 534, 913, 689, 887, 880, 311, 746, 941, 338, 396, 39, 923, 0, 34, 36, 147, 760, 906, 936, 785, 221, 414, 777, 538, 1047, 859]"
183,13,4906,3573,6939,0,1933,2973,"[203, 67, 136, 298, 947, 870, 739, 220, 293, 306, 690, 39, 545, 0, 267, 664, 977, 463, 457, 446, 826, 775, 51, 193, 48, 605, 95]"
184,13,4664,6933,4670,0,1783,2881,"[243, 553, 742, 734, 280, 473, 82, 236, 4, 514, 830, 613, 632, 0, 106, 168, 46, 928, 924, 201, 588, 386, 627, 40, 231, 776, 203]"
185,13,3624,2372,5922,0,2465,1159,"[364, 250, 311, 142, 344, 125, 125, 23, 40, 159, 86, 137, 20, 0, 276, 230, 347, 86, 161, 112, 201, 365, 200, 266, 164, 130, 252]"
186,13,3837,2505,7254,0,3764,73,"[11, 18, 19, 24, 18, 1, 6, 1, 18, 4, 18, 2, 10, 0, 3, 8, 14, 7, 4, 21, 23, 14, 1, 7, 9, 3, 3]"
187,13,3316,66,10000,504,2773,543,"[99, 56, 180, 122, 106, 42, 128, 26, 165, 163, 32, 71, 132, 0, 38, 30, 78, 45, 27, 64, 34, 94, 60, 93, 38, 130, 85]"
188,13,4181,6009,8172,0,933,3248,"[967, 313, 564, 359, 760, 1081, 133, 851, 105, 440, 874, 315, 1079, 0, 1063, 623, 487, 752, 203, 778, 1018, 1082, 84, 908, 1032, 820, 528]"
189,13,3368,6117,5423,0,2210,1158,"[319, 301, 76, 271, 269, 191, 323, 152, 268, 33, 117, 258, 0, 0, 163, 287, 254, 311, 344, 153, 384, 375, 165, 76, 6, 57, 104]"
190,13,3778,3325,5876,0,262,3516,"[854, 371, 480, 553, 94, 348, 335, 1149, 333, 331, 1159, 774, 676, 0, 244, 559, 256, 969, 299, 833, 926, 914, 916, 1061, 517, 319, 763]"
191,13,3990,2223,7643,0,1897,2093,"[199, 76, 374, 110, 141, 1, 23, 565, 203, 692, 312, 144, 223, 0, 165, 364, 397, 412, 231, 5, 465, 687, 455, 234, 199, 233, 420]"
192,13,3017,1006,9654,0,1370,1647,"[495, 292, 0, 447, 420, 134, 469, 146, 533, 514, 246, 100, 74, 0, 290, 141, 210, 271, 280, 337, 75, 236, 302, 188, 349, 194, 547]"
193,13,4392,5163,8883,0,3241,1151,"[144, 281, 359, 99, 110, 43, 101, 274, 12, 370, 204, 188, 252, 0, 357, 91, 326, 147, 248, 117, 209, 271, 8, 142, 172, 33, 97]"
194,13,4804,5191,8496,0,4192,612,"[182, 109, 195, 96, 92, 39, 49, 36, 165, 126, 66, 13, 138, 0, 80, 89, 39, 110, 23, 128, 127, 185, 130, 133, 109, 111, 200]"
195,13,3168,5955,5709,0,2212,956,"[207, 20, 107, 194, 175, 290, 104, 21, 5, 149, 47, 63, 65, 0, 134, 298, 29, 51, 1, 42, 78, 70, 314, 25, 118, 159, 2]"
196,13,3797,1700,7806,0,2013,1784,"[257, 430, 406, 52, 572, 536, 546, 591, 368, 45, 2, 315, 443, 0, 480, 586, 540, 471, 134, 474, 456, 85, 424, 482, 136, 591, 39]"
197,13,3685,6121,5370,0,254,3431,"[1030, 1015, 652, 1112, 333, 884, 438, 141, 1032, 1112, 202, 181, 797, 0, 419, 663, 513, 596, 558, 436, 41, 94, 663, 746, 246, 983, 916]"
198,13,4609,2648,7331,0,4224,385,"[1, 48, 81, 70, 15, 32, 38, 57, 14, 37, 80, 8, 103, 0, 44, 125, 107, 36, 41, 107, 52, 108, 122, 89, 103, 87, 122]"
199,13,4739,7095,4975,0,2213,2526,"[133, 238, 593, 729, 262, 182, 232, 492, 255, 197, 152, 656, 303, 0, 633, 773, 779, 552, 39, 256, 812, 335, 434, 357, 506, 162, 416]"
200,13,4959,3418,6516,0,4229,730,"[230, 7, 165, 199, 16, 135, 25, 113, 18, 92, 240, 214, 97, 0, 15, 239, 141, 212, 32, 205, 194, 151, 117, 220, 32, 234, 66]"
201,13,3465,1341,8640,0,1827,1638,"[63, 56, 128, 544, 499, 85, 98, 294, 331, 438, 238, 7, 222, 0, 482, 169, 325, 503, 475, 422, 506, 421, 25, 506, 512, 546, 484]"
202,13,4510,7196,5954,0,2024,2486,"[644, 745, 422, 273, 645, 634, 411, 648, 155, 716, 175, 585, 748, 0, 314, 190, 134, 687, 378, 411, 699, 606, 479, 573, 4, 288, 374]"
203,13,3825,2562,7217,0,1494,2331,"[100, 368, 375, 393, 688, 350, 92, 55, 696, 239, 510, 464, 437, 0, 595, 769, 414, 492, 74, 568, 360, 742, 580, 747, 95, 692, 352]"
204,13,3670,2522,8365,0,2635,1035,"[148, 165, 16, 293, 222, 94, 287, 77, 213, 18, 96, 141, 207, 0, 324, 111, 141, 328, 47, 239, 211, 130, 204, 116, 297, 226, 1]"
205,13,3547,5009,6903,0,1755,1792,"[287, 38, 135, 319, 129, 173, 331, 371, 542, 313, 157, 328, 414, 0, 341, 395, 58, 457, 420, 240, 574, 360, 293, 403, 437, 588, 191]"
206,13,4000,2063,8840,0,2221,1779,"[496, 528, 276, 533, 336, 587, 241, 120, 493, 518, 74, 338, 273, 0, 236, 336, 475, 219, 558, 482, 121, 457, 581, 168, 590, 42, 95]"
207,13,3680,5722,6798,0,3095,585,"[177, 53, 129, 5, 6, 188, 10, 157, 160, 54, 173, 15, 132, 0, 10, 79, 148, 195, 165, 173, 138, 55, 60, 126, 37, 149, 65]"
208,13,3907,1262,9443,0,1341,2566,"[422, 542, 12, 622, 362, 451, 183, 826, 162, 182, 296, 360, 656, 0, 823, 561, 623, 240, 409, 656, 194, 88, 25, 192, 582, 86, 243]"
209,13,4717,6566,7594,0,1539,3178,"[955, 716, 850, 974, 629, 760, 975, 371, 908, 98, 112, 988, 239, 0, 713, 358, 309, 66, 884, 930, 282, 223, 757, 1054, 463, 801, 774]"
210,13,3454,5206,5842,0,1475,1979,"[396, 634, 127, 84, 640, 53, 49, 374, 174, 188, 280, 601, 10, 0, 278, 20, 656, 305, 338, 506, 195, 302, 580, 68, 420, 192, 53]"
211,13,4069,2703,7208,0,636,3433,"[1134, 797, 519, 883, 931, 111, 37, 273, 699, 263, 629, 540, 1083, 0, 715, 1086, 217, 449, 640, 801, 316, 933, 494, 227, 1, 176, 682]"
212,13,4171,6496,4883,0,2668,1503,"[301, 458, 22, 387, 315, 398, 57, 485, 216, 5, 440, 135, 54, 0, 283, 70, 102, 209, 113, 13, 440, 246, 240, 225, 382, 397, 179]"
213,13,4220,385,8718,0,1330,2890,"[407, 625, 305, 825, 150, 82, 289, 109, 623, 2, 523, 373, 432, 0, 226, 293, 331, 959, 140, 349, 62, 732, 193, 824, 651, 696, 234]"
214,13,4345,5371,7692,0,2085,2260,"[96, 16, 490, 501, 620, 602, 15, 320, 116, 396, 222, 10, 228, 0, 603, 469, 365, 546, 608, 372, 326, 496, 454, 388, 548, 311, 345]"
215,13,3844,6797,4739,0,950,2894,"[691, 251, 356, 328, 747, 537, 379, 83, 10, 568, 303, 150, 626, 0, 64, 449, 870, 580, 246, 927, 162, 149, 580, 176, 628, 591, 246]"
216,13,4784,717,8806,0,1610,3174,"[689, 211, 398, 915, 436, 513, 751, 320, 257, 418, 110, 363, 935, 0, 934, 294, 640, 619, 691, 1041, 981, 715, 89, 419, 295, 288, 903]"
217,13,4053,5649,7210,0,231,3822,"[525, 566, 1107, 682, 740, 824, 1189, 26, 474, 420, 432, 819, 240, 0, 874, 167, 420, 488, 159, 680, 1220, 372, 958, 259, 1209, 726, 20]"
218,13,4005,7157,4058,0,3455,550,"[162, 169, 152, 69, 166, 129, 77, 182, 6, 28, 130, 1, 114, 0, 125, 113, 86, 11, 119, 7, 170, 151, 75, 19, 25, 105, 86]"
219,13,4652,3810,4900,0,1827,2825,"[326, 876, 885, 126, 524, 394, 692, 883, 457, 346, 74, 93, 846, 0, 219, 412, 213, 155, 250, 392, 844, 499, 315, 226, 153, 684, 466]"
220,13,4246,4131,5015,0,4184,62,"[10, 0, 9, 8, 14, 7, 18, 13, 19, 10, 10, 4, 17, 0, 8, 11, 18, 15, 4, 2, 6, 8, 2, 2, 17, 7, 9]"
221,13,4172,2382,6805,0,274,3898,"[1070, 48, 1295, 1182, 1116, 430, 977, 465, 66, 338, 802, 519, 549, 0, 720, 1208, 980, 39, 420, 737, 837, 671, 378, 836, 304, 94, 1285]"
222,13,3503,1335,8973,0,3452,51,"[3, 15, 12, 9, 3, 9, 9, 7, 8, 3, 16, 8, 12, 0, 17, 11, 16, 8, 10, 5, 9, 11, 0, 15, 11, 4, 16]"
223,13,4532,7286,6219,0,2043,2489,"[611, 350, 702, 516, 402, 210, 317, 545, 327, 38, 503, 606, 250, 0, 132, 519, 276, 739, 353, 157, 583, 241, 268, 819, 28, 826, 829]"
224,13,4793,6168,4844,0,3466,1327,"[258, 184, 397, 8, 116, 50, 129, 243, 2, 69, 291, 4, 298, 0, 148, 130, 439, 51, 426, 218, 228, 262, 54, 285, 431, 123, 276]"
225,13,4045,2166,6723,0,1863,2182,"[693, 329, 25, 465, 66, 634, 683, 536, 379, 165, 89, 274, 422, 0, 108, 68, 676, 179, 344, 55, 318, 21, 650, 414, 181, 536, 482]"
226,13,3122,296,9549,0,715,2407,"[218, 664, 138, 581, 325, 396, 127, 10, 178, 514, 678, 244, 703, 0, 438, 64, 561, 561, 157, 576, 516, 564, 366, 247, 101, 84, 123]"
227,13,4342,5692,8199,0,1566,2776,"[686, 402, 788, 333, 496, 662, 607, 488, 481, 590, 566, 743, 299, 0, 753, 397, 193, 871, 17, 349, 684, 192, 388, 261, 814, 101, 673]"
228,13,3980,7217,4962,0,2403,1577,"[60, 284, 258, 302, 23, 324, 196, 519, 464, 417, 516, 292, 58, 0, 326, 411, 179, 158, 512, 333, 489, 462, 97, 505, 383, 37, 106]"
229,13,3041,1010,6993,0,293,2748,"[293, 292, 845, 748, 740, 2, 199, 257, 281, 631, 870, 124, 1, 0, 783, 178, 623, 543, 737, 752, 853, 182, 855, 379, 32, 139, 895]"
230,13,3692,210,10000,475,2198,1494,"[184, 24, 242, 25, 184, 149, 399, 280, 470, 203, 5, 83, 267, 0, 248, 303, 111, 246, 275, 24, 252, 125, 388, 217, 412, 364, 123]"
231,13,4599,5919,8680,0,864,3735,"[752, 592, 1089, 356, 302, 338, 116, 1235, 458, 455, 1045, 325, 87, 0, 229, 102, 1195, 784, 177, 705, 425, 122, 91, 947, 66, 1092, 212]"
232,13,3871,7094,5457,0,344,3527,"[299, 670, 253, 884, 39, 632, 293, 497, 144, 1046, 911, 282, 827, 0, 1099, 1146, 265, 635, 853, 74, 514, 159, 808, 51, 951, 319, 747]"
233,13,4713,2930,7240,0,4148,565,"[52, 93, 120, 109, 77, 28, 169, 186, 8, 0, 182, 157, 35, 0, 73, 43, 85, 9, 27, 28, 149, 109, 3, 124, 131, 55, 108]"
234,13,4587,6963,4864,0,2079,2508,"[578, 187, 171, 48, 678, 508, 674, 156, 217, 305, 702, 511, 633, 0, 50, 767, 341, 205, 483, 136, 31, 731, 564, 345, 71, 138, 317]"
235,13,3566,2455,5975,0,1529,2037,"[145, 561, 93, 265, 7, 117, 387, 554, 516, 558, 54, 8, 355, 0, 502, 197, 326, 537, 122, 433, 631, 28, 266, 190, 336, 326, 488]"
236,13,4274,724,9525,0,3156,1118,"[138, 330, 201, 329, 68, 324, 289, 372, 163, 244, 163, 302, 43, 0, 328, 149, 243, 5, 95, 259, 314, 199, 252, 131, 247, 68, 291]"
237,13,3941,5240,8226,0,2367,1574,"[511, 151, 400, 495, 3, 288, 138, 315, 288, 328, 368, 346, 194, 0, 316, 33, 485, 74, 289, 221, 286, 190, 356, 378, 364, 81, 447]"
238,13,4052,6101,6177,0,1246,2806,"[296, 202, 589, 915, 229, 126, 74, 210, 45, 12, 74, 178, 140, 0, 555, 48, 301, 338, 288, 471, 247, 895, 778, 460, 825, 106, 777]"
239,13,4804,3652,7329,0,2803,2001,"[431, 474, 511, 373, 23, 123, 30, 489, 346, 483, 507, 202, 646, 0, 552, 55, 240, 126, 416, 359, 217, 169, 289, 237, 322, 542, 133]"
240,13,4094,5607,5816,0,637,3457,"[1057, 98, 1008, 47, 86, 1114, 138, 462, 811, 84, 129, 731, 533, 0, 611, 222, 1146, 746, 713, 456, 1103, 450, 629, 733, 618, 742, 643]"
241,13,4293,870,9239,0,3995,298,"[86, 19, 42, 16, 0, 36, 85, 60, 68, 14, 8, 3, 65, 0, 51, 15, 27, 55, 60, 96, 49, 27, 5, 2, 2, 74, 12]"
242,13,3303,6679,5863,0,89,3214,"[260, 282, 126, 388, 1021, 806, 337, 270, 128, 575, 446, 881, 546, 0, 417, 218, 681, 125, 389, 521, 1014, 904, 1043, 933, 824, 376, 787]"
243,13,4470,2130,8203,0,2543,1927,"[48, 573, 631, 437, 479, 61, 330, 575, 397, 201, 143, 172, 225, 0, 323, 336, 193, 53, 85, 176, 236, 23, 102, 540, 449, 192, 582]"
244,13,4368,5309,7262,0,2350,2018,"[199, 275, 608, 20, 314, 438, 215, 597, 323, 570, 559, 204, 352, 0, 655, 23, 341, 539, 505, 630, 669, 430, 219, 160, 182, 294, 327]"
245,13,4778,7174,4866,0,4223,555,"[62, 153, 50, 53, 13, 79, 53, 2, 13, 168, 6, 28, 113, 0, 128, 160, 143, 94, 89, 118, 183, 44, 165, 108, 180, 173, 157]"
246,13,4531,1786,7611,0,539,3992,"[505, 704, 732, 702, 1086, 1036, 1010, 181, 661, 1257, 910, 337, 908, 0, 241, 424, 67, 1151, 461, 366, 713, 125, 149, 761, 1325, 957, 166]"
247,13,4237,5941,5907,0,3933,304,"[26, 71, 93, 86, 80, 26, 5, 92, 101, 68, 29, 48, 95, 0, 57, 38, 22, 12, 70, 34, 10, 7, 84, 29, 16, 31, 42]"
248,13,3627,2608,6926,0,3015,612,"[178, 33, 170, 196, 153, 82, 102, 59, 134, 76, 165, 204, 118, 0, 67, 17, 47, 64, 117, 194, 54, 24, 151, 106, 111, 153, 114]"
249,13,4377,5752,5551,0,191,4186,"[887, 1103, 1054, 1170, 614, 433, 801, 1078, 466, 179, 1256, 917, 644, 0, 860, 435, 436, 1197, 816, 1372, 694, 1066, 780, 1214, 657, 219, 772]"
250,13,3348,1098,7801,0,2117,1231,"[260, 84, 120, 163, 188, 260, 402, 354, 30, 280, 68, 166, 405, 0, 238, 404, 114, 148, 17, 219, 190, 139, 8, 196, 175, 326, 397]"
251,13,3262,5199,5864,0,988,2274,"[433, 394, 343, 68, 406, 544, 660, 430, 669, 464, 639, 506, 124, 0, 640, 73, 743, 71, 639, 166, 118, 326, 296, 596, 199, 629, 449]"
252,13,3861,2975,6750,0,2338,1523,"[340, 216, 318, 176, 406, 461, 492, 268, 308, 252, 483, 384, 325, 0, 309, 500, 57, 386, 430, 421, 124, 416, 149, 251, 262, 343, 188]"
253,13,4403,5227,5926,0,369,4034,"[656, 297, 733, 680, 323, 1049, 780, 1019, 1014, 726, 790, 486, 805, 0, 269, 594, 1138, 923, 1058, 1316, 1062, 996, 747, 866, 229, 183, 54]"
254,13,3285,188,9023,0,2352,933,"[97, 190, 130, 181, 184, 0, 36, 247, 309, 186, 105, 143, 159, 0, 24, 98, 58, 183, 21, 16, 119, 221, 121, 74, 266, 27, 291]"
255,13,3333,7462,4894,0,2683,650,"[214, 68, 142, 7, 50, 107, 67, 155, 166, 43, 6, 51, 152, 0, 168, 87, 209, 89, 90, 195, 9, 133, 3, 64, 213, 44, 159]"
256,13,3779,1194,7479,0,424,3355,"[37, 528, 899, 837, 488, 308, 103, 683, 738, 1052, 514, 227, 635, 0, 537, 985, 533, 898, 171, 1099, 881, 94, 337, 211, 16, 374, 925]"
257,13,3478,2590,8367,0,2624,854,"[170, 250, 240, 72, 55, 27, 274, 217, 283, 51, 148, 142, 1, 0, 207, 193, 61, 270, 279, 138, 19, 111, 269, 225, 31, 271, 204]"
258,13,3125,6085,5407,0,1860,1265,"[173, 100, 46, 411, 364, 196, 55, 367, 154, 329, 406, 237, 155, 0, 164, 213, 80, 34, 137, 128, 174, 217, 116, 321, 98, 268, 375]"
259,13,3634,2901,6140,0,25,3609,"[552, 386, 622, 265, 266, 477, 972, 363, 256, 1161, 1070, 97, 186, 0, 1059, 43, 193, 983, 209, 66, 69, 879, 319, 1149, 263, 514, 890]"
260,13,4909,5975,5074,0,2292,2617,"[193, 109, 335, 319, 742, 801, 465, 698, 604, 332, 816, 135, 310, 0, 595, 389, 331, 839, 611, 12, 347, 676, 151, 175, 191, 576, 560]"
261,13,3974,954,8094,0,741,3233,"[28, 62, 319, 1004, 982, 663, 146, 156, 836, 430, 948, 584, 559, 0, 90, 923, 809, 593, 424, 892, 805, 984, 797, 854, 99, 448, 159]"
262,13,4770,5945,6919,0,3720,1050,"[88, 313, 318, 293, 79, 281, 156, 41, 160, 58, 127, 174, 157, 0, 235, 300, 156, 211, 4, 188, 50, 256, 142, 74, 91, 223, 173]"
263,13,4965,5692,6192,0,22,4943,"[1522, 859, 1458, 237, 436, 770, 1226, 445, 582, 1330, 1114, 1640, 436, 0, 252, 214, 92, 797, 231, 1030, 436, 1323, 976, 32, 841, 611, 1561]"
264,13,4822,6477,4537,0,3415,1407,"[327, 211, 159, 291, 287, 204, 295, 25, 277, 247, 75, 371, 445, 0, 376, 386, 191, 8, 445, 166, 276, 429, 149, 329, 140, 118, 168]"
265,13,4513,1625,7425,0,1250,3263,"[1033, 55, 788, 624, 1049, 111, 728, 64, 477, 261, 552, 102, 995, 0, 541, 846, 764, 1022, 307, 50, 876, 874, 230, 649, 898, 1052, 1027]"
266,13,4387,6974,4838,0,1216,3171,"[329, 1055, 538, 698, 166, 1037, 336, 496, 910, 656, 447, 580, 199, 0, 303, 775, 151, 142, 525, 762, 673, 913, 720, 561, 671, 1040, 942]"
267,13,3665,1878,6625,0,323,3342,"[25, 407, 109, 849, 1068, 897, 383, 457, 869, 356, 741, 427, 1009, 0, 724, 548, 258, 438, 1078, 370, 1099, 211, 278, 1029, 177, 14, 482]"
268,13,3766,1409,8982,0,2228,1538,"[157, 162, 11, 502, 233, 206, 402, 335, 174, 60, 320, 326, 155, 0, 413, 65, 229, 408, 169, 380, 358, 142, 321, 47, 335, 145, 74]"
269,13,4201,6895,6288,0,1261,2940,"[787, 198, 314, 573, 251, 319, 157, 394, 929, 978, 209, 768, 338, 0, 776, 281, 423, 72, 793, 229, 504, 100, 682, 334, 509, 591, 942]"
270,13,4522,4267,6543,0,3696,826,"[0, 232, 5, 123, 182, 55, 244, 117, 128, 79, 127, 151, 159, 0, 214, 144, 44, 91, 198, 172, 44, 77, 50, 139, 255, 38, 185]"
271,13,3102,1078,8567,0,2344,758,"[180, 184, 18, 159, 99, 125, 144, 19, 99, 94, 97, 28, 82, 0, 178, 182, 53, 67, 24, 186, 177, 141, 177, 152, 26, 179, 14]"
272,13,4310,6682,6195,0,2318,1992,"[559, 168, 126, 380, 483, 410, 309, 158, 245, 496, 112, 302, 251, 0, 528, 389, 631, 101, 632, 480, 90, 153, 52, 72, 422, 156, 322]"
273,13,4625,1295,9525,0,1603,3022,"[47, 737, 854, 1000, 445, 295, 492, 984, 630, 688, 744, 270, 886, 0, 230, 571, 860, 918, 302, 316, 461, 604, 692, 795, 921, 508, 989]"
274,13,3779,6722,6582,0,2885,894,"[108, 69, 226, 34, 228, 251, 5, 26, 297, 173, 148, 84, 108, 0, 98, 216, 146, 151, 139, 287, 253, 200, 256, 177, 249, 23, 161]"
275,13,4654,6915,4321,0,1541,3113,"[936, 27, 600, 648, 518, 988, 426, 1014, 305, 366, 644, 550, 755, 0, 493, 644, 747, 968, 598, 872, 326, 95, 935, 244, 93, 581, 782]"
276,13,4375,2967,5729,0,2074,2301,"[303, 50, 625, 19, 525, 695, 699, 434, 515, 442, 334, 353, 140, 0, 79, 49, 619, 379, 236, 520, 505, 636, 263, 761, 622, 562, 195]"
277,13,4977,3983,6723,0,4302,675,"[191, 149, 150, 139, 116, 52, 167, 22, 225, 39, 36, 25, 69, 0, 7, 14, 5, 94, 191, 98, 153, 172, 168, 82, 125, 74, 0]"
278,13,4123,185,10000,661,2424,1699,"[436, 173, 538, 29, 262, 188, 254, 453, 358, 145, 248, 99, 509, 0, 221, 115, 97, 521, 514, 54, 282, 65, 27, 30, 431, 233, 197]"
279,13,3775,6549,7226,0,782,2993,"[867, 967, 635, 800, 66, 232, 356, 641, 850, 603, 249, 477, 94, 0, 792, 493, 193, 437, 48, 369, 987, 673, 252, 397, 984, 104, 314]"
280,13,3465,2888,7803,0,3289,176,"[9, 36, 12, 55, 29, 12, 27, 3, 23, 46, 39, 23, 40, 0, 18, 12, 16, 44, 26, 45, 32, 11, 8, 10, 5, 32, 18]"
281,13,3483,7158,4128,0,1068,2415,"[449, 151, 133, 79, 155, 362, 552, 153, 369, 297, 164, 249, 178, 0, 52, 582, 20, 331, 308, 414, 378, 125, 781, 391, 390, 579, 326]"
282,13,4012,3311,4829,0,1909,2103,"[504, 144, 694, 228, 580, 388, 32, 41, 310, 365, 670, 292, 445, 0, 566, 516, 209, 532, 245, 431, 391, 457, 294, 25, 264, 173, 203]"
283,13,4426,3495,5760,0,2877,1549,"[370, 249, 476, 285, 274, 302, 308, 23, 141, 246, 372, 232, 489, 0, 188, 128, 261, 93, 229, 262, 329, 332, 201, 352, 290, 445, 122]"
284,13,4100,2915,6945,0,1404,2696,"[796, 365, 410, 355, 629, 679, 287, 590, 104, 501, 474, 594, 348, 0, 69, 689, 480, 712, 102, 663, 435, 232, 495, 322, 275, 801, 229]"
285,13,4950,6241,5654,0,3667,1283,"[151, 345, 28, 37, 152, 272, 115, 248, 274, 160, 365, 21, 305, 0, 292, 195, 402, 389, 119, 125, 339, 17, 427, 166, 264, 347, 260]"
286,13,3319,2257,6716,0,1861,1458,"[475, 350, 51, 166, 168, 70, 189, 282, 245, 245, 275, 273, 155, 0, 96, 22, 329, 289, 327, 291, 472, 167, 324, 394, 447, 202, 410]"
287,13,3212,1368,8560,0,3034,178,"[48, 7, 30, 51, 38, 58, 18, 52, 9, 48, 46, 43, 57, 0, 45, 53, 4, 34, 42, 41, 45, 57, 29, 46, 23, 50, 55]"
288,13,4834,6319,7075,0,3106,1728,"[411, 521, 206, 74, 385, 26, 487, 353, 509, 413, 223, 319, 496, 0, 24, 333, 74, 292, 470, 264, 142, 264, 443, 359, 323, 345, 85]"
289,13,4572,7279,4368,0,1326,3246,"[1064, 249, 14, 188, 570, 728, 282, 896, 4, 214, 565, 93, 619, 0, 617, 953, 1020, 323, 500, 58, 588, 418, 268, 299, 926, 201, 792]"
290,13,3163,258,7273,0,1116,2047,"[126, 570, 302, 78, 588, 323, 546, 225, 23, 542, 223, 268, 48, 0, 260, 114, 189, 631, 232, 171, 223, 681, 180, 257, 61, 261, 358]"
291,13,3017,1791,8499,0,2029,988,"[318, 251, 125, 155, 156, 240, 73, 71, 74, 62, 133, 77, 264, 0, 98, 64, 66, 294, 219, 41, 217, 181, 36, 276, 213, 222, 42]"
292,13,4039,6623,5915,0,1644,2395,"[561, 745, 391, 732, 145, 206, 24, 551, 485, 480, 307, 581, 430, 0, 569, 10, 300, 207, 755, 224, 510, 712, 783, 392, 735, 278, 728]"
293,13,4864,2582,8197,0,2775,2089,"[618, 676, 315, 232, 66, 392, 79, 63, 31, 181, 100, 120, 493, 0, 540, 618, 453, 583, 559, 289, 248, 26, 409, 54, 688, 135, 589]"
294,13,4147,7068,5276,0,3990,157,"[46, 0, 31, 43, 13, 24, 12, 10, 4, 23, 46, 47, 0, 0, 2, 13, 37, 8, 29, 40, 28, 24, 18, 5, 12, 18, 50]"
295,13,3266,259,8283,0,748,2518,"[826, 484, 16, 19, 210, 159, 763, 522, 655, 41, 257, 606, 366, 0, 337, 676, 573, 332, 738, 324, 588, 305, 781, 442, 370, 330, 601]"
296,13,3046,5747,5582,0,1519,1527,"[365, 35, 455, 478, 315, 394, 219, 29, 402, 108, 267, 423, 34, 0, 508, 65, 71, 330, 363, 454, 394, 85, 236, 19, 506, 157, 377]"
297,13,3709,2376,6915,0,933,2776,"[40, 66, 729, 753, 283, 26, 769, 849, 759, 785, 130, 5, 171, 0, 440, 801, 255, 85, 892, 102, 347, 533, 145, 411, 415, 271, 665]"
298,13,4298,7441,3772,0,1495,2803,"[120, 909, 460, 167, 456, 51, 329, 877, 10, 869, 173, 813, 890, 0, 667, 928, 28, 528, 143, 164, 105, 514, 795, 73, 519, 699, 361]"
299,13,4630,3882,4520,0,4453,177,"[56, 32, 2, 28, 34, 53, 23, 34, 8, 14, 37, 27, 47, 0, 46, 35, 41, 26, 40, 40, 7, 52, 44, 18, 32, 10, 42]"
0,14,1495,0,1495,0,535,960,"[169, 102, 46, 62, 143, 41, 182, 313, 23, 208, 273, 252, 173, 0, 108, 63, 45, 178, 43, 12, 11, 123, 274, 156, 182, 258, 43]"
1,14,2666,826,3335,0,1324,1342,"[289, 149, 10, 238, 43, 293, 261, 387, 251, 366, 329, 299, 67, 0, 325, 115, 87, 331, 297, 332, 355, 37, 446, 349, 257, 397, 174]"
2,14,1754,125,4964,0,207,1547,"[398, 390, 240, 295, 260, 204, 385, 298, 131, 76, 163, 390, 56, 0, 23, 59, 267, 85, 511, 367, 357, 301, 484, 354, 494, 407, 170]"
3,14,1543,382,6125,0,580,963,"[255, 242, 252, 55, 82, 315, 258, 258, 286, 72, 272, 189, 306, 0, 188, 120, 156, 242, 228, 310, 67, 2, 107, 106, 126, 316, 104]"
4,14,2189,1256,7058,0,1451,738,"[185, 162, 58, 226, 214, 170, 187, 109, 166, 27, 169, 49, 12, 0, 232, 159, 50, 157, 161, 27, 71, 222, 208, 221, 0, 173, 67]"
5,14,1905,1581,7382,0,248,1657,"[430, 43, 6, 403, 145, 524, 92, 327, 439, 133, 317, 394, 482, 0, 288, 518, 413, 57, 274, 441, 320, 30, 181, 0, 9, 339, 410]"
6,14,2600,94,9888,0,1533,1067,"[99, 160, 129, 236, 98, 196, 8, 341, 150, 15, 98, 207, 63, 0, 302, 182, 20, 173, 192, 43, 125, 324, 125, 22, 100, 239, 122]"
7,14,2011,7092,4807,0,98,1913,"[41, 94, 393, 629, 36, 206, 133, 14, 616, 20, 531, 600, 381, 0, 635, 101, 117, 122, 571, 409, 560, 435, 626, 540, 506, 632, 186]"
8,14,2121,107,6821,0,2074,47,"[11, 8, 15, 11, 6, 8, 2, 2, 4, 12, 1, 1, 14, 0, 4, 10, 13, 10, 5, 7, 3, 10, 4, 15, 2, 4, 1]"
9,14,2260,1385,7696,0,404,1856,"[176, 347, 357, 37, 65, 171, 363, 108, 150, 575, 401, 175, 509, 0, 242, 136, 25, 409, 455, 488, 284, 446, 187, 542, 594, 176, 294]"
10,14,2730,380,10000,46,1770,960,"[249, 27, 183, 109, 317, 253, 277, 63, 2, 63, 80, 108, 317, 0, 219, 196, 23, 222, 261, 317, 257, 65, 177, 144, 80, 182, 29]"
11,14,1266,5064,6202,0,444,822,"[149, 110, 166, 20, 200, 164, 97, 90, 208, 263, 187, 181, 171, 0, 236, 221, 145, 250, 249, 246, 101, 246, 60, 251, 179, 33, 95]"
12,14,2849,2606,6445,0,2354,495,"[109, 42, 56, 63, 113, 142, 128, 130, 8, 123, 70, 79, 26, 0, 67, 10, 34, 111, 105, 111, 64, 117, 137, 90, 129, 128, 150]"
13,14,2481,1078,7848,0,1616,865,"[140, 278, 58, 104, 141, 45, 100, 273, 257, 130, 174, 49, 166, 0, 211, 207, 156, 235, 92, 41, 154, 183, 196, 10, 173, 90, 28]"
14,14,2608,2025,8431,0,1751,857,"[150, 279, 29, 177, 201, 157, 243, 99, 270, 186, 131, 1, 65, 0, 219, 46, 269, 175, 182, 136, 176, 194, 196, 59, 149, 13, 108]"
15,14,1435,392,9474,0,1063,372,"[50, 78, 53, 60, 39, 77, 107, 120, 71, 110, 49, 30, 41, 0, 107, 109, 81, 32, 95, 115, 26, 88, 104, 42, 32, 101, 15]"
16,14,1904,7450,3928,0,1253,651,"[141, 127, 16, 198, 137, 125, 210, 78, 79, 175, 34, 183, 198, 0, 73, 78, 111, 20, 67, 69, 115, 126, 143, 63, 90, 84, 121]"
17,14,2186,1654,4460,0,734,1452,"[80, 422, 205, 336, 410, 236, 323, 53, 33, 362, 13, 328, 6, 0, 124, 141, 18, 478, 427, 33, 236, 325, 384, 91, 249, 208, 319]"
18,14,2470,1126,5804,0,1599,871,"[228, 66, 290, 184, 111, 52, 253, 211, 256, 66, 2, 77, 109, 0, 218, 248, 43, 246, 260, 84, 39, 111, 128, 137, 241, 280, 181]"
19,14,1293,777,6320,0,258,1035,"[226, 21, 112, 293, 182, 137, 53, 226, 256, 328, 35, 34, 85, 0, 218, 203, 200, 189, 232, 114, 301, 45, 113, 250, 263, 117, 141]"
20,14,2640,1937,7023,0,1574,1066,"[114, 219, 117, 351, 308, 48, 192, 30, 163, 113, 169, 80, 199, 0, 127, 148, 126, 54, 326, 89, 301, 160, 44, 239, 296, 243, 42]"
21,14,1145,272,7896,0,293,852,"[215, 29, 229, 41, 4, 10, 132, 119, 61, 209, 270, 173, 165, 0, 175, 89, 199, 121, 1, 235, 223, 158, 111, 117, 186, 103, 149]"
22,14,2150,221,9825,0,1038,1112,"[365, 40, 108, 110, 177, 215, 271, 253, 290, 368, 5, 147, 257, 0, 370, 82, 162, 243, 18, 289, 264, 344, 102, 211, 39, 189, 25]"
23,14,1009,271,10000,563,684,325,"[66, 58, 88, 45, 94, 40, 82, 26, 5, 30, 41, 63, 99, 0, 35, 75, 3, 95, 94, 4, 104, 88, 3, 46, 35, 2, 32]"
24,14,2266,7482,4784,0,1817,449,"[29, 113, 61, 80, 105, 86, 30, 24, 19, 104, 17, 144, 3, 0, 32, 3, 82, 83, 134, 74, 71, 0, 118, 71, 11, 70, 121]"
25,14,2091,474,6401,0,535,1556,"[284, 494, 38, 447, 360, 264, 172, 73, 153, 426, 360, 23, 127, 0, 411, 184, 229, 263, 138, 2, 409, 436, 325, 446, 21, 238, 201]"
26,14,1475,267,7609,0,625,850,"[137, 243, 237, 263, 48, 36, 209, 75, 181, 47, 216, 226, 246, 0, 236, 127, 98, 59, 79, 123, 54, 211, 104, 234, 108, 144, 268]"
27,14,1441,650,8400,0,285,1156,"[145, 39, 108, 97, 256, 163, 88, 224, 39, 73, 355, 175, 124, 0, 200, 129, 302, 13, 242, 274, 123, 251, 260, 8, 125, 365, 262]"
28,14,2725,5061,6064,0,1193,1532,"[173, 55, 336, 46, 419, 200, 303, 137, 489, 171, 477, 264, 401, 0, 113, 132, 88, 334, 198, 298, 142, 244, 8, 70, 15, 409, 298]"
29,14,2692,1690,7066,0,2671,21,"[7, 4, 1, 2, 3, 4, 6, 0, 3, 0, 1, 3, 6, 0, 4, 2, 6, 2, 2, 2, 4, 3, 1, 5, 6, 7, 2]"
30,14,2158,128,9096,0,1827,331,"[26, 28, 88, 106, 27, 5, 5, 29, 82, 50, 80, 80, 49, 0, 26, 99, 31, 50, 50, 19, 83, 13, 49, 45, 28, 47, 40]"
31,14,2984,6622,5458,0,1252,1732,"[387, 212, 292, 13, 472, 410, 176, 100, 468, 57, 244, 76, 75, 0, 116, 267, 568, 238, 68, 125, 536, 524, 526, 375, 555, 81, 250]"
32,14,1848,704,6602,0,1814,34,"[8, 11, 7, 1, 3, 7, 1, 0, 0, 9, 8, 2, 9, 0, 5, 3, 7, 2, 6, 1, 1, 2, 5, 6, 1, 8, 10]"
33,14,1639,302,7939,0,1324,315,"[25, 3, 26, 57, 30, 50, 43, 5, 7, 93, 25, 6, 37, 0, 31, 66, 49, 98, 4, 95, 96, 35, 70, 25, 10, 76, 30]"
34,14,1781,160,9560,0,1494,287,"[22, 25, 7, 42, 3, 68, 66, 80, 16, 48, 14, 44, 4, 0, 70, 27, 76, 45, 82, 80, 43, 35, 43, 83, 17, 48, 45]"
35,14,2428,5008,6980,0,2428,0,"[0, 0, 0, 0, 0, 0, 0, 0, 0, 0, 0, 0, 0, 0, 0, 0, 0, 0, 0, 0, 0, 0, 0, 0, 0, 0, 0]"
36,14,2892,1611,8261,0,2704,188,"[11, 27, 3, 61, 45, 19, 17, 55, 12, 18, 1, 37, 23, 0, 9, 6, 31, 2, 37, 35, 27, 60, 29, 43, 28, 33, 15]"
37,14,2024,724,9561,0,674,1350,"[130, 358, 376, 213, 308, 324, 5, 435, 13, 127, 337, 289, 309, 0, 145, 439, 63, 350, 82, 356, 29, 210, 156, 103, 299, 104, 172]"
38,14,1031,104,10000,488,363,668,"[169, 26, 68, 16, 72, 161, 46, 51, 162, 66, 116, 79, 131, 0, 152, 188, 190, 111, 137, 211, 184, 97, 199, 49, 78, 168, 92]"
39,14,2351,7310,5041,0,800,1551,"[30, 204, 34, 343, 130, 445, 79, 254, 64, 329, 236, 195, 237, 0, 157, 279, 88, 219, 413, 415, 128, 341, 435, 294, 506, 397, 212]"
40,14,1200,635,5606,0,406,794,"[97, 14, 235, 1, 263, 189, 193, 195, 110, 100, 241, 73, 196, 0, 146, 84, 241, 121, 64, 27, 7, 126, 4, 18, 17, 119, 113]"
41,14,2612,2450,5768,0,788,1824,"[388, 465, 183, 106, 263, 460, 39, 134, 571, 168, 337, 540, 49, 0, 94, 198, 111, 18, 353, 433, 440, 29, 572, 265, 78, 263, 69]"
42,14,2187,1874,6081,0,1367,820,"[160, 36, 131, 240, 191, 164, 218, 143, 135, 31, 204, 83, 84, 0, 225, 231, 58, 185, 221, 268, 243, 221, 253, 121, 75, 111, 106]"
43,14,1586,1112,6555,0,937,649,"[161, 28, 52, 54, 14, 177, 46, 78, 41, 57, 100, 195, 132, 0, 65, 173, 208, 152, 102, 45, 100, 49, 116, 180, 89, 207, 180]"
44,14,2178,819,7914,0,867,1311,"[390, 75, 105, 138, 344, 196, 339, 18, 377, 206, 328, 84, 73, 0, 411, 298, 29, 361, 379, 357, 207, 390, 62, 111, 16, 263, 403]"
45,14,2960,2196,8678,0,1973,987,"[163, 239, 68, 240, 325, 128, 182, 322, 259, 102, 153, 44, 205, 0, 270, 175, 85, 68, 195, 101, 160, 141, 285, 138, 185, 95, 119]"
46,14,1030,872,8836,0,549,481,"[158, 38, 92, 124, 20, 19, 11, 150, 2, 132, 94, 95, 12, 0, 64, 149, 102, 117, 36, 50, 16, 14, 104, 75, 14, 29, 99]"
47,14,1625,212,10000,249,1355,270,"[61, 0, 54, 61, 61, 33, 88, 79, 47, 24, 51, 54, 36, 0, 76, 70, 79, 82, 11, 16, 0, 64, 86, 66, 8, 39, 41]"
48,14,2075,5092,6983,0,1762,313,"[53, 90, 22, 29, 49, 61, 83, 9, 31, 73, 28, 79, 49, 0, 8, 15, 35, 37, 8, 103, 89, 34, 78, 60, 55, 33, 37]"
49,14,2948,858,9073,0,2773,175,"[44, 32, 58, 33, 1, 51, 4, 44, 19, 12, 20, 27, 10, 0, 30, 41, 48, 26, 12, 42, 25, 52, 12, 23, 41, 43, 13]"
50,14,2989,6708,5354,0,2959,30,"[5, 1, 1, 9, 3, 6, 7, 9, 1, 1, 9, 5, 0, 0, 2, 7, 10, 5, 1, 3, 6, 8, 10, 0, 6, 1, 9]"
51,14,2438,665,7127,0,1687,751,"[119, 61, 122, 119, 165, 20, 144, 28, 69, 171, 234, 105, 230, 0, 194, 179, 76, 49, 57, 178, 121, 110, 92, 198, 11, 200, 108]"
52,14,2042,714,8455,0,912,1130,"[39, 133, 44, 333, 312, 180, 59, 255, 313, 60, 119, 6, 118, 0, 250, 101, 232, 295, 262, 137, 35, 34, 280, 307, 61, 17, 69]"
53,14,1699,1427,8727,0,268,1431,"[32, 11, 116, 28, 295, 77, 459, 168, 72, 457, 306, 226, 119, 0, 55, 322, 119, 447, 33, 315, 125, 13, 380, 249, 275, 289, 266]"
54,14,2991,7483,4235,0,1245,1746,"[497, 384, 306, 167, 380, 263, 241, 21, 329, 544, 186, 393, 462, 0, 275, 257, 218, 251, 47, 566, 476, 535, 140, 307, 71, 247, 3]"
55,14,2460,1147,5548,0,113,2347,"[695, 317, 378, 304, 334, 150, 270, 465, 211, 415, 772, 525, 207, 0, 472, 361, 535, 369, 348, 38, 552, 479, 254, 398, 102, 91, 289]"
56,14,1256,198,6606,0,783,473,"[21, 63, 112, 72, 72, 90, 82, 7, 36, 31, 65, 139, 68, 0, 85, 26, 156, 99, 17, 119, 112, 152, 65, 145, 117, 71, 113]"
57,14,1234,168,7672,0,499,735,"[210, 239, 203, 182, 68, 139, 199, 77, 17, 89, 240, 2, 117, 0, 134, 47, 82, 187, 83, 196, 14, 201, 158, 228, 165, 49, 173]"
58,14,1635,1005,8302,0,655,980,"[321, 244, 60, 241, 207, 295, 65, 138, 231, 281, 278, 227, 299, 0, 34, 268, 266, 310, 265, 100, 208, 190, 258, 24, 192, 165, 279]"
59,14,2370,1983,8689,0,24,2346,"[651, 703, 89, 330, 232, 15, 657, 6, 192, 34, 385, 409, 200, 0, 562, 424, 97, 501, 727, 191, 113, 712, 468, 41, 358, 18, 483]"
60,14,1679,117,10000,251,750,929,"[168, 78, 199, 226, 211, 236, 95, 296, 82, 44, 84, 285, 157, 0, 242, 266, 52, 193, 146, 232, 148, 100, 221, 54, 7, 287, 177]"
61,14,1583,5718,5865,0,815,768,"[31, 106, 162, 154, 82, 243, 41, 19, 169, 146, 148, 103, 193, 0, 42, 39, 92, 123, 163, 186, 254, 220, 70, 248, 21, 157, 120]"
62,14,2974,1882,6957,0,1960,1014,"[137, 214, 180, 283, 191, 137, 333, 8, 25, 99, 163, 334, 159, 0, 297, 167, 89, 117, 224, 166, 249, 197, 111, 136, 145, 19, 234]"
63,14,1928,1017,7868,0,1125,803,"[64, 131, 62, 152, 114, 63, 170, 58, 41, 233, 16, 57, 250, 0, 98, 41, 31, 2, 84, 183, 231, 16, 92, 191, 56, 135, 101]"
64,14,2786,1547,9107,0,1011,1775,"[567, 285, 584, 204, 243, 16, 289, 409, 215, 6, 444, 4, 192, 0, 54, 167, 202, 532, 71, 378, 429, 234, 226, 332, 315, 151, 588]"
65,14,1158,26,10000,239,1016,142,"[6, 28, 3, 38, 11, 47, 3, 7, 28, 21, 37, 32, 33, 0, 26, 21, 33, 28, 32, 44, 18, 44, 15, 8, 33, 46, 6]"
66,14,1054,6496,4558,0,370,684,"[71, 160, 16, 224, 174, 193, 216, 85, 214, 184, 64, 53, 48, 0, 181, 18, 96, 143, 114, 17, 80, 185, 37, 71, 148, 161, 187]"
67,14,1742,1587,4713,0,695,1047,"[156, 159, 34, 68, 246, 226, 43, 275, 207, 93, 167, 147, 231, 0, 320, 267, 316, 69, 333, 292, 131, 40, 331, 197, 297, 343, 153]"
68,14,1958,1421,5250,0,191,1767,"[387, 556, 241, 283, 29, 477, 439, 208, 317, 330, 81, 63, 292, 0, 447, 278, 45, 545, 323, 252, 247, 120, 569, 349, 563, 382, 517]"
69,14,1730,116,6864,0,1146,584,"[74, 81, 103, 85, 68, 60, 147, 191, 184, 81, 103, 17, 67, 0, 74, 43, 112, 43, 133, 91, 105, 92, 75, 133, 104, 157, 92]"
70,14,1700,1126,7438,0,863,837,"[113, 180, 128, 203, 32, 28, 98, 65, 140, 120, 36, 36, 262, 0, 58, 79, 89, 190, 87, 41, 187, 183, 46, 90, 75, 212, 107]"
71,14,1933,642,8729,0,547,1386,"[181, 393, 460, 292, 381, 149, 294, 143, 245, 221, 172, 423, 203, 0, 126, 285, 79, 419, 81, 23, 329, 22, 377, 336, 203, 412, 24]"
72,14,2524,6978,4275,0,1124,1400,"[92, 243, 314, 218, 337, 214, 357, 247, 359, 141, 163, 422, 61, 0, 36, 37, 268, 414, 400, 256, 339, 221, 410, 45, 424, 92, 347]"
73,14,1506,875,4906,0,346,1160,"[307, 340, 301, 72, 120, 182, 2, 366, 254, 213, 233, 383, 237, 0, 177, 354, 147, 379, 256, 323, 224, 132, 335, 240, 212, 247, 149]"
74,14,1337,681,5562,0,923,414,"[53, 41, 52, 45, 94, 119, 100, 82, 123, 38, 125, 110, 135, 0, 58, 87, 87, 134, 104, 126, 92, 67, 113, 17, 111, 100, 112]"
75,14,1893,355,7100,0,873,1020,"[24, 330, 189, 132, 271, 206, 301, 160, 156, 131, 287, 137, 80, 0, 14, 315, 51, 292, 148, 78, 184, 122, 227, 199, 271, 205, 104]"
76,14,1022,727,7395,0,395,627,"[106, 65, 96, 143, 160, 8, 129, 162, 182, 149, 54, 96, 47, 0, 108, 57, 160, 148, 16, 135, 14, 43, 10, 52, 31, 205, 103]"
77,14,1367,470,8292,0,636,731,"[102, 189, 116, 148, 114, 60, 115, 98, 122, 18, 52, 24, 147, 0, 175, 168, 40, 186, 197, 120, 191, 206, 24, 233, 83, 42, 234]"
78,14,1110,899,8503,0,936,174,"[57, 49, 9, 55, 32, 2, 25, 7, 23, 42, 41, 7, 56, 0, 39, 48, 35, 0, 29, 57, 13, 41, 51, 0, 52, 23, 46]"
79,14,2872,5492,5883,0,2425,447,"[64, 5, 129, 16, 23, 11, 37, 53, 90, 121, 57, 64, 53, 0, 92, 67, 36, 72, 14, 75, 76, 71, 41, 34, 73, 22, 140]"
80,14,2449,295,8037,0,1496,953,"[158, 136, 74, 219, 227, 200, 296, 15, 181, 315, 67, 305, 84, 0, 298, 90, 289, 241, 281, 164, 302, 302, 60, 172, 205, 132, 38]"
81,14,1457,1264,8230,0,741,716,"[186, 155, 63, 188, 65, 93, 82, 109, 124, 121, 143, 21, 4, 0, 110, 59, 46, 96, 3, 25, 78, 205, 82, 54, 60, 68, 154]"
82,14,1227,1032,8425,0,701,526,"[95, 170, 69, 127, 44, 107, 90, 71, 147, 156, 120, 86, 114, 0, 163, 29, 137, 87, 136, 115, 32, 61, 64, 20, 72, 48, 40]"
83,14,2359,1004,9780,0,1722,637,"[178, 105, 42, 154, 89, 95, 178, 195, 64, 164, 62, 37, 95, 0, 107, 42, 182, 146, 146, 60, 89, 125, 149, 134, 18, 4, 129]"
84,14,1163,974,9969,0,146,1017,"[310, 21, 80, 323, 258, 137, 108, 65, 50, 314, 0, 93, 251, 0, 265, 181, 305, 177, 114, 107, 127, 228, 167, 0, 71, 328, 107]"
85,14,1514,5755,5728,0,601,913,"[172, 21, 154, 251, 104, 293, 131, 113, 297, 58, 100, 100, 11, 0, 74, 145, 101, 221, 241, 181, 85, 98, 244, 83, 162, 153, 201]"
86,14,2590,2370,5948,0,2378,212,"[9, 18, 34, 60, 15, 2, 11, 44, 30, 62, 52, 36, 16, 0, 43, 59, 20, 46, 49, 46, 33, 68, 7, 2, 13, 63, 61]"
87,14,2717,1764,6901,0,803,1914,"[179, 82, 264, 278, 74, 105, 188, 218, 595, 117, 532, 508, 155, 0, 596, 6, 4, 460, 397, 351, 355, 384, 116, 411, 283, 434, 98]"
88,14,2534,1722,7713,0,828,1706,"[379, 389, 389, 79, 427, 308, 452, 0, 353, 168, 174, 403, 47, 0, 119, 387, 314, 92, 441, 164, 389, 137, 346, 400, 85, 11, 294]"
89,14,2375,1520,8568,0,1488,887,"[213, 170, 57, 263, 51, 149, 240, 187, 145, 4, 243, 281, 162, 0, 25, 234, 213, 3, 125, 162, 192, 12, 125, 77, 117, 103, 122]"
90,14,2629,6715,4482,0,487,2142,"[289, 534, 31, 404, 98, 561, 186, 482, 533, 102, 651, 595, 572, 0, 270, 498, 539, 646, 549, 423, 496, 679, 226, 629, 503, 250, 713]"
91,14,2313,1862,4933,0,946,1367,"[448, 225, 206, 169, 451, 0, 228, 227, 399, 353, 291, 68, 366, 0, 67, 405, 174, 217, 289, 421, 402, 187, 442, 181, 378, 266, 63]"
92,14,1238,109,6062,0,1082,156,"[19, 37, 0, 45, 49, 33, 34, 23, 51, 39, 20, 45, 36, 0, 49, 46, 27, 23, 33, 41, 20, 36, 12, 29, 10, 10, 29]"
93,14,1521,1377,6206,0,607,914,"[3, 197, 28, 125, 10, 152, 197, 40, 261, 114, 44, 201, 98, 0, 120, 82, 271, 254, 268, 207, 26, 269, 257, 182, 139, 136, 103]"
94,14,2369,1984,6591,0,1892,477,"[112, 112, 53, 118, 148, 124, 16, 98, 64, 67, 137, 62, 139, 0, 93, 91, 79, 148, 29, 46, 106, 73, 15, 151, 71, 120, 69]"
95,14,1002,869,6724,0,722,280,"[85, 82, 2, 20, 71, 36, 16, 14, 30, 77, 35, 80, 68, 0, 29, 7, 4, 24, 75, 3, 41, 28, 28, 12, 57, 49, 88]"
96,14,2418,803,8339,0,1893,525,"[0, 43, 125, 166, 6, 31, 63, 168, 18, 151, 73, 147, 46, 0, 172, 46, 81, 137, 52, 20, 160, 54, 153, 85, 32, 52, 42]"
97,14,2333,2116,8556,0,133,2200,"[515, 89, 328, 474, 476, 355, 341, 86, 632, 529, 394, 175, 87, 0, 46, 265, 487, 559, 353, 607, 94, 658, 391, 144, 608, 395, 129]"
98,14,1056,83,9529,0,65,991,"[219, 70, 73, 213, 171, 43, 245, 268, 1, 29, 304, 114, 80, 0, 102, 253, 328, 67, 79, 110, 247, 290, 279, 141, 239, 153, 227]"
99,14,2115,6375,5269,0,1141,974,"[127, 33, 139, 276, 242, 274, 204, 24, 283, 23, 176, 188, 92, 0, 165, 266, 286, 103, 289, 152, 174, 312, 220, 322, 202, 307, 51]"
100,14,2446,458,7257,0,1193,1253,"[131, 21, 295, 417, 77, 416, 248, 58, 366, 367, 133, 176, 126, 0, 31, 259, 347, 102, 42, 258, 236, 17, 146, 353, 346, 109, 382]"
101,14,1558,515,8300,0,152,1406,"[361, 136, 385, 79, 252, 147, 437, 250, 457, 207, 411, 367, 460, 0, 150, 345, 400, 330, 75, 115, 95, 388, 124, 275, 157, 373, 294]"
102,14,2408,1850,8858,0,2272,136,"[3, 8, 25, 1, 44, 34, 28, 19, 9, 40, 30, 32, 15, 0, 15, 20, 42, 32, 12, 33, 10, 14, 5, 20, 10, 29, 35]"
103,14,1842,1570,9130,0,507,1335,"[150, 433, 199, 336, 296, 241, 305, 35, 367, 335, 351, 398, 227, 0, 221, 406, 190, 43, 35, 380, 390, 36, 248, 159, 221, 281, 305]"
104,14,1418,936,9612,0,1362,56,"[8, 17, 12, 6, 7, 12, 4, 6, 15, 13, 15, 2, 12, 0, 0, 1, 8, 8, 8, 8, 18, 14, 8, 17, 4, 13, 18]"
105,14,2308,6103,5817,0,1742,566,"[185, 119, 46, 144, 17, 40, 39, 188, 171, 186, 14, 26, 16, 0, 89, 28, 19, 96, 177, 113, 76, 188, 32, 52, 163, 43, 179]"
106,14,2826,413,8230,0,1052,1774,"[38, 130, 562, 99, 313, 509, 413, 361, 336, 246, 210, 375, 326, 0, 119, 434, 21, 37, 305, 569, 449, 584, 246, 290, 207, 116, 576]"
107,14,1921,1702,8449,0,626,1295,"[355, 279, 264, 239, 342, 269, 155, 21, 161, 267, 284, 98, 279, 0, 256, 385, 270, 312, 296, 174, 127, 190, 404, 300, 106, 313, 356]"
108,14,2450,851,10000,48,1881,569,"[145, 88, 82, 115, 4, 80, 175, 179, 87, 14, 165, 45, 64, 0, 152, 97, 143, 23, 135, 17, 47, 89, 48, 60, 100, 39, 57]"
109,14,1681,5898,5783,0,1041,640,"[183, 168, 23, 5, 97, 31, 143, 179, 201, 40, 77, 29, 47, 0, 77, 111, 165, 37, 38, 129, 179, 55, 183, 189, 54, 43, 41]"
110,14,2408,1664,6527,0,912,1496,"[133, 294, 28, 96, 41, 102, 177, 498, 389, 149, 106, 236, 255, 0, 105, 199, 211, 373, 99, 354, 408, 177, 263, 306, 130, 147, 224]"
111,14,1928,286,8169,0,335,1593,"[341, 373, 110, 331, 498, 287, 127, 33, 222, 205, 76, 29, 415, 0, 122, 354, 193, 233, 516, 274, 505, 308, 79, 170, 109, 82, 164]"
112,14,1234,855,8548,0,1029,205,"[61, 4, 9, 28, 17, 11, 7, 1, 11, 43, 32, 66, 16, 0, 30, 16, 68, 32, 3, 4, 25, 67, 59, 38, 67, 11, 48]"
113,14,2324,1223,9649,0,1114,1210,"[207, 208, 339, 325, 101, 319, 276, 245, 369, 328, 397, 280, 359, 0, 11, 229, 233, 261, 69, 55, 372, 8, 121, 7, 62, 229, 373]"
114,14,1418,5977,5090,0,1068,350,"[66, 29, 104, 51, 32, 15, 31, 57, 94, 66, 67, 54, 78, 0, 74, 101, 87, 82, 0, 113, 44, 42, 77, 56, 21, 102, 57]"
115,14,2492,1113,6469,0,1095,1397,"[216, 65, 273, 396, 440, 0, 399, 78, 265, 177, 404, 317, 351, 0, 169, 161, 252, 42, 134, 267, 267, 62, 347, 2, 204, 462, 39]"
116,14,1465,600,7334,0,1040,425,"[38, 6, 92, 2, 107, 103, 14, 86, 62, 78, 66, 27, 22, 0, 79, 135, 27, 93, 13, 99, 82, 112, 24, 0, 1, 98, 55]"
117,14,1962,765,8531,0,868,1094,"[59, 194, 226, 92, 54, 24, 18, 302, 11, 200, 84, 132, 3, 0, 353, 121, 129, 46, 253, 258, 158, 55, 330, 244, 257, 8, 272]"
118,14,2117,1326,9322,0,143,1974,"[557, 517, 625, 352, 79, 443, 509, 269, 475, 225, 394, 279, 248, 0, 21, 656, 653, 490, 346, 625, 639, 475, 175, 401, 147, 447, 213]"
119,14,1908,5858,5372,0,1403,505,"[109, 128, 11, 27, 107, 92, 46, 104, 84, 120, 21, 127, 2, 0, 103, 78, 3, 90, 91, 9, 58, 115, 122, 109, 55, 74, 58]"
120,14,1876,1476,5772,0,791,1085,"[187, 317, 68, 169, 226, 156, 187, 48, 265, 82, 48, 295, 55, 0, 5, 37, 25, 243, 339, 230, 355, 178, 176, 357, 276, 112, 58]"
121,14,1885,15,7642,0,858,1027,"[105, 277, 84, 197, 92, 30, 58, 16, 170, 221, 199, 182, 235, 0, 163, 69, 247, 99, 147, 261, 285, 129, 189, 157, 22, 40, 274]"
122,14,2994,1848,8788,0,1218,1776,"[153, 99, 566, 579, 322, 538, 418, 51, 190, 375, 228, 338, 257, 0, 404, 368, 40, 480, 198, 498, 333, 584, 235, 4, 184, 239, 344]"
123,14,2484,6879,4393,0,91,2393,"[744, 52, 278, 52, 156, 356, 343, 168, 718, 572, 10, 410, 492, 0, 452, 232, 683, 519, 592, 401, 150, 396, 379, 340, 192, 514, 415]"
124,14,2933,1623,5703,0,2189,744,"[101, 247, 244, 42, 82, 2, 193, 123, 150, 25, 97, 218, 138, 0, 108, 35, 235, 220, 146, 180, 28, 246, 73, 38, 102, 184, 238]"
125,14,2076,1598,6181,0,894,1182,"[216, 5, 293, 254, 74, 327, 160, 280, 290, 57, 312, 138, 100, 0, 52, 149, 325, 100, 354, 35, 166, 45, 21, 219, 241, 9, 45]"
126,14,2389,1570,7000,0,1276,1113,"[362, 324, 21, 73, 4, 345, 219, 144, 267, 254, 229, 140, 125, 0, 291, 296, 194, 116, 154, 281, 181, 362, 257, 353, 285, 103, 192]"
127,14,2707,506,9201,0,1071,1636,"[148, 341, 453, 287, 489, 330, 153, 148, 251, 15, 425, 472, 93, 0, 539, 103, 274, 264, 359, 458, 308, 287, 100, 524, 293, 184, 270]"
128,14,1083,519,9765,0,206,877,"[13, 137, 96, 42, 145, 283, 8, 250, 102, 119, 118, 213, 244, 0, 242, 204, 238, 12, 178, 17, 64, 186, 99, 191, 123, 224, 107]"
129,14,2285,6405,5645,0,989,1296,"[226, 16, 131, 203, 77, 259, 215, 397, 170, 160, 330, 89, 170, 0, 217, 24, 43, 370, 205, 64, 313, 352, 44, 398, 214, 244, 88]"
130,14,2805,2308,6142,0,2397,408,"[17, 57, 97, 41, 54, 38, 128, 29, 124, 17, 124, 35, 75, 0, 57, 119, 97, 118, 118, 14, 95, 14, 103, 80, 102, 54, 122]"
131,14,1744,1568,6318,0,1526,218,"[8, 9, 5, 62, 12, 19, 71, 11, 28, 7, 17, 26, 34, 0, 30, 39, 64, 43, 50, 23, 20, 8, 37, 69, 63, 16, 5]"
132,14,1126,996,6448,0,891,235,"[70, 57, 53, 38, 32, 27, 10, 9, 24, 65, 72, 60, 12, 0, 5, 44, 49, 45, 78, 61, 35, 51, 15, 45, 78, 45, 73]"
133,14,1875,1316,7007,0,1064,811,"[91, 101, 98, 64, 182, 109, 141, 113, 115, 155, 9, 92, 260, 0, 204, 267, 210, 144, 11, 244, 129, 6, 105, 246, 2, 170, 266]"
134,14,2687,2274,7420,0,625,2062,"[85, 9, 242, 85, 180, 366, 567, 397, 199, 385, 91, 67, 157, 0, 516, 52, 298, 304, 170, 261, 228, 670, 527, 36, 527, 416, 26]"
135,14,2364,781,9003,0,1437,927,"[251, 28, 100, 187, 295, 218, 64, 273, 160, 59, 154, 86, 1, 0, 130, 53, 273, 303, 174, 78, 146, 41, 38, 177, 43, 123, 84]"
136,14,1380,934,9449,0,10,1370,"[260, 428, 437, 391, 283, 100, 63, 166, 309, 157, 128, 301, 215, 0, 369, 420, 268, 334, 139, 7, 62, 300, 254, 23, 390, 326, 122]"
137,14,1559,7032,3976,0,463,1096,"[314, 326, 321, 184, 279, 166, 204, 26, 29, 53, 86, 4, 47, 0, 18, 163, 182, 197, 274, 206, 166, 339, 208, 265, 5, 249, 247]"
138,14,2946,1242,5680,0,1736,1210,"[117, 71, 238, 362, 205, 259, 149, 28, 130, 206, 126, 205, 76, 0, 297, 50, 70, 393, 258, 300, 328, 43, 256, 204, 73, 28, 92]"
139,14,2366,963,7083,0,1248,1118,"[245, 345, 364, 227, 211, 82, 20, 45, 245, 253, 217, 245, 370, 0, 43, 101, 369, 372, 103, 162, 296, 116, 143, 156, 16, 273, 277]"
140,14,1066,1030,7119,0,114,952,"[301, 51, 242, 165, 105, 36, 238, 55, 226, 70, 57, 20, 70, 0, 134, 80, 87, 47, 133, 150, 200, 244, 187, 8, 91, 98, 49]"
141,14,1375,420,8074,0,666,709,"[144, 69, 59, 178, 115, 182, 190, 96, 105, 194, 61, 185, 114, 0, 17, 182, 73, 32, 94, 64, 222, 46, 107, 68, 54, 65, 71]"
142,14,2677,1740,9011,0,2293,384,"[93, 125, 70, 108, 122, 33, 102, 95, 39, 57, 27, 43, 126, 0, 126, 122, 74, 32, 64, 13, 70, 1, 120, 56, 24, 100, 86]"
143,14,2601,7323,4289,0,633,1968,"[62, 367, 653, 506, 37, 152, 493, 159, 220, 177, 454, 345, 466, 0, 124, 467, 327, 377, 171, 394, 332, 249, 399, 474, 277, 403, 485]"
144,14,1609,1260,4638,0,839,770,"[58, 85, 42, 82, 235, 221, 164, 49, 33, 248, 113, 101, 236, 0, 89, 37, 202, 173, 40, 160, 14, 234, 172, 13, 215, 31, 127]"
145,14,1323,1239,4722,0,689,634,"[118, 209, 119, 60, 95, 152, 35, 167, 103, 167, 74, 170, 56, 0, 160, 59, 150, 62, 142, 134, 194, 201, 148, 134, 101, 158, 80]"
146,14,1427,1073,5076,0,1141,286,"[19, 84, 31, 50, 5, 19, 56, 52, 83, 57, 27, 83, 50, 0, 47, 52, 58, 14, 65, 52, 26, 77, 19, 46, 46, 45, 95]"
147,14,2435,655,6856,0,1531,904,"[135, 41, 159, 283, 34, 96, 95, 281, 124, 175, 50, 249, 88, 0, 109, 247, 93, 288, 237, 45, 100, 289, 258, 31, 12, 120, 151]"
148,14,1881,83,8654,0,1332,549,"[84, 166, 109, 30, 48, 143, 174, 32, 125, 67, 26, 53, 47, 0, 141, 77, 69, 12, 97, 167, 16, 49, 75, 144, 10, 159, 34]"
149,14,1917,127,10000,444,1129,788,"[162, 108, 39, 220, 208, 21, 254, 256, 119, 112, 145, 139, 9, 0, 198, 119, 156, 170, 231, 212, 39, 134, 246, 153, 149, 0, 254]"
150,14,1246,7359,3887,0,749,497,"[157, 64, 10, 23, 162, 155, 94, 36, 69, 76, 158, 128, 60, 0, 138, 156, 126, 91, 133, 40, 131, 100, 59, 0, 115, 97, 143]"
151,14,1249,218,4918,0,31,1218,"[305, 48, 282, 326, 92, 7, 163, 127, 391, 225, 228, 41, 198, 0, 134, 311, 43, 381, 216, 63, 297, 251, 318, 1, 304, 395, 385]"
152,14,2747,2640,5025,0,600,2147,"[395, 704, 685, 1, 347, 429, 221, 557, 442, 173, 122, 415, 202, 0, 393, 73, 561, 186, 373, 15, 624, 712, 290, 102, 330, 475, 569]"
153,14,1968,292,6701,0,1409,559,"[105, 54, 58, 52, 93, 99, 91, 130, 128, 92, 11, 139, 167, 0, 14, 157, 140, 33, 124, 82, 2, 85, 67, 80, 69, 125, 125]"
154,14,2837,1397,8141,0,1566,1271,"[194, 265, 155, 153, 196, 281, 83, 321, 95, 199, 63, 218, 190, 0, 283, 298, 299, 330, 349, 395, 224, 242, 116, 375, 17, 30, 284]"
155,14,1330,1072,8399,0,992,338,"[0, 11, 39, 52, 6, 8, 4, 25, 18, 28, 11, 21, 80, 0, 60, 16, 12, 54, 0, 77, 73, 20, 92, 5, 23, 11, 14]"
156,14,2929,5666,5662,0,2450,479,"[30, 136, 45, 112, 113, 98, 31, 80, 57, 139, 121, 32, 104, 0, 121, 136, 69, 122, 51, 53, 45, 37, 24, 35, 73, 158, 15]"
157,14,2561,913,7310,0,1014,1547,"[79, 445, 479, 451, 91, 14, 104, 331, 239, 334, 133, 88, 162, 0, 454, 364, 315, 335, 296, 275, 153, 263, 344, 282, 274, 319, 186]"
158,14,1391,1098,7603,0,1128,263,"[52, 2, 48, 27, 32, 68, 74, 82, 26, 27, 82, 49, 33, 0, 74, 54, 77, 40, 10, 63, 21, 14, 5, 12, 69, 19, 36]"
159,14,2186,1361,8428,0,69,2117,"[511, 648, 430, 494, 88, 599, 492, 312, 281, 48, 48, 0, 243, 0, 229, 193, 663, 635, 181, 589, 559, 400, 42, 435, 672, 462, 257]"
160,14,1919,412,9935,0,1573,346,"[86, 50, 100, 43, 106, 68, 27, 18, 74, 81, 92, 78, 58, 0, 32, 20, 37, 81, 16, 77, 34, 35, 93, 19, 99, 56, 103]"
161,14,1585,6921,4599,0,168,1417,"[415, 458, 299, 219, 409, 61, 145, 436, 347, 224, 354, 112, 409, 0, 370, 390, 114, 157, 94, 210, 223, 459, 228, 319, 95, 179, 261]"
162,14,1656,359,5896,0,1304,352,"[98, 10, 5, 69, 79, 97, 99, 9, 29, 92, 64, 8, 29, 0, 107, 35, 77, 43, 43, 68, 19, 17, 77, 33, 7, 44, 100]"
163,14,1815,952,6759,0,1160,655,"[6, 186, 81, 48, 206, 198, 169, 8, 50, 127, 55, 33, 110, 0, 132, 181, 5, 176, 129, 60, 119, 38, 98, 176, 89, 205, 108]"
164,14,2817,1769,7807,0,1142,1675,"[311, 512, 339, 549, 338, 216, 402, 117, 127, 117, 362, 500, 482, 0, 328, 155, 269, 92, 520, 404, 549, 277, 18, 524, 237, 147, 356]"
165,14,2327,2040,8094,0,156,2171,"[477, 573, 266, 95, 640, 294, 11, 218, 37, 249, 90, 352, 544, 0, 446, 352, 533, 335, 532, 175, 27, 351, 225, 560, 334, 402, 201]"
166,14,2434,575,9953,0,1545,889,"[214, 78, 21, 207, 230, 185, 86, 125, 238, 225, 156, 126, 122, 0, 25, 173, 234, 182, 263, 269, 97, 166, 166, 234, 78, 204, 217]"
167,14,1927,6854,5026,0,821,1106,"[142, 289, 53, 21, 301, 18, 300, 88, 240, 260, 150, 84, 145, 0, 33, 12, 124, 129, 46, 211, 230, 65, 163, 198, 319, 345, 243]"
168,14,1640,1052,5614,0,498,1142,"[380, 156, 269, 31, 120, 89, 207, 316, 83, 38, 68, 378, 32, 0, 5, 141, 158, 271, 65, 350, 367, 348, 290, 326, 46, 374, 111]"
169,14,1105,564,6155,0,736,369,"[14, 84, 71, 41, 109, 49, 119, 103, 56, 32, 85, 30, 93, 0, 48, 45, 28, 63, 72, 1, 42, 81, 63, 76, 22, 75, 107]"
170,14,2869,2726,6298,0,1735,1134,"[314, 223, 115, 68, 214, 274, 34, 73, 354, 285, 254, 132, 155, 0, 327, 271, 321, 132, 192, 105, 84, 32, 20, 83, 248, 167, 38]"
171,14,1101,457,6942,0,496,605,"[41, 154, 66, 36, 43, 168, 53, 186, 96, 174, 167, 109, 29, 0, 13, 10, 22, 75, 153, 46, 65, 199, 107, 153, 68, 31, 182]"
172,14,3000,2649,7293,0,2447,553,"[37, 138, 46, 157, 151, 122, 146, 66, 115, 73, 80, 113, 3, 0, 120, 171, 158, 162, 61, 170, 104, 46, 0, 13, 37, 135, 160]"
173,14,2026,1752,7567,0,1207,819,"[42, 98, 116, 191, 205, 257, 205, 273, 67, 11, 260, 40, 25, 0, 259, 5, 264, 108, 108, 149, 215, 163, 255, 17, 146, 247, 79]"
174,14,1183,197,8553,0,462,721,"[18, 48, 33, 229, 144, 23, 32, 236, 37, 126, 175, 184, 33, 0, 36, 137, 27, 166, 232, 84, 54, 218, 226, 26, 164, 26, 134]"
175,14,2485,6532,4506,0,2231,254,"[47, 12, 62, 82, 2, 77, 58, 72, 38, 49, 25, 77, 59, 0, 8, 29, 71, 39, 19, 74, 22, 69, 83, 67, 8, 73, 67]"
176,14,1964,1162,5308,0,94,1870,"[455, 214, 515, 461, 398, 176, 577, 599, 10, 584, 622, 137, 12, 0, 376, 113, 135, 229, 29, 182, 446, 394, 54, 329, 291, 214, 65]"
177,14,2260,734,6834,0,468,1792,"[48, 397, 224, 377, 346, 139, 360, 198, 410, 416, 549, 88, 203, 0, 56, 383, 65, 475, 479, 235, 566, 470, 342, 565, 5, 12, 277]"
178,14,2293,1096,8031,0,845,1448,"[471, 205, 195, 312, 272, 240, 76, 267, 461, 199, 191, 445, 12, 0, 143, 192, 178, 273, 238, 341, 181, 11, 262, 98, 190, 288, 460]"
179,14,2712,745,9998,0,1984,728,"[60, 218, 163, 36, 53, 240, 174, 221, 201, 18, 101, 119, 76, 0, 28, 131, 71, 218, 26, 192, 113, 214, 168, 166, 212, 117, 33]"
180,14,1640,7199,4439,0,1454,186,"[17, 33, 5, 25, 16, 1, 42, 19, 5, 23, 13, 6, 7, 0, 23, 50, 19, 56, 2, 45, 60, 54, 55, 42, 47, 40, 59]"
181,14,1609,180,5868,0,376,1233,"[16, 95, 93, 1, 281, 44, 33, 399, 178, 341, 228, 284, 207, 0, 285, 352, 355, 165, 140, 226, 174, 57, 36, 260, 230, 235, 391]"
182,14,2695,2103,6460,0,2120,575,"[179, 83, 118, 30, 143, 62, 188, 42, 123, 95, 35, 82, 155, 0, 14, 106, 7, 161, 140, 28, 99, 13, 182, 99, 176, 93, 90]"
183,14,1276,625,7111,0,1132,144,"[8, 33, 38, 6, 18, 43, 15, 20, 14, 36, 40, 40, 15, 0, 26, 41, 40, 33, 20, 2, 12, 27, 33, 40, 42, 1, 17]"
184,14,1981,514,8578,0,1061,920,"[202, 153, 207, 77, 48, 138, 81, 121, 0, 177, 238, 133, 298, 0, 13, 233, 118, 106, 220, 103, 70, 15, 194, 239, 35, 248, 305]"
185,14,1395,598,9375,0,885,510,"[136, 33, 137, 154, 47, 144, 103, 14, 76, 62, 7, 124, 72, 0, 61, 5, 139, 62, 142, 113, 80, 152, 21, 28, 29, 151, 162]"
186,14,2347,5119,6603,0,828,1519,"[188, 335, 365, 462, 461, 338, 35, 61, 276, 66, 155, 240, 14, 0, 194, 435, 408, 258, 106, 322, 312, 121, 56, 357, 287, 227, 193]"
187,14,2956,347,9212,0,2703,253,"[52, 19, 47, 68, 46, 0, 35, 22, 77, 36, 81, 49, 76, 0, 10, 37, 78, 15, 39, 35, 70, 16, 9, 70, 22, 80, 8]"
188,14,1664,1157,9719,0,1379,285,"[4, 23, 68, 70, 45, 63, 77, 74, 47, 76, 8, 91, 40, 0, 17, 71, 60, 50, 38, 82, 32, 12, 76, 90, 87, 92, 95]"
189,14,1059,552,10000,226,299,760,"[51, 159, 148, 207, 118, 69, 42, 176, 198, 154, 181, 194, 170, 0, 72, 52, 197, 18, 107, 244, 149, 2, 199, 189, 213, 79, 165]"
190,14,1689,6705,4984,0,215,1474,"[6, 434, 399, 213, 276, 450, 123, 170, 226, 44, 448, 420, 79, 0, 232, 273, 173, 401, 457, 79, 448, 172, 402, 397, 387, 457, 402]"
191,14,1483,990,5477,0,1210,273,"[12, 44, 87, 5, 87, 77, 34, 52, 14, 54, 52, 18, 49, 0, 33, 66, 33, 82, 60, 60, 91, 63, 74, 63, 57, 34, 59]"
192,14,2291,1245,6523,0,985,1306,"[400, 407, 148, 381, 28, 289, 25, 202, 411, 435, 183, 209, 424, 0, 32, 263, 52, 310, 275, 48, 163, 30, 421, 137, 104, 97, 376]"
193,14,1027,249,7301,0,791,236,"[61, 6, 0, 76, 4, 46, 51, 29, 50, 58, 4, 8, 47, 0, 75, 71, 10, 55, 69, 50, 58, 16, 61, 14, 25, 17, 38]"
194,14,2228,1093,8436,0,388,1840,"[598, 570, 473, 603, 39, 369, 375, 120, 504, 488, 561, 430, 377, 0, 595, 179, 112, 66, 578, 220, 109, 495, 215, 418, 371, 382, 346]"
195,14,2307,343,10000,400,2257,50,"[3, 3, 13, 10, 10, 9, 2, 9, 13, 5, 7, 6, 3, 0, 9, 6, 5, 6, 2, 5, 1, 16, 0, 7, 13, 4, 4]"
196,14,1983,5940,6043,0,246,1737,"[8, 40, 396, 517, 171, 104, 361, 413, 16, 445, 176, 361, 393, 0, 30, 8, 2, 385, 369, 100, 534, 358, 377, 201, 56, 509, 518]"
197,14,2251,1308,6986,0,1136,1115,"[102, 133, 26, 371, 142, 192, 213, 91, 269, 320, 251, 117, 8, 0, 27, 231, 134, 111, 279, 29, 105, 103, 215, 178, 366, 178, 201]"
198,14,1166,1055,7097,0,130,1036,"[11, 313, 71, 16, 169, 309, 54, 6, 276, 83, 216, 64, 11, 0, 47, 323, 173, 341, 328, 197, 324, 263, 125, 342, 129, 12, 190]"
199,14,2824,2779,7142,0,1951,873,"[212, 260, 107, 165, 84, 15, 279, 142, 7, 260, 92, 57, 229, 0, 188, 163, 127, 74, 79, 100, 206, 91, 137, 191, 28, 164, 278]"
200,14,1021,17,8146,0,364,657,"[89, 25, 159, 147, 31, 62, 78, 98, 177, 46, 80, 102, 63, 0, 200, 173, 138, 63, 60, 175, 188, 199, 183, 181, 172, 182, 89]"
201,14,2936,7305,3777,0,2011,925,"[19, 244, 221, 111, 158, 147, 273, 5, 282, 180, 295, 55, 5, 0, 113, 98, 292, 49, 206, 175, 46, 173, 189, 281, 57, 206, 183]"
202,14,1097,2,4872,0,716,381,"[111, 67, 127, 110, 112, 53, 84, 55, 47, 35, 61, 80, 101, 0, 31, 84, 44, 24, 110, 19, 103, 53, 85, 93, 94, 31, 94]"
203,14,2552,449,6975,0,2307,245,"[66, 66, 10, 6, 49, 79, 53, 2, 29, 55, 55, 74, 30, 0, 21, 11, 43, 74, 63, 38, 37, 1, 32, 59, 47, 12, 25]"
204,14,1408,104,8279,0,792,616,"[5, 173, 68, 48, 197, 138, 188, 170, 183, 196, 40, 146, 86, 0, 145, 119, 137, 35, 6, 148, 177, 148, 44, 7, 174, 204, 139]"
205,14,1220,842,8657,0,925,295,"[22, 5, 17, 11, 59, 26, 88, 59, 42, 42, 72, 77, 67, 0, 98, 69, 34, 30, 66, 18, 72, 65, 18, 11, 32, 83, 69]"
206,14,2301,104,10000,854,1872,429,"[43, 131, 95, 134, 16, 103, 119, 54, 96, 16, 64, 101, 120, 0, 106, 90, 45, 95, 136, 61, 134, 112, 118, 44, 107, 127, 135]"
207,14,1138,6556,4582,0,512,626,"[110, 4, 109, 61, 96, 149, 67, 135, 28, 6, 155, 47, 200, 0, 18, 113, 39, 114, 65, 101, 24, 161, 31, 66, 52, 206, 175]"
208,14,1582,346,5818,0,1575,7,"[1, 2, 2, 1, 2, 1, 1, 2, 0, 0, 2, 1, 1, 0, 2, 0, 1, 2, 2, 0, 2, 2, 2, 0, 0, 1, 1]"
209,14,1429,1107,6140,0,867,562,"[40, 115, 93, 51, 95, 142, 38, 5, 99, 110, 73, 125, 172, 0, 67, 3, 109, 144, 134, 144, 27, 114, 14, 118, 3, 15, 103]"
210,14,1819,1010,6949,0,858,961,"[101, 220, 133, 101, 318, 134, 43, 136, 216, 214, 15, 66, 125, 0, 287, 82, 277, 290, 109, 81, 30, 274, 164, 71, 286, 226, 192]"
211,14,2861,2626,7184,0,665,2196,"[57, 80, 582, 212, 592, 484, 724, 485, 559, 135, 614, 605, 235, 0, 467, 703, 369, 5, 493, 559, 273, 491, 55, 76, 108, 91, 102]"
212,14,2723,1122,8785,0,715,2008,"[46, 112, 371, 39, 563, 60, 484, 279, 147, 431, 274, 390, 584, 0, 568, 145, 657, 54, 11, 668, 218, 71, 348, 370, 644, 24, 40]"
213,14,2714,6663,4836,0,583,2131,"[269, 126, 646, 398, 472, 539, 559, 62, 612, 657, 421, 153, 691, 0, 73, 708, 281, 318, 528, 160, 324, 106, 492, 111, 696, 158, 464]"
214,14,1785,150,6471,0,1631,154,"[9, 16, 10, 50, 5, 50, 37, 34, 49, 19, 39, 25, 42, 0, 49, 43, 13, 33, 46, 12, 6, 10, 21, 27, 33, 31, 40]"
215,14,2191,148,8514,0,251,1940,"[210, 340, 260, 587, 500, 58, 536, 127, 608, 83, 587, 305, 544, 0, 439, 402, 545, 443, 329, 375, 65, 629, 219, 158, 432, 363, 299]"
216,14,1801,1068,9247,0,912,889,"[233, 125, 154, 192, 84, 229, 257, 250, 6, 194, 3, 153, 10, 0, 274, 25, 227, 184, 44, 73, 213, 143, 22, 263, 75, 93, 65]"
217,14,1092,301,10000,38,987,105,"[5, 18, 14, 2, 29, 20, 18, 26, 33, 6, 24, 22, 22, 0, 19, 25, 27, 35, 19, 12, 27, 17, 33, 12, 15, 12, 4]"
218,14,2152,7060,5092,0,1931,221,"[7, 37, 42, 24, 62, 49, 3, 63, 68, 10, 17, 13, 49, 0, 18, 18, 16, 48, 39, 44, 21, 44, 50, 24, 20, 24, 43]"
219,14,1378,779,5691,0,905,473,"[157, 42, 62, 151, 154, 60, 109, 133, 139, 93, 137, 60, 63, 0, 143, 34, 146, 16, 43, 36, 23, 40, 57, 124, 141, 32, 22]"
220,14,1556,438,6809,0,1425,131,"[18, 7, 17, 39, 2, 23, 34, 19, 18, 15, 38, 24, 13, 0, 1, 30, 7, 23, 11, 18, 43, 18, 3, 41, 20, 18, 20]"
221,14,1584,234,8159,0,399,1185,"[54, 207, 361, 153, 68, 118, 97, 43, 313, 347, 11, 204, 43, 0, 18, 132, 333, 351, 241, 236, 157, 367, 248, 72, 296, 323, 237]"
222,14,1255,816,8598,0,106,1149,"[266, 206, 184, 4, 332, 19, 72, 34, 175, 8, 36, 229, 54, 0, 381, 216, 144, 50, 256, 249, 183, 159, 44, 199, 258, 369, 353]"
223,14,2585,6395,4788,0,2017,568,"[78, 57, 184, 31, 154, 179, 118, 178, 150, 150, 112, 161, 70, 0, 10, 188, 136, 109, 163, 121, 50, 63, 33, 91, 6, 52, 42]"
224,14,1456,999,5245,0,1381,75,"[25, 22, 5, 25, 13, 12, 22, 13, 10, 18, 11, 9, 9, 0, 10, 14, 0, 4, 17, 13, 20, 1, 22, 4, 10, 1, 22]"
225,14,1026,343,5928,0,965,61,"[10, 9, 5, 4, 1, 15, 0, 9, 12, 5, 19, 19, 1, 0, 7, 3, 5, 19, 1, 18, 16, 1, 16, 2, 6, 18, 11]"
226,14,2784,392,8320,0,1815,969,"[12, 141, 158, 45, 271, 268, 166, 279, 268, 262, 48, 321, 202, 0, 29, 237, 168, 233, 111, 141, 199, 277, 54, 97, 257, 101, 103]"
227,14,1496,1078,8738,0,552,944,"[262, 5, 130, 37, 10, 20, 283, 121, 23, 192, 68, 239, 307, 0, 144, 88, 308, 62, 272, 150, 131, 103, 124, 288, 286, 209, 47]"
228,14,2023,1045,9716,0,248,1775,"[490, 389, 240, 323, 169, 589, 497, 64, 394, 173, 343, 477, 4, 0, 242, 110, 45, 337, 498, 157, 169, 273, 273, 584, 243, 117, 216]"
229,14,2122,6929,4909,0,147,1975,"[480, 233, 41, 504, 45, 355, 269, 73, 355, 237, 488, 300, 139, 0, 205, 614, 134, 496, 585, 318, 425, 158, 559, 605, 109, 633, 5]"
230,14,1985,1257,5637,0,1308,677,"[163, 191, 200, 157, 110, 64, 15, 177, 140, 105, 18, 106, 182, 0, 197, 164, 201, 173, 115, 30, 216, 77, 74, 136, 198, 26, 179]"
231,14,1716,1701,5652,0,1410,306,"[95, 91, 31, 18, 30, 37, 26, 20, 4, 28, 34, 26, 22, 0, 11, 54, 5, 27, 63, 93, 46, 0, 55, 57, 25, 45, 40]"
232,14,2368,819,7201,0,1276,1092,"[178, 192, 111, 256, 249, 129, 123, 329, 37, 143, 55, 123, 238, 0, 256, 148, 295, 229, 343, 124, 240, 46, 116, 85, 337, 286, 301]"
233,14,1252,956,7497,0,326,926,"[257, 90, 247, 166, 187, 102, 1, 228, 2, 72, 251, 225, 48, 0, 37, 259, 13, 109, 71, 241, 178, 256, 194, 36, 179, 38, 130]"
234,14,2676,591,9582,0,1020,1656,"[405, 381, 214, 550, 524, 149, 26, 32, 409, 332, 256, 208, 513, 0, 27, 236, 103, 156, 389, 212, 113, 22, 350, 266, 542, 1, 424]"
235,14,1205,236,10000,551,120,1085,"[99, 159, 249, 218, 218, 77, 181, 132, 114, 284, 155, 175, 216, 0, 150, 74, 261, 269, 278, 108, 246, 159, 294, 79, 34, 203, 235]"
236,14,2772,6137,6635,0,2228,544,"[47, 145, 59, 133, 98, 61, 23, 39, 103, 94, 134, 97, 2, 0, 123, 124, 114, 77, 50, 105, 111, 33, 131, 160, 153, 133, 81]"
237,14,2285,1735,7185,0,1245,1040,"[32, 92, 91, 253, 141, 246, 59, 103, 236, 69, 43, 26, 344, 0, 156, 152, 193, 83, 202, 257, 306, 157, 73, 236, 153, 174, 279]"
238,14,1474,975,7684,0,555,919,"[190, 278, 221, 129, 252, 276, 210, 145, 230, 25, 203, 188, 116, 0, 283, 11, 248, 121, 295, 103, 144, 104, 132, 60, 261, 50, 24]"
239,14,1541,1144,8081,0,73,1468,"[255, 136, 135, 121, 288, 330, 220, 451, 32, 9, 459, 389, 89, 0, 124, 168, 371, 204, 472, 281, 252, 150, 467, 363, 406, 299, 234]"
240,14,2872,943,10000,10,1444,1428,"[238, 162, 110, 11, 294, 334, 44, 197, 327, 107, 439, 18, 310, 0, 6, 359, 112, 143, 323, 54, 333, 260, 59, 26, 362, 231, 198]"
241,14,1068,5561,5507,0,144,924,"[153, 52, 68, 305, 19, 125, 233, 263, 307, 248, 75, 299, 96, 0, 161, 160, 213, 197, 115, 262, 203, 207, 254, 175, 276, 272, 78]"
242,14,2245,117,7635,0,966,1279,"[118, 280, 137, 240, 242, 192, 391, 400, 156, 9, 188, 341, 242, 0, 152, 380, 154, 239, 166, 211, 399, 302, 155, 143, 307, 285, 252]"
243,14,1683,1463,7855,0,847,836,"[81, 260, 110, 82, 219, 54, 138, 192, 149, 102, 109, 154, 67, 0, 227, 227, 199, 81, 27, 178, 119, 35, 25, 148, 197, 146, 221]"
244,14,1031,82,8804,0,953,78,"[19, 12, 23, 16, 19, 15, 3, 21, 10, 5, 5, 25, 19, 0, 0, 11, 22, 22, 14, 18, 10, 20, 2, 25, 11, 11, 8]"
245,14,1568,899,9473,0,453,1115,"[343, 195, 238, 39, 233, 73, 231, 335, 204, 49, 199, 205, 42, 0, 186, 122, 32, 22, 214, 89, 230, 73, 309, 43, 307, 104, 204]"
246,14,1609,6730,4352,0,1051,558,"[48, 56, 10, 173, 54, 104, 15, 86, 120, 121, 53, 167, 172, 0, 161, 15, 4, 67, 156, 72, 139, 36, 59, 122, 142, 115, 69]"
247,14,1453,1153,4652,0,1150,303,"[85, 35, 48, 74, 95, 93, 36, 83, 24, 48, 31, 30, 54, 0, 57, 88, 56, 88, 0, 64, 86, 59, 37, 58, 74, 87, 23]"
248,14,2318,299,6671,0,2241,77,"[9, 21, 25, 14, 14, 25, 16, 24, 15, 11, 6, 14, 1, 0, 14, 0, 11, 13, 1, 12, 4, 24, 17, 18, 25, 4, 6]"
249,14,1719,1360,7030,0,1644,75,"[23, 5, 5, 1, 7, 5, 0, 0, 6, 7, 18, 3, 24, 0, 2, 25, 16, 14, 23, 17, 4, 17, 10, 15, 8, 14, 8]"
250,14,2304,1965,7369,0,893,1411,"[29, 449, 6, 239, 163, 388, 48, 366, 233, 123, 14, 263, 427, 0, 120, 245, 399, 252, 365, 240, 164, 104, 312, 37, 294, 208, 7]"
251,14,2959,2701,7627,0,1585,1374,"[283, 300, 30, 181, 260, 101, 425, 209, 209, 366, 380, 400, 152, 0, 175, 232, 145, 137, 291, 448, 95, 93, 415, 243, 72, 76, 225]"
252,14,1630,1007,8250,0,467,1163,"[174, 6, 45, 374, 92, 19, 246, 352, 381, 322, 92, 160, 70, 0, 124, 375, 246, 200, 63, 213, 326, 338, 184, 275, 155, 108, 168]"
253,14,1709,333,9626,0,1128,581,"[79, 177, 9, 132, 106, 24, 40, 101, 109, 100, 118, 39, 80, 0, 185, 182, 24, 33, 73, 192, 126, 119, 29, 150, 78, 116, 85]"
254,14,1675,6935,4366,0,40,1635,"[383, 63, 504, 182, 157, 24, 259, 66, 172, 514, 420, 358, 272, 0, 480, 513, 111, 155, 495, 357, 167, 112, 204, 453, 404, 148, 498]"
255,14,2985,970,6381,0,372,2613,"[264, 741, 777, 819, 328, 234, 661, 613, 23, 555, 128, 206, 612, 0, 796, 784, 294, 798, 622, 542, 794, 559, 248, 433, 208, 327, 256]"
256,14,2356,13,8724,0,359,1997,"[66, 495, 472, 143, 70, 527, 204, 660, 259, 162, 450, 419, 340, 0, 376, 398, 34, 448, 298, 551, 587, 508, 117, 380, 377, 664, 46]"
257,14,2947,6769,4902,0,1546,1401,"[195, 100, 125, 71, 439, 221, 260, 358, 332, 9, 268, 61, 176, 0, 120, 251, 114, 104, 75, 272, 95, 91, 121, 178, 58, 467, 132]"
258,14,1309,67,6144,0,263,1046,"[315, 233, 333, 151, 147, 7, 9, 48, 223, 203, 209, 344, 127, 0, 124, 114, 175, 311, 303, 151, 229, 156, 60, 309, 96, 346, 35]"
259,14,2891,1638,7397,0,583,2308,"[124, 492, 220, 17, 120, 711, 515, 87, 32, 16, 115, 277, 214, 0, 459, 449, 267, 295, 585, 30, 498, 165, 284, 496, 81, 595, 355]"
260,14,1569,107,8859,0,222,1347,"[63, 438, 43, 29, 420, 417, 122, 244, 227, 279, 196, 448, 231, 0, 123, 335, 196, 149, 340, 278, 11, 71, 279, 415, 400, 231, 213]"
261,14,2985,6572,5272,0,2288,697,"[28, 179, 9, 229, 162, 229, 148, 230, 36, 105, 187, 121, 225, 0, 210, 206, 109, 136, 0, 204, 202, 211, 222, 118, 99, 33, 214]"
262,14,1929,189,7012,0,467,1462,"[243, 294, 267, 230, 258, 190, 415, 83, 61, 415, 400, 258, 308, 0, 96, 4, 262, 159, 274, 107, 258, 30, 284, 15, 66, 444, 337]"
263,14,1372,935,7449,0,465,907,"[35, 70, 8, 78, 7, 102, 88, 147, 236, 125, 41, 169, 83, 0, 226, 61, 207, 68, 212, 234, 271, 96, 22, 279, 287, 133, 190]"
264,14,2365,960,8854,0,2017,348,"[41, 29, 12, 103, 116, 5, 8, 101, 110, 27, 52, 73, 36, 0, 98, 116, 115, 2, 16, 2, 49, 20, 63, 64, 90, 13, 47]"
265,14,1337,343,9848,0,492,845,"[170, 70, 260, 276, 143, 93, 81, 85, 94, 48, 71, 172, 112, 0, 110, 263, 230, 53, 74, 39, 6, 131, 13, 101, 48, 159, 246]"
266,14,2831,5453,7226,0,2354,477,"[6, 120, 101, 159, 29, 84, 92, 158, 150, 72, 123, 91, 124, 0, 19, 115, 18, 64, 14, 69, 55, 25, 1, 122, 123, 102, 156]"
267,14,1904,675,8455,0,745,1159,"[367, 310, 80, 378, 304, 89, 227, 223, 249, 311, 219, 17, 360, 0, 117, 79, 98, 262, 8, 180, 262, 40, 191, 90, 332, 271, 366]"
268,14,1144,116,9483,0,605,539,"[73, 88, 157, 49, 167, 35, 102, 142, 82, 89, 13, 68, 106, 0, 99, 172, 25, 79, 48, 106, 98, 83, 112, 53, 54, 75, 88]"
269,14,1599,6070,5012,0,1144,455,"[5, 67, 50, 6, 50, 82, 44, 116, 87, 105, 34, 19, 85, 0, 49, 24, 130, 1, 134, 55, 21, 98, 65, 97, 53, 129, 116]"
270,14,1516,162,6366,0,561,955,"[151, 125, 60, 145, 112, 241, 34, 190, 114, 308, 93, 116, 309, 0, 291, 39, 169, 259, 200, 12, 163, 291, 73, 125, 112, 69, 24]"
271,14,1906,426,7846,0,1148,758,"[113, 98, 102, 205, 73, 143, 203, 16, 177, 6, 242, 43, 216, 0, 237, 221, 14, 182, 82, 251, 178, 132, 70, 247, 242, 167, 188]"
272,14,2278,330,9794,0,1635,643,"[92, 184, 7, 33, 195, 178, 145, 40, 81, 98, 89, 178, 39, 0, 109, 172, 61, 188, 121, 201, 160, 201, 129, 2, 70, 173, 53]"
273,14,2231,5426,6599,0,59,2172,"[619, 328, 171, 672, 558, 113, 395, 472, 672, 586, 27, 566, 539, 0, 289, 33, 338, 360, 41, 253, 177, 481, 499, 71, 552, 204, 34]"
274,14,2578,101,9076,0,141,2437,"[155, 577, 455, 421, 50, 605, 729, 502, 473, 166, 292, 563, 443, 0, 615, 355, 752, 727, 192, 766, 173, 592, 756, 134, 677, 133, 157]"
275,14,2963,6284,5755,0,225,2738,"[399, 23, 754, 536, 191, 185, 269, 756, 211, 164, 676, 862, 219, 0, 557, 212, 756, 22, 258, 326, 628, 339, 680, 609, 447, 253, 308]"
276,14,2370,1193,6932,0,1212,1158,"[116, 38, 325, 339, 318, 97, 186, 79, 53, 324, 181, 188, 235, 0, 281, 25, 318, 296, 234, 20, 310, 32, 370, 190, 377, 142, 22]"
277,14,2533,2529,6936,0,1390,1143,"[30, 140, 273, 289, 20, 40, 152, 217, 11, 323, 365, 40, 61, 0, 296, 150, 65, 114, 79, 265, 300, 291, 261, 373, 181, 327, 376]"
278,14,1937,1053,7820,0,606,1331,"[421, 45, 359, 313, 38, 363, 223, 419, 327, 32, 148, 307, 139, 0, 340, 389, 56, 158, 435, 206, 271, 327, 21, 134, 364, 437, 366]"
279,14,1284,393,8711,0,117,1167,"[141, 166, 311, 387, 211, 109, 56, 318, 185, 113, 277, 169, 346, 0, 258, 98, 116, 213, 374, 280, 113, 315, 221, 284, 12, 255, 378]"
280,14,1411,1196,8926,0,703,708,"[43, 91, 124, 119, 107, 23, 207, 33, 181, 15, 173, 185, 210, 0, 151, 112, 70, 78, 48, 143, 206, 180, 193, 152, 199, 166, 187]"
281,14,2976,5614,6288,0,1261,1715,"[310, 193, 246, 553, 100, 123, 449, 490, 99, 319, 438, 223, 559, 0, 209, 41, 125, 375, 121, 523, 48, 339, 36, 281, 397, 506, 274]"
282,14,2359,1537,7110,0,1502,857,"[29, 102, 114, 18, 199, 173, 175, 154, 167, 125, 70, 6, 260, 0, 182, 220, 231, 207, 125, 164, 91, 184, 17, 167, 22, 252, 129]"
283,14,1122,973,7259,0,548,574,"[165, 139, 29, 67, 165, 107, 135, 21, 8, 54, 159, 162, 91, 0, 40, 47, 19, 28, 74, 5, 154, 143, 70, 172, 0, 133, 174]"
284,14,2117,1856,7520,0,1447,670,"[208, 114, 88, 120, 177, 149, 167, 121, 145, 95, 0, 96, 202, 0, 126, 31, 186, 218, 99, 89, 197, 92, 161, 185, 102, 36, 83]"
285,14,1985,1074,8431,0,1173,812,"[237, 136, 159, 208, 193, 69, 258, 25, 137, 102, 245, 208, 28, 0, 80, 152, 37, 146, 198, 32, 44, 233, 95, 177, 250, 228, 258]"
286,14,2558,2352,8637,0,2003,555,"[0, 114, 172, 89, 32, 92, 168, 132, 155, 21, 39, 57, 70, 0, 90, 111, 62, 107, 68, 71, 118, 3, 98, 176, 34, 94, 118]"
287,14,2484,7475,3646,0,909,1575,"[417, 437, 409, 391, 222, 204, 468, 55, 393, 334, 494, 486, 468, 0, 436, 480, 359, 313, 19, 222, 315, 268, 103, 161, 326, 263, 196]"
288,14,2391,1263,4774,0,678,1713,"[175, 43, 563, 328, 47, 560, 353, 278, 449, 383, 352, 190, 187, 0, 480, 458, 9, 81, 151, 79, 514, 309, 555, 354, 525, 2, 294]"
289,14,2968,2651,5091,0,2956,12,"[1, 4, 2, 0, 0, 0, 1, 3, 3, 2, 0, 1, 2, 0, 2, 0, 1, 2, 3, 3, 3, 0, 3, 1, 4, 2, 1]"
290,14,2937,2123,5905,0,1950,987,"[253, 81, 45, 52, 135, 223, 26, 295, 41, 36, 140, 245, 40, 0, 141, 289, 84, 36, 291, 72, 58, 71, 255, 205, 222, 47, 213]"
291,14,1226,293,6838,0,378,848,"[217, 142, 272, 272, 266, 39, 40, 106, 55, 263, 203, 103, 228, 0, 61, 130, 194, 181, 234, 147, 132, 136, 68, 217, 159, 92, 133]"
292,14,2755,1330,8263,0,544,2211,"[235, 385, 241, 731, 149, 351, 246, 632, 78, 335, 506, 181, 431, 0, 300, 72, 582, 161, 254, 473, 236, 190, 143, 227, 105, 65, 106]"
293,14,1966,95,10000,134,1173,793,"[245, 149, 64, 167, 57, 32, 95, 210, 99, 177, 255, 216, 252, 0, 89, 205, 54, 227, 28, 71, 159, 34, 171, 78, 153, 133, 247]"
294,14,2237,5984,6253,0,1386,851,"[38, 274, 27, 253, 202, 120, 105, 28, 207, 34, 163, 95, 223, 0, 146, 175, 58, 23, 33, 35, 12, 75, 257, 51, 277, 61, 71]"
295,14,1201,931,6523,0,1048,153,"[37, 20, 44, 49, 17, 29, 34, 22, 18, 21, 4, 34, 16, 0, 32, 41, 21, 20, 47, 15, 37, 16, 36, 12, 33, 18, 16]"
296,14,1171,229,7465,0,831,340,"[82, 6, 34, 57, 30, 98, 33, 93, 45, 32, 87, 55, 35, 0, 95, 98, 46, 39, 5, 0, 99, 46, 18, 38, 64, 37, 85]"
297,14,1057,724,7798,0,461,596,"[124, 101, 155, 59, 109, 36, 123, 37, 124, 103, 138, 12, 51, 0, 169, 121, 172, 150, 42, 6, 23, 6, 166, 86, 79, 198, 130]"
298,14,2081,1686,8193,0,1304,777,"[13, 63, 104, 127, 141, 185, 138, 109, 28, 168, 207, 24, 70, 0, 235, 179, 178, 195, 17, 107, 54, 16, 107, 52, 123, 98, 218]"
299,14,1531,861,8863,0,1117,414,"[29, 50, 102, 137, 68, 98, 48, 41, 20, 121, 114, 11, 107, 0, 37, 3, 124, 49, 48, 3, 29, 108, 52, 28, 37, 4, 130]"
0,15,4952,0,4952,0,2421,2531,"[12, 718, 317, 115, 472, 138, 350, 218, 39, 448, 104, 228, 802, 826, 0, 628, 407, 614, 352, 396, 316, 120, 750, 817, 330, 385, 57]"
1,15,4886,1018,8820,0,3300,1586,"[147, 196, 327, 432, 338, 340, 441, 459, 290, 237, 279, 307, 117, 341, 0, 211, 28, 329, 241, 442, 304, 519, 237, 440, 45, 174, 449]"
2,15,3905,5354,7371,0,3174,731,"[63, 133, 6, 42, 158, 161, 243, 193, 148, 90, 93, 49, 126, 241, 0, 186, 125, 60, 166, 152, 17, 133, 10, 216, 188, 44, 164]"
3,15,3649,6878,4142,0,3347,302,"[34, 64, 91, 38, 89, 54, 70, 35, 39, 71, 77, 9, 14, 78, 0, 0, 18, 89, 14, 22, 69, 55, 3, 15, 39, 70, 57]"
4,15,3195,200,7137,0,460,2735,"[275, 601, 225, 585, 202, 70, 897, 892, 329, 142, 149, 442, 515, 322, 0, 906, 147, 91, 204, 303, 768, 204, 890, 597, 603, 33, 884]"
5,15,4855,5463,6529,0,1576,3279,"[707, 137, 664, 338, 353, 521, 859, 993, 90, 32, 246, 222, 901, 15, 0, 30, 959, 478, 989, 815, 1060, 157, 384, 459, 552, 677, 676]"
6,15,3197,2879,6847,0,1044,2153,"[708, 236, 635, 364, 168, 646, 6, 665, 205, 227, 9, 474, 93, 320, 0, 243, 618, 328, 324, 402, 577, 392, 440, 656, 528, 479, 563]"
7,15,3719,3661,6905,0,1699,2020,"[454, 4, 477, 57, 428, 367, 553, 625, 513, 594, 6, 537, 612, 489, 0, 35, 656, 366, 589, 135, 455, 436, 8, 264, 586, 673, 295]"
8,15,3734,2686,7953,0,3097,637,"[146, 88, 3, 52, 180, 128, 180, 191, 49, 211, 37, 141, 48, 92, 0, 203, 124, 56, 77, 39, 210, 180, 82, 140, 40, 68, 111]"
9,15,3623,5817,5759,0,2726,897,"[217, 110, 293, 263, 215, 296, 35, 148, 76, 242, 268, 109, 152, 125, 0, 38, 128, 67, 186, 192, 132, 77, 188, 47, 242, 107, 68]"
10,15,4593,4211,6141,0,2157,2436,"[409, 683, 683, 236, 809, 703, 404, 274, 158, 674, 402, 48, 45, 600, 0, 262, 37, 525, 663, 707, 656, 391, 322, 258, 713, 605, 668]"
11,15,3607,3578,6170,0,1520,2087,"[258, 465, 78, 541, 302, 152, 55, 299, 401, 587, 198, 190, 524, 269, 0, 325, 551, 259, 427, 458, 590, 494, 382, 158, 186, 166, 90]"
12,15,4567,2640,8097,0,2613,1954,"[477, 328, 481, 533, 231, 227, 432, 158, 234, 512, 325, 588, 67, 172, 0, 634, 85, 603, 55, 317, 122, 187, 44, 174, 122, 510, 555]"
13,15,3970,6115,5952,0,439,3531,"[170, 416, 884, 425, 556, 914, 914, 909, 544, 446, 464, 509, 521, 290, 0, 1114, 120, 799, 1043, 1081, 680, 485, 1111, 749, 232, 104, 1064]"
14,15,3672,2622,7002,0,1039,2633,"[490, 170, 21, 307, 263, 583, 555, 289, 490, 443, 599, 256, 265, 857, 0, 47, 855, 404, 804, 9, 645, 695, 406, 104, 20, 188, 740]"
15,15,4767,5309,6460,0,3315,1452,"[481, 430, 226, 349, 309, 354, 269, 206, 420, 440, 200, 100, 308, 349, 0, 228, 240, 49, 200, 8, 256, 318, 311, 65, 373, 174, 380]"
16,15,4079,48,10000,491,3060,1019,"[78, 27, 287, 214, 154, 54, 310, 160, 194, 125, 170, 6, 155, 92, 0, 105, 22, 118, 142, 51, 302, 57, 78, 212, 116, 318, 299]"
17,15,3879,6904,6975,0,1123,2756,"[556, 383, 762, 229, 905, 66, 360, 629, 140, 273, 525, 78, 781, 41, 0, 468, 477, 701, 645, 421, 188, 396, 444, 658, 602, 884, 162]"
18,15,4689,7453,4211,0,597,4092,"[549, 1017, 559, 1, 75, 1166, 1346, 677, 1320, 446, 827, 481, 385, 410, 0, 960, 373, 626, 556, 571, 1029, 64, 142, 803, 1342, 87, 1184]"
19,15,3613,69,7755,0,3398,215,"[41, 64, 3, 57, 47, 70, 27, 69, 71, 14, 14, 58, 19, 9, 0, 60, 21, 41, 51, 47, 31, 58, 50, 38, 45, 28, 12]"
20,15,4124,7351,4528,0,1714,2410,"[463, 127, 61, 247, 394, 318, 313, 89, 625, 262, 335, 557, 97, 251, 0, 642, 497, 737, 179, 471, 665, 64, 794, 139, 151, 606, 353]"
21,15,4463,3586,5405,0,106,4357,"[818, 974, 40, 729, 1096, 1004, 868, 790, 1381, 811, 1177, 819, 479, 1270, 0, 1232, 303, 1328, 1245, 961, 1104, 534, 194, 1228, 942, 491, 624]"
22,15,3152,581,7976,0,277,2875,"[163, 854, 642, 58, 391, 730, 783, 902, 630, 460, 209, 418, 456, 691, 0, 757, 762, 851, 273, 570, 679, 902, 468, 785, 829, 310, 238]"
23,15,4655,7174,5457,0,4378,277,"[78, 70, 77, 28, 27, 87, 13, 27, 4, 3, 88, 61, 41, 49, 0, 22, 2, 53, 92, 52, 8, 79, 90, 55, 37, 20, 13]"
24,15,3128,411,8174,0,1953,1175,"[33, 320, 167, 286, 343, 113, 7, 207, 294, 115, 380, 281, 72, 247, 0, 55, 159, 27, 23, 198, 266, 3, 80, 242, 244, 100, 40]"
25,15,4712,6873,6013,0,2178,2534,"[421, 501, 351, 150, 822, 695, 11, 90, 18, 479, 85, 825, 612, 604, 0, 558, 705, 561, 618, 31, 478, 470, 491, 89, 687, 697, 406]"
26,15,3723,3210,6526,0,3567,156,"[42, 11, 8, 27, 25, 30, 51, 29, 5, 4, 23, 21, 24, 42, 0, 16, 2, 23, 5, 26, 12, 24, 50, 28, 14, 50, 30]"
27,15,4706,7248,3984,0,4287,419,"[113, 52, 20, 128, 47, 129, 40, 84, 43, 122, 76, 4, 80, 21, 0, 58, 21, 101, 11, 56, 32, 95, 94, 85, 71, 112, 109]"
28,15,4838,1970,6852,0,1241,3597,"[416, 1006, 640, 285, 20, 487, 103, 589, 794, 396, 1033, 199, 541, 180, 0, 270, 269, 85, 296, 888, 528, 587, 459, 856, 1035, 668, 201]"
29,15,3277,414,9715,0,1149,2128,"[29, 339, 353, 260, 115, 654, 332, 451, 55, 105, 664, 539, 130, 194, 0, 141, 96, 15, 695, 232, 586, 230, 442, 627, 162, 137, 288]"
30,15,3797,6155,7357,0,702,3095,"[303, 366, 983, 528, 150, 268, 597, 1016, 480, 936, 399, 510, 779, 330, 0, 39, 200, 297, 731, 718, 971, 616, 895, 775, 633, 679, 752]"
31,15,3886,7013,4230,0,1327,2559,"[190, 50, 715, 180, 51, 3, 60, 435, 390, 635, 842, 217, 494, 758, 0, 802, 222, 706, 456, 357, 549, 614, 209, 514, 630, 634, 9]"
32,15,4069,3663,4636,0,2439,1630,"[75, 512, 391, 452, 534, 439, 332, 95, 106, 192, 23, 262, 451, 48, 0, 193, 296, 208, 410, 336, 126, 357, 264, 462, 134, 239, 496]"
33,15,4067,751,7952,0,26,4041,"[1023, 414, 1162, 722, 189, 871, 386, 1081, 804, 177, 273, 928, 1055, 750, 0, 870, 1121, 1055, 376, 870, 1036, 1148, 939, 265, 760, 620, 415]"
34,15,4566,7467,5051,0,2083,2483,"[800, 472, 730, 269, 416, 826, 771, 493, 326, 300, 274, 786, 397, 206, 0, 441, 125, 31, 248, 179, 651, 374, 542, 780, 40, 714, 213]"
35,15,3064,1853,6262,0,649,2415,"[570, 325, 4, 362, 788, 782, 449, 344, 621, 564, 632, 623, 402, 412, 0, 438, 639, 124, 195, 615, 496, 4, 512, 543, 58, 3, 560]"
36,15,3397,552,9107,0,1124,2273,"[369, 164, 173, 474, 289, 422, 357, 112, 543, 332, 751, 628, 182, 197, 0, 603, 424, 311, 650, 567, 71, 490, 367, 330, 404, 652, 2]"
37,15,4293,5553,7847,0,1702,2591,"[628, 738, 78, 175, 207, 569, 594, 298, 151, 721, 598, 200, 461, 648, 0, 84, 739, 721, 448, 334, 544, 166, 296, 645, 406, 685, 714]"
38,15,4418,6003,6262,0,255,4163,"[638, 117, 804, 285, 1275, 691, 330, 711, 98, 676, 985, 918, 991, 676, 0, 697, 410, 1208, 1264, 565, 256, 413, 1159, 129, 1296, 112, 249]"
39,15,4776,6725,4313,0,3660,1116,"[289, 338, 332, 148, 335, 60, 129, 240, 86, 9, 83, 363, 140, 169, 0, 321, 154, 131, 244, 173, 250, 317, 239, 229, 208, 276, 317]"
40,15,4425,1127,7611,0,3195,1230,"[74, 168, 151, 43, 138, 384, 226, 371, 403, 267, 219, 190, 130, 19, 0, 408, 267, 198, 1, 288, 105, 404, 137, 363, 128, 283, 285]"
41,15,4092,6640,5063,0,2362,1730,"[82, 185, 331, 65, 198, 245, 337, 83, 144, 495, 447, 52, 300, 85, 0, 460, 340, 174, 144, 314, 407, 10, 412, 29, 420, 467, 75]"
42,15,3594,1741,6916,0,3345,249,"[24, 14, 24, 56, 75, 57, 83, 43, 7, 60, 78, 23, 24, 70, 0, 30, 53, 20, 6, 31, 69, 7, 24, 71, 59, 6, 51]"
43,15,3429,1476,8869,0,1673,1756,"[143, 67, 476, 508, 381, 229, 432, 45, 85, 520, 559, 361, 173, 100, 0, 101, 204, 122, 12, 279, 570, 564, 421, 476, 269, 133, 550]"
44,15,4488,6542,6815,0,1535,2953,"[0, 592, 261, 503, 451, 687, 272, 967, 71, 772, 179, 332, 972, 24, 0, 764, 83, 777, 163, 728, 464, 95, 141, 534, 825, 102, 78]"
45,15,3653,1031,9437,0,1093,2560,"[740, 821, 192, 495, 322, 686, 188, 113, 346, 375, 146, 36, 258, 752, 0, 304, 143, 810, 701, 444, 11, 453, 335, 252, 713, 16, 138]"
46,15,3514,7265,5686,0,876,2638,"[536, 582, 252, 398, 81, 622, 37, 505, 868, 772, 307, 686, 221, 687, 0, 735, 427, 570, 523, 716, 417, 669, 719, 159, 425, 139, 285]"
47,15,3038,2069,6655,0,2813,225,"[26, 55, 0, 10, 68, 12, 9, 19, 70, 38, 52, 61, 15, 20, 0, 9, 5, 50, 16, 26, 11, 63, 71, 59, 52, 71, 27]"
48,15,3153,2070,7738,0,1411,1742,"[509, 514, 314, 30, 240, 400, 525, 248, 140, 160, 114, 285, 141, 5, 0, 537, 521, 337, 365, 294, 27, 208, 203, 387, 433, 117, 505]"
49,15,4585,6754,5569,0,2548,2037,"[416, 466, 156, 181, 498, 258, 648, 290, 337, 352, 167, 629, 89, 64, 0, 83, 112, 261, 60, 280, 250, 563, 180, 85, 343, 290, 162]"
50,15,3690,1976,7283,0,2232,1458,"[281, 198, 83, 51, 316, 322, 227, 191, 163, 415, 428, 25, 252, 155, 0, 107, 137, 28, 481, 132, 185, 106, 324, 135, 268, 387, 21]"
51,15,4641,5061,6863,0,4229,412,"[125, 59, 72, 117, 37, 104, 31, 67, 127, 127, 7, 104, 123, 128, 0, 29, 27, 83, 102, 9, 82, 81, 78, 86, 96, 88, 83]"
52,15,4876,5954,5785,0,2999,1877,"[281, 185, 568, 328, 478, 529, 600, 299, 9, 395, 622, 366, 10, 220, 0, 605, 74, 120, 556, 579, 560, 480, 388, 115, 135, 281, 0]"
53,15,3823,816,8792,0,1225,2598,"[356, 224, 80, 190, 88, 516, 403, 258, 178, 209, 680, 554, 797, 319, 0, 579, 718, 722, 725, 474, 642, 837, 276, 816, 818, 295, 268]"
54,15,3762,7463,5091,0,2903,859,"[84, 159, 223, 249, 225, 219, 271, 3, 108, 211, 65, 171, 241, 235, 0, 125, 170, 86, 19, 194, 194, 233, 92, 98, 75, 7, 219]"
55,15,3378,2484,5985,0,2930,448,"[143, 16, 1, 105, 103, 52, 28, 134, 4, 119, 96, 81, 70, 109, 0, 106, 93, 89, 65, 7, 117, 85, 125, 145, 118, 93, 111]"
56,15,3074,2544,6515,0,2184,890,"[197, 155, 256, 291, 210, 263, 26, 296, 281, 12, 16, 260, 260, 35, 0, 200, 166, 61, 211, 179, 247, 159, 153, 206, 271, 153, 192]"
57,15,4923,5499,5939,0,2538,2385,"[195, 697, 520, 556, 717, 785, 364, 133, 635, 742, 311, 663, 147, 251, 0, 628, 702, 518, 285, 126, 574, 56, 578, 281, 540, 99, 122]"
58,15,4974,2976,7937,0,4355,619,"[191, 116, 125, 108, 85, 27, 68, 182, 135, 97, 159, 68, 72, 170, 0, 33, 115, 91, 170, 63, 79, 206, 205, 71, 105, 200, 88]"
59,15,3630,5413,6154,0,614,3016,"[134, 97, 604, 922, 579, 834, 392, 816, 616, 817, 946, 418, 191, 868, 0, 727, 139, 333, 945, 243, 203, 267, 558, 514, 131, 329, 489]"
60,15,3297,1510,7941,0,823,2474,"[269, 83, 193, 781, 632, 456, 263, 710, 92, 797, 457, 238, 511, 342, 0, 20, 53, 338, 649, 715, 777, 182, 518, 686, 382, 409, 790]"
61,15,3192,7127,4006,0,2030,1162,"[303, 277, 227, 277, 210, 33, 40, 367, 138, 339, 376, 3, 39, 356, 0, 138, 304, 112, 93, 312, 108, 349, 48, 272, 279, 114, 196]"
62,15,3932,2223,5715,0,367,3565,"[673, 619, 440, 18, 129, 857, 218, 669, 562, 718, 911, 345, 120, 376, 0, 271, 399, 513, 43, 1054, 385, 899, 610, 232, 517, 405, 531]"
63,15,3153,2051,6817,0,1989,1164,"[188, 55, 148, 128, 166, 193, 208, 233, 137, 136, 90, 70, 90, 135, 0, 242, 188, 206, 141, 303, 166, 333, 151, 4, 373, 45, 27]"
64,15,3324,2624,7517,0,240,3084,"[177, 789, 30, 240, 322, 632, 668, 525, 9, 264, 466, 483, 718, 727, 0, 398, 602, 175, 559, 771, 272, 464, 208, 328, 24, 967, 259]"
65,15,4888,6047,6358,0,94,4794,"[756, 675, 1351, 1070, 312, 936, 407, 656, 1509, 393, 693, 821, 943, 513, 0, 951, 156, 971, 561, 789, 1580, 1162, 259, 1064, 1469, 427, 890]"
66,15,3923,1875,8406,0,3332,591,"[183, 16, 107, 6, 112, 24, 134, 130, 77, 151, 69, 138, 37, 103, 0, 100, 156, 139, 137, 23, 10, 16, 4, 35, 41, 165, 177]"
67,15,3985,6175,6216,0,670,3315,"[202, 30, 979, 1090, 148, 126, 508, 294, 820, 123, 1079, 59, 626, 788, 0, 5, 369, 466, 659, 666, 407, 502, 19, 165, 692, 429, 1093]"
68,15,3296,2953,6559,0,2877,419,"[43, 123, 106, 11, 15, 53, 117, 76, 49, 21, 92, 110, 12, 58, 0, 38, 113, 51, 51, 53, 134, 80, 104, 21, 96, 88, 137]"
69,15,4362,2158,8763,0,1219,3143,"[599, 577, 657, 9, 155, 1023, 296, 544, 482, 518, 829, 140, 571, 537, 0, 624, 375, 702, 759, 936, 438, 64, 193, 215, 295, 1042, 336]"
70,15,3030,6846,4947,0,2537,493,"[37, 150, 109, 113, 146, 93, 29, 114, 49, 66, 41, 50, 152, 155, 0, 17, 71, 85, 51, 23, 7, 158, 136, 77, 69, 125, 38]"
71,15,4113,2718,6342,0,2522,1591,"[51, 41, 348, 160, 238, 290, 11, 440, 35, 316, 111, 33, 288, 451, 0, 344, 4, 369, 39, 379, 356, 124, 187, 462, 384, 192, 499]"
72,15,4201,1467,9076,0,3985,216,"[41, 29, 13, 59, 63, 45, 61, 7, 49, 43, 43, 41, 50, 59, 0, 2, 4, 56, 10, 34, 49, 27, 51, 35, 15, 51, 60]"
73,15,3667,5015,7728,0,2743,924,"[222, 201, 121, 230, 118, 110, 232, 235, 102, 71, 206, 56, 129, 162, 0, 20, 127, 253, 56, 185, 305, 93, 266, 173, 122, 139, 297]"
74,15,3042,1521,9249,0,2897,145,"[14, 8, 22, 13, 35, 22, 10, 12, 2, 19, 37, 4, 0, 24, 0, 34, 40, 41, 43, 39, 14, 3, 3, 27, 40, 1, 25]"
75,15,3255,7352,5152,0,2196,1059,"[78, 0, 154, 211, 329, 79, 117, 102, 338, 296, 183, 261, 294, 301, 0, 231, 89, 302, 271, 337, 269, 83, 292, 141, 15, 145, 330]"
76,15,3340,1086,7406,0,402,2938,"[506, 429, 623, 121, 99, 21, 347, 701, 743, 396, 403, 459, 374, 566, 0, 413, 536, 40, 506, 189, 920, 454, 742, 66, 149, 628, 630]"
77,15,3137,2208,8335,0,743,2394,"[159, 106, 245, 635, 150, 347, 639, 613, 190, 653, 239, 480, 543, 268, 0, 77, 215, 164, 784, 715, 768, 219, 569, 739, 397, 436, 231]"
78,15,3931,5192,7074,0,21,3910,"[584, 462, 1055, 564, 43, 1179, 354, 641, 372, 1252, 269, 374, 971, 1297, 0, 292, 180, 788, 161, 986, 208, 676, 846, 521, 245, 415, 998]"
79,15,4669,6267,5476,0,1253,3416,"[484, 837, 100, 470, 770, 607, 279, 337, 577, 330, 469, 310, 382, 814, 0, 568, 859, 180, 178, 834, 603, 509, 866, 692, 825, 747, 1002]"
80,15,4019,2196,7299,0,3917,102,"[17, 5, 17, 0, 32, 8, 28, 14, 4, 22, 31, 20, 4, 0, 0, 21, 13, 9, 5, 23, 12, 33, 31, 5, 5, 20, 22]"
81,15,3314,2599,8014,0,3239,75,"[14, 12, 6, 0, 25, 23, 2, 21, 2, 6, 7, 2, 11, 9, 0, 5, 20, 24, 17, 10, 11, 16, 14, 16, 9, 18, 25]"
82,15,3818,7323,4509,0,366,3452,"[272, 881, 909, 128, 420, 150, 98, 114, 746, 805, 491, 286, 161, 743, 0, 844, 510, 128, 657, 744, 831, 10, 648, 190, 870, 1074, 880]"
83,15,3304,354,7459,0,2409,895,"[292, 18, 204, 208, 163, 244, 33, 31, 85, 208, 270, 122, 259, 212, 0, 120, 262, 196, 70, 106, 0, 80, 216, 247, 89, 31, 15]"
84,15,3235,161,10000,533,3124,111,"[17, 5, 7, 0, 18, 33, 37, 11, 12, 5, 36, 36, 21, 30, 0, 17, 10, 8, 28, 10, 20, 10, 19, 27, 35, 15, 13]"
85,15,4273,5087,9186,0,2423,1850,"[83, 77, 119, 461, 91, 467, 564, 37, 364, 113, 377, 424, 150, 477, 0, 476, 458, 381, 116, 308, 460, 287, 73, 143, 587, 218, 337]"
86,15,3209,5105,7290,0,2658,551,"[174, 7, 120, 125, 6, 72, 26, 90, 5, 73, 58, 114, 61, 24, 0, 161, 146, 98, 183, 119, 154, 164, 37, 146, 175, 76, 134]"
87,15,3235,1379,9146,0,442,2793,"[701, 92, 11, 541, 664, 767, 692, 375, 718, 558, 522, 927, 377, 154, 0, 248, 332, 631, 792, 350, 704, 703, 838, 69, 36, 840, 387]"
88,15,4301,5617,7830,0,2235,2066,"[195, 32, 178, 58, 227, 197, 7, 454, 168, 242, 142, 133, 62, 397, 0, 638, 558, 141, 608, 235, 433, 640, 210, 571, 57, 647, 258]"
89,15,4935,6722,6043,0,1119,3816,"[938, 71, 216, 417, 669, 81, 1021, 579, 92, 813, 863, 376, 12, 879, 0, 684, 446, 611, 52, 305, 128, 834, 35, 685, 1241, 324, 961]"
90,15,3784,1518,8309,0,1536,2248,"[278, 540, 448, 354, 246, 301, 546, 353, 132, 533, 96, 243, 586, 615, 0, 707, 548, 692, 672, 90, 487, 302, 40, 650, 522, 696, 614]"
91,15,3932,6174,6067,0,3741,191,"[5, 22, 33, 29, 42, 15, 53, 50, 27, 45, 47, 8, 48, 59, 0, 7, 55, 2, 52, 11, 59, 1, 57, 15, 51, 19, 15]"
92,15,3626,1492,8201,0,2341,1285,"[421, 394, 19, 322, 91, 346, 268, 84, 421, 45, 101, 221, 139, 2, 0, 146, 84, 184, 356, 209, 326, 316, 59, 311, 250, 135, 331]"
93,15,4747,6530,6418,0,1902,2845,"[731, 898, 301, 19, 947, 253, 271, 910, 821, 531, 20, 68, 472, 89, 0, 442, 297, 352, 654, 178, 129, 690, 463, 899, 53, 622, 599]"
94,15,3533,1372,8579,0,3487,46,"[9, 9, 10, 2, 10, 10, 3, 4, 7, 10, 4, 13, 15, 13, 0, 10, 7, 1, 4, 1, 2, 15, 1, 7, 11, 7, 6]"
95,15,4558,5315,7822,0,800,3758,"[144, 430, 1139, 585, 707, 546, 131, 176, 846, 402, 842, 267, 773, 755, 0, 1188, 926, 46, 1099, 731, 1150, 744, 215, 286, 778, 804, 1201]"
96,15,4225,6092,5955,0,4049,176,"[11, 31, 14, 25, 48, 23, 44, 1, 9, 49, 5, 53, 8, 2, 0, 39, 20, 15, 54, 31, 10, 58, 4, 4, 44, 34, 26]"
97,15,4661,2356,8260,0,3555,1106,"[335, 349, 317, 317, 290, 222, 229, 270, 2, 54, 100, 54, 143, 32, 0, 196, 32, 61, 269, 96, 83, 241, 309, 348, 321, 63, 178]"
98,15,3546,5034,6772,0,3419,127,"[10, 22, 34, 29, 11, 20, 19, 42, 25, 29, 13, 30, 14, 17, 0, 23, 7, 0, 38, 32, 37, 18, 17, 36, 6, 15, 35]"
99,15,3930,2695,8007,0,3884,46,"[10, 2, 14, 11, 4, 1, 10, 15, 9, 0, 8, 6, 4, 12, 0, 8, 0, 13, 8, 0, 8, 8, 2, 1, 14, 4, 4]"
100,15,3161,6180,4988,0,1997,1164,"[46, 182, 30, 329, 248, 123, 199, 190, 294, 76, 283, 30, 26, 291, 0, 172, 318, 7, 369, 245, 294, 211, 232, 232, 80, 353, 35]"
101,15,3707,1417,7278,0,636,3071,"[205, 636, 35, 971, 720, 362, 862, 997, 899, 546, 944, 928, 108, 295, 0, 780, 877, 923, 873, 883, 528, 617, 828, 133, 661, 358, 773]"
102,15,3054,2543,7789,0,2237,817,"[2, 76, 260, 227, 60, 196, 207, 130, 246, 145, 131, 184, 263, 109, 0, 18, 150, 89, 102, 82, 144, 186, 28, 92, 104, 29, 50]"
103,15,4672,6980,5481,0,2312,2360,"[663, 517, 254, 233, 206, 522, 783, 180, 554, 411, 165, 68, 651, 22, 0, 20, 590, 660, 693, 762, 358, 555, 315, 632, 151, 470, 189]"
104,15,3196,787,7890,0,379,2817,"[601, 551, 542, 501, 759, 463, 644, 695, 647, 822, 137, 891, 116, 353, 0, 639, 331, 672, 448, 59, 68, 183, 480, 792, 295, 599, 445]"
105,15,3951,6109,5732,0,2019,1932,"[257, 365, 114, 489, 457, 87, 639, 99, 233, 341, 128, 423, 263, 575, 0, 280, 70, 136, 199, 214, 400, 592, 512, 313, 224, 593, 117]"
106,15,4628,4399,5961,0,1955,2673,"[882, 150, 152, 567, 366, 622, 99, 236, 695, 502, 491, 570, 446, 747, 0, 27, 573, 167, 369, 727, 212, 48, 277, 25, 657, 825, 113]"
107,15,4151,3785,6327,0,2970,1181,"[87, 344, 144, 165, 66, 98, 312, 306, 229, 245, 176, 297, 35, 125, 0, 26, 86, 27, 21, 225, 299, 368, 353, 349, 66, 89, 136]"
108,15,4653,3693,7287,0,3412,1241,"[145, 196, 165, 55, 260, 82, 119, 358, 79, 143, 369, 195, 218, 133, 0, 11, 59, 311, 169, 96, 264, 368, 139, 163, 35, 361, 269]"
109,15,4748,5236,6799,0,4497,251,"[21, 48, 44, 40, 36, 43, 76, 18, 75, 68, 14, 35, 39, 10, 0, 72, 25, 56, 58, 29, 76, 8, 73, 61, 76, 43, 75]"
110,15,4113,1264,9648,0,2110,2003,"[481, 576, 378, 442, 97, 578, 393, 302, 470, 7, 550, 610, 105, 527, 0, 656, 84, 113, 300, 441, 27, 186, 580, 603, 22, 633, 551]"
111,15,3895,5171,8372,0,1069,2826,"[433, 97, 724, 549, 559, 368, 604, 388, 288, 17, 1, 254, 83, 578, 0, 665, 453, 496, 595, 710, 474, 867, 806, 156, 241, 557, 598]"
112,15,3926,6029,6269,0,3576,350,"[59, 82, 69, 21, 27, 115, 63, 95, 84, 85, 52, 88, 33, 105, 0, 23, 77, 69, 75, 99, 101, 93, 105, 82, 83, 90, 103]"
113,15,4657,533,10000,393,1062,3595,"[1011, 741, 396, 420, 935, 509, 689, 911, 340, 71, 262, 1197, 930, 1124, 0, 319, 153, 960, 644, 428, 604, 294, 118, 966, 185, 1140, 1106]"
114,15,3244,6306,6938,0,1691,1553,"[160, 27, 164, 98, 9, 412, 9, 35, 120, 182, 334, 444, 306, 18, 0, 327, 308, 291, 3, 342, 463, 0, 190, 388, 29, 248, 208]"
115,15,4888,6368,5458,0,864,4024,"[150, 589, 1301, 147, 519, 891, 764, 1063, 286, 427, 327, 916, 1117, 884, 0, 414, 1303, 363, 1200, 775, 19, 1016, 885, 2, 701, 921, 874]"
116,15,4789,499,9748,0,2478,2311,"[363, 161, 621, 455, 329, 594, 159, 640, 99, 582, 238, 461, 549, 221, 0, 663, 182, 181, 31, 151, 507, 665, 227, 344, 144, 433, 610]"
117,15,3924,6955,6717,0,2629,1295,"[25, 421, 175, 121, 114, 311, 259, 326, 122, 260, 402, 144, 206, 312, 0, 418, 211, 0, 326, 50, 74, 291, 320, 427, 123, 4, 205]"
118,15,4558,7063,4212,0,1344,3214,"[928, 643, 559, 616, 871, 568, 412, 334, 221, 528, 291, 520, 633, 790, 0, 543, 148, 515, 672, 1024, 819, 532, 752, 373, 846, 271, 826]"
119,15,3591,2655,5148,0,627,2964,"[782, 741, 502, 914, 107, 936, 74, 740, 898, 76, 821, 680, 70, 354, 0, 236, 564, 568, 174, 383, 730, 189, 503, 16, 341, 530, 409]"
120,15,4515,3514,6149,0,2096,2419,"[795, 694, 26, 180, 715, 140, 484, 430, 148, 336, 75, 22, 339, 541, 0, 593, 425, 1, 519, 126, 515, 24, 72, 180, 263, 806, 264]"
121,15,3121,337,8933,0,1617,1504,"[139, 360, 269, 156, 40, 254, 170, 388, 398, 11, 491, 452, 140, 213, 0, 283, 337, 352, 336, 349, 155, 284, 54, 441, 136, 371, 70]"
122,15,4832,7406,6359,0,4214,618,"[3, 108, 94, 181, 184, 126, 72, 165, 151, 40, 13, 174, 74, 40, 0, 69, 154, 102, 93, 56, 204, 73, 168, 150, 43, 187, 161]"
123,15,4763,6084,5038,0,2963,1800,"[431, 109, 346, 183, 468, 317, 454, 49, 149, 48, 168, 160, 377, 182, 0, 491, 152, 94, 27, 203, 124, 58, 13, 60, 257, 49, 412]"
124,15,3636,1758,6916,0,429,3207,"[884, 646, 458, 112, 408, 595, 740, 800, 831, 657, 1035, 817, 1012, 322, 0, 833, 23, 148, 9, 41, 472, 323, 694, 1019, 492, 254, 835]"
125,15,3321,1813,8424,0,826,2495,"[42, 571, 156, 818, 64, 438, 356, 288, 404, 139, 554, 438, 720, 214, 0, 708, 389, 241, 389, 636, 651, 392, 644, 280, 544, 425, 694]"
126,15,3715,6824,5315,0,2191,1524,"[298, 168, 474, 19, 74, 85, 97, 152, 192, 305, 226, 371, 442, 326, 0, 158, 435, 388, 294, 297, 431, 446, 427, 313, 61, 128, 258]"
127,15,4051,1822,7544,0,2925,1126,"[62, 268, 225, 38, 180, 355, 291, 44, 350, 157, 27, 195, 322, 146, 0, 53, 247, 86, 122, 233, 18, 255, 251, 180, 322, 190, 90]"
128,15,4149,6737,4956,0,3863,286,"[85, 54, 41, 10, 47, 47, 20, 9, 44, 32, 44, 86, 91, 59, 0, 66, 65, 21, 23, 5, 22, 23, 30, 27, 27, 13, 10]"
129,15,4236,1398,7794,0,1749,2487,"[428, 676, 127, 320, 421, 427, 532, 21, 151, 269, 408, 595, 460, 503, 0, 455, 25, 710, 274, 75, 457, 543, 573, 440, 693, 152, 723]"
130,15,4125,6057,5862,0,602,3523,"[1059, 130, 381, 30, 56, 687, 1007, 671, 301, 104, 916, 380, 903, 945, 0, 549, 468, 356, 423, 464, 243, 880, 768, 367, 882, 226, 113]"
131,15,4709,3193,7378,0,337,4372,"[394, 1452, 822, 649, 751, 563, 131, 474, 1131, 664, 437, 1033, 218, 640, 0, 1449, 840, 631, 936, 366, 349, 736, 531, 550, 1062, 1145, 621]"
132,15,3585,404,10000,559,150,3435,"[152, 1087, 1037, 923, 906, 744, 185, 280, 794, 868, 497, 32, 401, 1066, 0, 76, 906, 823, 858, 257, 851, 492, 432, 1121, 271, 737, 647]"
133,15,4027,6267,7760,0,3031,996,"[41, 235, 235, 119, 6, 79, 62, 64, 135, 57, 280, 120, 327, 56, 0, 312, 299, 46, 297, 99, 325, 302, 36, 294, 115, 225, 59]"
134,15,3844,6241,5363,0,1391,2453,"[712, 663, 587, 12, 140, 790, 41, 724, 349, 153, 305, 127, 745, 437, 0, 412, 568, 361, 600, 620, 245, 71, 634, 152, 500, 781, 779]"
135,15,3802,2944,6221,0,3726,76,"[15, 3, 9, 14, 18, 17, 19, 23, 18, 6, 8, 19, 5, 10, 0, 13, 22, 21, 14, 16, 24, 2, 0, 24, 1, 21, 6]"
136,15,3597,1478,8340,0,269,3328,"[91, 902, 472, 924, 441, 810, 273, 118, 284, 1049, 752, 86, 432, 54, 0, 1001, 710, 451, 1023, 1008, 173, 333, 12, 140, 709, 267, 1011]"
137,15,4961,7430,5871,0,895,4066,"[272, 135, 55, 11, 756, 27, 664, 328, 743, 1086, 324, 638, 62, 1133, 0, 1080, 855, 100, 76, 363, 1137, 694, 711, 1188, 783, 417, 287]"
138,15,4021,2560,7332,0,3330,691,"[173, 121, 101, 3, 78, 3, 147, 205, 127, 60, 199, 192, 205, 54, 0, 79, 41, 96, 230, 207, 55, 140, 12, 142, 72, 47, 25]"
139,15,4910,5927,6315,0,2440,2470,"[554, 626, 426, 501, 498, 276, 129, 678, 153, 228, 74, 165, 250, 120, 0, 750, 469, 500, 515, 140, 383, 332, 514, 249, 576, 32, 651]"
140,15,4291,3274,7332,0,1036,3255,"[107, 579, 61, 43, 687, 949, 1068, 365, 129, 1077, 363, 1065, 505, 112, 0, 501, 133, 1035, 741, 199, 736, 231, 724, 30, 185, 917, 372]"
141,15,4097,6024,5405,0,2948,1149,"[152, 131, 219, 211, 53, 374, 59, 46, 298, 161, 32, 39, 306, 76, 0, 103, 354, 310, 83, 142, 182, 364, 119, 75, 262, 288, 186]"
142,15,3421,1505,7321,0,3330,91,"[17, 29, 4, 10, 9, 23, 18, 18, 0, 27, 23, 2, 9, 26, 0, 3, 1, 30, 13, 5, 0, 5, 30, 7, 24, 0, 19]"
143,15,3675,1247,9749,0,1202,2473,"[488, 804, 597, 139, 397, 154, 387, 98, 718, 146, 141, 120, 730, 201, 0, 226, 221, 459, 166, 781, 346, 398, 564, 644, 818, 807, 108]"
144,15,4854,6102,8501,0,1624,3230,"[586, 884, 731, 187, 569, 697, 634, 464, 394, 648, 258, 151, 187, 1012, 0, 931, 932, 10, 678, 482, 912, 799, 645, 73, 695, 834, 278]"
145,15,4773,6396,6878,0,35,4738,"[728, 1333, 832, 438, 628, 666, 1116, 1293, 1473, 675, 1132, 1384, 31, 592, 0, 1299, 224, 851, 1031, 149, 1441, 743, 524, 1194, 797, 631, 1179]"
146,15,3605,482,10000,1,1447,2158,"[249, 336, 313, 83, 459, 541, 684, 274, 471, 44, 605, 639, 513, 267, 0, 688, 504, 417, 428, 389, 506, 106, 486, 568, 391, 485, 96]"
147,15,3861,6586,7275,0,2724,1137,"[191, 106, 345, 0, 98, 137, 181, 191, 240, 18, 102, 313, 24, 254, 0, 201, 109, 180, 104, 133, 207, 358, 106, 293, 164, 132, 54]"
148,15,4347,6047,5575,0,2700,1647,"[495, 85, 507, 164, 389, 67, 307, 211, 470, 502, 383, 0, 191, 129, 0, 169, 34, 315, 421, 71, 116, 379, 519, 403, 31, 243, 519]"
149,15,3083,2667,5991,0,975,2108,"[309, 663, 149, 126, 653, 603, 266, 569, 48, 560, 531, 322, 512, 542, 0, 601, 426, 319, 565, 420, 379, 483, 27, 170, 498, 561, 222]"
150,15,3140,2689,6442,0,1834,1306,"[103, 112, 344, 335, 46, 316, 99, 61, 351, 149, 189, 362, 71, 273, 0, 122, 210, 380, 228, 197, 193, 152, 5, 106, 322, 48, 293]"
151,15,3648,3629,6461,0,2950,698,"[39, 131, 25, 202, 80, 178, 206, 119, 133, 64, 0, 59, 84, 193, 0, 210, 165, 58, 12, 37, 53, 151, 208, 208, 76, 67, 27]"
152,15,3140,1068,8533,0,271,2869,"[324, 235, 41, 498, 606, 710, 36, 529, 707, 570, 8, 833, 839, 139, 0, 940, 492, 315, 450, 815, 155, 707, 340, 692, 104, 332, 501]"
153,15,4698,6976,6255,0,866,3832,"[442, 315, 408, 1053, 1085, 722, 407, 237, 457, 16, 195, 139, 831, 1253, 0, 1077, 264, 1226, 494, 414, 216, 1008, 365, 97, 540, 320, 1246]"
154,15,3255,2054,7456,0,1245,2010,"[396, 365, 342, 138, 51, 159, 129, 451, 259, 487, 10, 414, 412, 358, 0, 349, 386, 403, 370, 56, 633, 222, 541, 282, 263, 42, 448]"
155,15,3522,2679,8299,0,64,3458,"[1151, 248, 187, 780, 590, 85, 528, 387, 1151, 1099, 892, 221, 27, 959, 0, 692, 389, 377, 1016, 138, 1031, 830, 331, 388, 440, 495, 317]"
156,15,3475,7276,4498,0,414,3061,"[542, 442, 601, 150, 908, 21, 335, 113, 543, 210, 54, 557, 660, 699, 0, 469, 183, 348, 969, 914, 950, 519, 621, 967, 874, 682, 576]"
157,15,4700,3231,5967,0,4661,39,"[4, 4, 6, 7, 7, 4, 13, 10, 9, 2, 11, 10, 6, 0, 0, 1, 10, 2, 6, 5, 9, 3, 13, 2, 0, 11, 3]"
158,15,3904,403,9468,0,2226,1678,"[158, 35, 240, 288, 370, 329, 150, 366, 235, 296, 547, 74, 532, 258, 0, 455, 375, 430, 127, 435, 404, 288, 515, 9, 354, 536, 353]"
159,15,4069,5205,8332,0,1737,2332,"[500, 668, 702, 210, 452, 95, 475, 616, 655, 399, 306, 570, 427, 452, 0, 755, 167, 740, 149, 577, 244, 37, 438, 721, 522, 82, 597]"
160,15,4319,6076,6575,0,4156,163,"[47, 2, 13, 33, 32, 6, 50, 38, 41, 39, 22, 6, 34, 22, 0, 42, 26, 41, 7, 38, 2, 1, 43, 42, 8, 49, 11]"
161,15,3458,873,9160,0,117,3341,"[42, 119, 214, 383, 1065, 417, 143, 659, 247, 548, 46, 947, 785, 793, 0, 531, 162, 32, 102, 617, 766, 185, 130, 606, 648, 953, 927]"
162,15,3000,5715,6445,0,2115,885,"[236, 254, 243, 148, 125, 100, 184, 43, 29, 84, 50, 33, 46, 275, 0, 175, 225, 269, 59, 228, 241, 289, 157, 40, 230, 35, 29]"
163,15,3397,2591,7251,0,1530,1867,"[321, 567, 191, 391, 493, 122, 540, 420, 292, 373, 608, 252, 140, 431, 0, 385, 386, 208, 291, 421, 435, 121, 168, 349, 301, 586, 360]"
164,15,3920,5390,5781,0,970,2950,"[922, 959, 348, 240, 240, 149, 563, 726, 882, 573, 375, 841, 256, 520, 0, 262, 856, 310, 48, 164, 482, 195, 698, 44, 324, 730, 356]"
165,15,4741,3992,6530,0,2957,1784,"[429, 87, 211, 469, 577, 376, 459, 305, 190, 165, 391, 335, 47, 449, 0, 418, 264, 333, 77, 165, 244, 572, 287, 11, 78, 505, 155]"
166,15,3519,1547,8502,0,643,2876,"[725, 470, 730, 276, 758, 25, 720, 784, 765, 62, 305, 817, 249, 812, 0, 621, 306, 271, 313, 226, 948, 927, 392, 305, 166, 302, 384]"
167,15,3174,5119,6557,0,2300,874,"[169, 8, 257, 2, 154, 50, 12, 280, 217, 30, 33, 254, 244, 257, 0, 54, 270, 102, 163, 214, 246, 117, 263, 249, 138, 10, 181]"
168,15,4094,2341,8310,0,3039,1055,"[194, 198, 73, 103, 261, 3, 65, 155, 129, 62, 209, 342, 187, 2, 0, 228, 138, 34, 220, 149, 151, 32, 38, 249, 237, 69, 24]"
169,15,3248,6972,4586,0,1881,1367,"[141, 221, 49, 264, 390, 358, 7, 293, 35, 15, 277, 246, 81, 222, 0, 242, 3, 392, 123, 128, 264, 75, 324, 215, 250, 157, 347]"
170,15,3790,2253,6123,0,933,2857,"[356, 944, 847, 892, 556, 874, 710, 417, 159, 448, 244, 439, 923, 938, 0, 897, 824, 534, 28, 938, 618, 565, 580, 769, 741, 907, 185]"
171,15,4590,2299,8414,0,2509,2081,"[79, 398, 596, 389, 197, 291, 495, 380, 683, 67, 453, 304, 183, 123, 0, 646, 491, 168, 136, 676, 513, 543, 440, 666, 380, 351, 156]"
172,15,3017,5575,5856,0,1672,1345,"[413, 309, 190, 422, 207, 5, 341, 167, 221, 153, 184, 358, 288, 368, 0, 57, 314, 198, 348, 402, 168, 233, 358, 439, 147, 376, 328]"
173,15,4581,3030,7407,0,4043,538,"[120, 89, 45, 157, 6, 157, 78, 5, 119, 30, 125, 129, 133, 56, 0, 2, 68, 27, 175, 138, 162, 103, 128, 54, 95, 136, 123]"
174,15,3281,1802,8886,0,446,2835,"[141, 573, 246, 732, 772, 684, 294, 908, 498, 799, 32, 841, 935, 906, 0, 517, 532, 656, 637, 298, 22, 83, 736, 16, 216, 292, 285]"
175,15,3045,5904,6027,0,1213,1832,"[72, 150, 277, 182, 601, 35, 524, 87, 311, 481, 550, 538, 365, 334, 0, 34, 42, 366, 169, 487, 362, 528, 342, 111, 395, 74, 307]"
176,15,3887,116,9798,0,2337,1550,"[424, 26, 175, 501, 15, 132, 278, 212, 160, 501, 164, 334, 441, 174, 0, 329, 98, 480, 79, 372, 208, 113, 347, 221, 383, 61, 186]"
177,15,4763,5787,8774,0,1417,3346,"[224, 143, 794, 897, 460, 622, 16, 1084, 739, 604, 294, 908, 474, 65, 0, 665, 181, 654, 595, 251, 1063, 423, 101, 781, 962, 227, 514]"
178,15,3726,5972,6528,0,2387,1339,"[76, 177, 430, 316, 202, 148, 149, 93, 160, 414, 90, 54, 87, 313, 0, 292, 433, 369, 51, 134, 318, 401, 38, 60, 414, 92, 127]"
179,15,4546,5389,5685,0,1102,3444,"[407, 637, 635, 854, 986, 844, 1062, 413, 781, 743, 165, 488, 861, 627, 0, 964, 348, 130, 105, 468, 592, 126, 761, 482, 892, 136, 1092]"
180,15,4698,3779,6604,0,761,3937,"[1276, 678, 1105, 694, 220, 327, 500, 310, 498, 458, 84, 1027, 809, 1162, 0, 570, 845, 286, 149, 851, 916, 946, 714, 982, 911, 229, 968]"
181,15,4301,2197,8708,0,3886,415,"[96, 120, 124, 68, 98, 57, 26, 89, 112, 2, 98, 121, 104, 98, 0, 24, 77, 42, 133, 28, 28, 106, 80, 127, 134, 41, 133]"
182,15,3227,7104,4831,0,2150,1077,"[70, 81, 352, 24, 323, 217, 107, 174, 59, 147, 74, 10, 275, 261, 0, 260, 329, 84, 126, 293, 78, 58, 119, 260, 347, 81, 290]"
183,15,3329,21,8139,0,2831,498,"[134, 140, 24, 73, 18, 97, 32, 1, 85, 154, 147, 99, 45, 3, 0, 64, 96, 142, 153, 59, 98, 114, 143, 114, 77, 11, 46]"
184,15,3486,5937,5688,0,2586,900,"[4, 35, 46, 74, 54, 59, 197, 202, 136, 190, 269, 76, 284, 95, 0, 74, 123, 275, 65, 8, 255, 257, 205, 33, 197, 136, 27]"
185,15,3377,2519,6546,0,1002,2375,"[456, 412, 675, 384, 92, 771, 355, 314, 596, 187, 531, 649, 628, 117, 0, 610, 585, 376, 264, 40, 490, 653, 641, 485, 525, 377, 359]"
186,15,4685,5063,6168,0,2043,2642,"[11, 555, 416, 528, 308, 257, 186, 398, 465, 182, 151, 299, 376, 389, 0, 161, 655, 554, 160, 223, 51, 237, 241, 136, 569, 315, 519]"
187,15,4156,3938,6386,0,3075,1081,"[62, 35, 253, 134, 57, 78, 135, 319, 353, 313, 206, 281, 9, 7, 0, 359, 112, 76, 225, 352, 294, 345, 24, 188, 183, 25, 155]"
188,15,4793,6632,4547,0,3057,1736,"[496, 433, 401, 351, 210, 212, 261, 211, 52, 328, 309, 278, 44, 127, 0, 291, 223, 383, 9, 245, 96, 385, 160, 455, 207, 41, 20]"
189,15,4771,596,8722,0,4665,106,"[30, 28, 12, 13, 26, 18, 3, 26, 21, 7, 0, 11, 13, 25, 0, 28, 22, 4, 8, 0, 5, 7, 31, 19, 34, 29, 14]"
190,15,3245,6456,5511,0,1043,2202,"[676, 216, 282, 355, 210, 496, 318, 92, 7, 701, 376, 23, 328, 676, 0, 123, 138, 462, 534, 98, 94, 202, 101, 156, 476, 589, 174]"
191,15,3931,104,9338,0,1322,2609,"[133, 701, 31, 401, 103, 659, 655, 802, 584, 257, 706, 488, 406, 821, 0, 748, 55, 693, 333, 77, 86, 120, 465, 157, 306, 812, 840]"
192,15,4149,5325,8162,0,4017,132,"[39, 21, 43, 39, 14, 44, 14, 28, 1, 6, 14, 39, 5, 22, 0, 21, 7, 29, 37, 41, 34, 40, 32, 14, 6, 24, 39]"
193,15,3926,6444,5644,0,53,3873,"[1059, 828, 1157, 925, 805, 748, 1059, 245, 1263, 764, 600, 1244, 302, 857, 0, 787, 507, 526, 120, 485, 228, 1089, 1043, 289, 1097, 37, 1156]"
194,15,4384,2168,7860,0,424,3960,"[512, 571, 1019, 966, 969, 377, 458, 581, 160, 1297, 892, 863, 336, 346, 0, 858, 23, 175, 918, 1175, 969, 322, 1242, 181, 214, 224, 72]"
195,15,4382,6828,5414,0,1104,3278,"[27, 190, 447, 1087, 634, 24, 770, 348, 898, 642, 205, 485, 482, 1079, 0, 1061, 902, 141, 1066, 200, 518, 351, 57, 129, 608, 345, 649]"
196,15,3234,2538,6110,0,1339,1895,"[401, 366, 179, 318, 607, 30, 164, 546, 324, 221, 7, 532, 371, 227, 0, 383, 73, 283, 113, 283, 426, 487, 273, 269, 388, 404, 236]"
197,15,3677,160,9627,0,400,3277,"[134, 317, 580, 540, 1005, 179, 695, 263, 341, 622, 643, 759, 736, 244, 0, 500, 480, 443, 579, 271, 193, 25, 413, 494, 666, 216, 606]"
198,15,4693,6204,8116,0,53,4640,"[228, 1283, 893, 818, 1330, 190, 451, 154, 27, 17, 1475, 1537, 867, 1217, 0, 660, 103, 1200, 1471, 473, 967, 260, 602, 1179, 722, 1483, 860]"
199,15,3305,7101,4320,0,1727,1578,"[388, 64, 287, 107, 353, 7, 244, 215, 476, 219, 472, 293, 239, 47, 0, 262, 411, 263, 78, 55, 211, 203, 220, 349, 509, 81, 439]"
200,15,4891,1803,7408,0,2322,2569,"[94, 757, 378, 35, 543, 111, 811, 635, 653, 28, 371, 493, 768, 497, 0, 63, 538, 540, 759, 36, 738, 209, 828, 738, 641, 403, 465]"
201,15,4928,5905,6431,0,2163,2765,"[522, 131, 294, 690, 808, 123, 878, 385, 242, 745, 908, 153, 672, 723, 0, 26, 424, 53, 522, 183, 865, 541, 59, 670, 874, 881, 809]"
202,15,4543,4356,6618,0,2593,1950,"[18, 529, 176, 525, 334, 34, 25, 571, 50, 351, 518, 451, 234, 643, 0, 69, 227, 347, 555, 543, 44, 585, 508, 602, 171, 133, 302]"
203,15,3221,2748,7091,0,2159,1062,"[53, 222, 90, 13, 310, 12, 277, 329, 103, 10, 14, 20, 258, 93, 0, 163, 232, 34, 178, 250, 330, 251, 15, 139, 66, 332, 209]"
204,15,4218,6957,4352,0,2772,1446,"[322, 410, 283, 48, 197, 309, 293, 1, 279, 67, 332, 394, 187, 147, 0, 390, 148, 445, 391, 406, 190, 386, 82, 368, 428, 302, 423]"
205,15,3861,2262,5951,0,577,3284,"[876, 371, 52, 55, 826, 104, 525, 296, 371, 431, 511, 27, 1081, 936, 0, 656, 805, 555, 844, 213, 654, 33, 573, 763, 638, 626, 611]"
206,15,4521,38,10000,434,2550,1971,"[314, 442, 68, 141, 604, 240, 388, 560, 397, 251, 280, 543, 596, 410, 0, 43, 411, 49, 233, 314, 268, 130, 342, 434, 219, 313, 221]"
207,15,3521,6342,7179,0,2167,1354,"[245, 291, 239, 223, 287, 273, 152, 75, 392, 323, 177, 357, 426, 54, 0, 378, 327, 88, 157, 407, 318, 385, 181, 120, 150, 120, 235]"
208,15,4299,7364,4114,0,1383,2916,"[544, 196, 628, 647, 189, 446, 58, 574, 576, 13, 122, 297, 694, 321, 0, 246, 100, 50, 501, 372, 133, 925, 3, 122, 362, 686, 856]"
209,15,3429,2840,4703,0,2840,589,"[29, 63, 13, 185, 80, 193, 190, 117, 67, 67, 81, 173, 65, 84, 0, 48, 31, 168, 173, 54, 47, 135, 126, 94, 137, 14, 150]"
210,15,3377,906,7174,0,3347,30,"[10, 7, 5, 4, 5, 8, 10, 5, 8, 4, 1, 5, 3, 1, 0, 10, 1, 0, 1, 6, 10, 8, 8, 5, 4, 0, 5]"
211,15,4851,6168,5857,0,2695,2156,"[340, 106, 593, 125, 349, 238, 228, 81, 592, 196, 251, 260, 304, 98, 0, 623, 492, 270, 71, 17, 250, 449, 140, 601, 318, 414, 276]"
212,15,4812,2630,8039,0,4690,122,"[15, 2, 32, 17, 9, 11, 19, 34, 13, 0, 29, 19, 2, 19, 0, 15, 15, 29, 21, 13, 36, 19, 17, 40, 24, 7, 8]"
213,15,3399,6250,5188,0,1128,2271,"[179, 555, 2, 470, 653, 343, 612, 227, 156, 96, 101, 323, 718, 595, 0, 673, 684, 357, 369, 634, 517, 393, 618, 86, 685, 423, 751]"
214,15,3432,3196,5424,0,3030,402,"[93, 32, 20, 71, 23, 19, 34, 75, 33, 69, 111, 38, 0, 111, 0, 58, 107, 37, 121, 8, 70, 69, 57, 119, 27, 48, 97]"
215,15,3418,2306,6536,0,838,2580,"[276, 761, 497, 122, 129, 312, 702, 567, 650, 609, 575, 72, 844, 818, 0, 713, 255, 70, 578, 530, 469, 746, 510, 541, 818, 432, 106]"
216,15,3194,1044,8686,0,1247,1947,"[33, 515, 230, 444, 255, 478, 234, 354, 152, 120, 288, 287, 537, 518, 0, 419, 76, 628, 209, 385, 101, 401, 203, 149, 294, 224, 392]"
217,15,4297,6627,6356,0,128,4169,"[699, 165, 1126, 608, 934, 24, 1110, 263, 86, 381, 1240, 864, 1084, 1229, 0, 758, 480, 51, 429, 1338, 490, 100, 1111, 323, 819, 611, 1125]"
218,15,3844,76,10000,124,3660,184,"[37, 35, 29, 7, 53, 44, 24, 18, 18, 19, 40, 13, 14, 37, 0, 25, 40, 50, 14, 19, 1, 60, 11, 27, 44, 53, 47]"
219,15,4072,7283,6789,0,2641,1431,"[218, 391, 173, 92, 50, 231, 313, 392, 5, 369, 16, 38, 463, 349, 0, 69, 433, 6, 260, 232, 461, 182, 189, 123, 66, 434, 173]"
220,15,3626,3596,6819,0,687,2939,"[966, 327, 289, 299, 250, 394, 411, 422, 740, 542, 869, 940, 217, 665, 0, 462, 465, 814, 572, 847, 620, 109, 265, 549, 9, 517, 362]"
221,15,3191,1242,8768,0,850,2341,"[754, 760, 26, 138, 417, 437, 260, 147, 231, 552, 401, 644, 96, 168, 0, 404, 395, 347, 356, 505, 235, 711, 738, 517, 150, 170, 453]"
222,15,4920,6739,6949,0,943,3977,"[356, 205, 1095, 486, 802, 80, 1204, 1324, 346, 1297, 909, 505, 690, 770, 0, 129, 898, 1225, 948, 921, 931, 208, 314, 1008, 939, 1307, 723]"
223,15,3404,1608,8745,0,702,2702,"[724, 37, 601, 620, 608, 462, 819, 766, 219, 693, 846, 357, 838, 261, 0, 668, 669, 102, 807, 58, 153, 534, 398, 603, 826, 819, 565]"
224,15,3116,6035,5826,0,2803,313,"[86, 16, 21, 99, 11, 47, 93, 77, 70, 89, 55, 36, 65, 46, 0, 52, 14, 58, 9, 71, 50, 5, 101, 15, 96, 24, 9]"
225,15,4424,2038,8212,0,3934,490,"[48, 53, 8, 11, 110, 155, 103, 37, 90, 39, 109, 143, 72, 66, 0, 6, 130, 31, 3, 7, 117, 66, 48, 121, 107, 31, 142]"
226,15,4551,5402,7361,0,218,4333,"[208, 953, 731, 589, 1220, 311, 801, 304, 578, 590, 923, 984, 1019, 777, 0, 963, 1410, 1216, 662, 93, 1258, 885, 309, 782, 284, 349, 347]"
227,15,4151,5107,6405,0,2618,1533,"[222, 479, 286, 500, 424, 366, 102, 91, 271, 173, 102, 273, 20, 86, 0, 203, 311, 27, 200, 81, 280, 309, 317, 297, 350, 337, 256]"
228,15,3897,304,9998,0,1467,2430,"[136, 514, 97, 75, 111, 483, 654, 89, 745, 478, 235, 610, 0, 759, 0, 363, 35, 409, 286, 383, 334, 596, 451, 670, 369, 694, 380]"
229,15,3530,7338,6190,0,2566,964,"[147, 256, 51, 243, 59, 207, 37, 11, 160, 97, 193, 187, 84, 60, 0, 119, 303, 51, 125, 60, 258, 258, 3, 16, 26, 99, 22]"
230,15,3719,2538,7371,0,2845,874,"[60, 132, 273, 242, 159, 25, 165, 42, 198, 113, 95, 204, 207, 229, 0, 36, 255, 235, 80, 46, 51, 119, 217, 39, 222, 264, 15]"
231,15,4687,6765,5293,0,500,4187,"[1182, 748, 362, 94, 455, 795, 359, 955, 1029, 1007, 1219, 310, 909, 1123, 0, 1090, 1349, 790, 958, 730, 366, 174, 602, 940, 227, 1177, 452]"
232,15,3461,308,8446,0,2130,1331,"[189, 400, 327, 100, 3, 71, 20, 143, 248, 240, 434, 296, 150, 427, 0, 408, 335, 441, 203, 178, 225, 199, 237, 155, 11, 293, 133]"
233,15,3509,6487,5468,0,602,2907,"[718, 907, 296, 344, 918, 132, 964, 282, 393, 64, 602, 417, 230, 298, 0, 751, 609, 890, 405, 875, 70, 796, 316, 517, 184, 241, 143]"
234,15,4763,2976,7255,0,1896,2867,"[719, 565, 52, 666, 850, 432, 478, 271, 801, 624, 827, 687, 37, 384, 0, 868, 790, 275, 529, 148, 864, 384, 542, 890, 183, 645, 499]"
235,15,4412,5204,6463,0,2564,1848,"[120, 6, 264, 282, 299, 94, 429, 129, 465, 24, 183, 59, 526, 214, 0, 395, 564, 228, 100, 603, 268, 396, 332, 318, 287, 470, 225]"
236,15,4193,2560,8096,0,2906,1287,"[236, 185, 293, 148, 223, 99, 190, 120, 394, 316, 21, 230, 365, 56, 0, 273, 394, 42, 383, 85, 196, 335, 18, 20, 92, 192, 335]"
237,15,3040,7105,4031,0,668,2372,"[716, 226, 243, 292, 35, 49, 616, 60, 258, 294, 172, 768, 665, 697, 0, 788, 776, 2, 148, 1, 767, 416, 206, 163, 7, 452, 642]"
238,15,4618,1628,7021,0,3117,1501,"[316, 340, 110, 391, 369, 435, 174, 76, 329, 363, 473, 309, 264, 190, 0, 484, 215, 307, 405, 256, 447, 262, 405, 314, 279, 407, 464]"
239,15,3868,3533,7356,0,3270,598,"[58, 130, 165, 163, 190, 67, 71, 150, 88, 199, 199, 126, 145, 164, 0, 186, 18, 29, 161, 26, 148, 99, 172, 71, 151, 69, 169]"
240,15,4723,5759,6320,0,1503,3220,"[495, 833, 1025, 366, 425, 630, 516, 585, 356, 507, 415, 77, 183, 760, 0, 679, 97, 431, 747, 171, 1045, 420, 134, 874, 610, 391, 359]"
241,15,4534,2237,8617,0,3733,801,"[181, 36, 29, 231, 103, 48, 186, 251, 155, 91, 109, 89, 121, 180, 0, 49, 152, 21, 29, 120, 171, 224, 132, 223, 247, 102, 36]"
242,15,3673,6630,5660,0,672,3001,"[330, 957, 428, 244, 720, 924, 676, 4, 691, 97, 841, 347, 686, 408, 0, 195, 58, 587, 843, 470, 18, 50, 57, 775, 554, 754, 139]"
243,15,4888,4549,5999,0,1078,3810,"[563, 1033, 3, 822, 992, 580, 1178, 958, 1268, 898, 491, 496, 552, 559, 0, 464, 876, 39, 1174, 1165, 789, 397, 1113, 1060, 580, 391, 729]"
244,15,3156,1245,7910,0,2797,359,"[40, 59, 59, 39, 69, 77, 28, 63, 32, 24, 87, 101, 82, 60, 0, 97, 111, 6, 46, 78, 71, 19, 55, 94, 81, 60, 117]"
245,15,3878,7138,4650,0,142,3736,"[595, 289, 903, 214, 57, 387, 734, 564, 229, 125, 443, 927, 1001, 269, 0, 172, 969, 830, 1241, 845, 308, 135, 576, 1085, 433, 499, 753]"
246,15,3217,711,7156,0,1040,2177,"[156, 35, 335, 615, 574, 333, 190, 336, 499, 597, 150, 400, 97, 2, 0, 273, 520, 328, 142, 67, 703, 710, 43, 642, 565, 238, 607]"
247,15,3375,2440,8091,0,167,3208,"[825, 55, 531, 696, 205, 133, 514, 804, 625, 482, 812, 956, 261, 836, 0, 1014, 464, 463, 961, 848, 728, 661, 81, 895, 220, 297, 87]"
248,15,4538,7021,5608,0,1365,3173,"[604, 712, 376, 921, 948, 296, 610, 347, 51, 495, 209, 664, 1043, 52, 0, 565, 428, 252, 321, 571, 859, 74, 117, 602, 80, 421, 808]"
249,15,3506,2619,6495,0,992,2514,"[8, 788, 221, 48, 643, 658, 118, 476, 76, 107, 112, 287, 197, 703, 0, 610, 388, 67, 617, 122, 645, 338, 330, 27, 54, 798, 791]"
250,15,3239,2792,6942,0,2045,1194,"[19, 7, 121, 192, 220, 121, 245, 306, 322, 13, 47, 310, 15, 302, 0, 333, 341, 95, 175, 326, 144, 327, 268, 59, 124, 135, 22]"
251,15,4109,6570,4481,0,1852,2257,"[668, 588, 553, 311, 150, 255, 243, 13, 301, 401, 79, 571, 681, 156, 0, 742, 511, 76, 706, 745, 314, 546, 28, 158, 384, 503, 438]"
252,15,4344,998,7827,0,2856,1488,"[49, 419, 413, 283, 256, 313, 266, 128, 223, 295, 239, 365, 303, 94, 0, 469, 234, 293, 383, 62, 414, 131, 2, 435, 376, 408, 491]"
253,15,4984,7410,5401,0,761,4223,"[1002, 1095, 145, 714, 200, 342, 508, 267, 479, 244, 26, 869, 1013, 968, 0, 1216, 140, 1403, 117, 1387, 762, 515, 637, 500, 1273, 269, 1307]"
254,15,4117,1814,7704,0,299,3818,"[1112, 162, 293, 1241, 809, 112, 312, 553, 988, 405, 30, 805, 1089, 719, 0, 253, 1264, 418, 364, 542, 317, 1140, 762, 994, 586, 776, 514]"
255,15,4302,5345,6661,0,3070,1232,"[388, 364, 388, 112, 251, 26, 245, 301, 251, 52, 74, 187, 28, 401, 0, 163, 13, 16, 95, 237, 216, 318, 375, 69, 261, 155, 185]"
256,15,3097,2781,6977,0,2704,393,"[30, 104, 17, 82, 78, 30, 34, 73, 36, 84, 76, 3, 38, 20, 0, 13, 59, 130, 75, 50, 55, 105, 85, 18, 11, 98, 61]"
257,15,4238,6633,4582,0,2664,1574,"[442, 496, 309, 176, 143, 229, 500, 352, 124, 454, 46, 455, 75, 382, 0, 463, 150, 503, 280, 225, 20, 333, 276, 518, 331, 101, 468]"
258,15,4921,4230,5273,0,447,4474,"[580, 728, 575, 1168, 237, 521, 831, 179, 311, 594, 991, 1234, 833, 1037, 0, 1106, 1259, 1059, 505, 1149, 1387, 1334, 897, 176, 1009, 703, 1033]"
259,15,4101,3766,5608,0,3818,283,"[82, 92, 81, 1, 0, 23, 71, 14, 19, 2, 6, 21, 8, 31, 0, 77, 37, 89, 81, 88, 83, 79, 32, 70, 14, 3, 93]"
260,15,4562,562,9608,0,3528,1034,"[222, 309, 326, 129, 299, 211, 181, 91, 57, 137, 90, 264, 50, 240, 0, 152, 99, 277, 88, 246, 185, 82, 102, 309, 330, 262, 43]"
261,15,3155,5698,7065,0,1872,1283,"[350, 10, 114, 229, 279, 52, 130, 7, 348, 2, 77, 19, 91, 120, 0, 286, 338, 153, 75, 176, 78, 401, 304, 43, 425, 219, 58]"
262,15,4483,7396,4152,0,1437,3046,"[644, 109, 243, 35, 181, 155, 372, 270, 23, 285, 143, 35, 937, 166, 0, 221, 128, 696, 267, 889, 413, 903, 679, 918, 681, 348, 55]"
263,15,3950,1856,6246,0,2904,1046,"[68, 101, 149, 261, 211, 33, 300, 161, 306, 291, 230, 300, 339, 241, 0, 33, 144, 47, 62, 303, 29, 318, 55, 113, 178, 144, 28]"
264,15,3703,3422,6527,0,3276,427,"[131, 61, 141, 94, 128, 75, 35, 112, 51, 77, 55, 106, 81, 74, 0, 11, 54, 62, 111, 74, 18, 39, 86, 40, 84, 19, 68]"
265,15,4226,2113,8640,0,1438,2788,"[371, 95, 196, 89, 552, 766, 77, 912, 444, 299, 782, 806, 329, 183, 0, 252, 290, 674, 856, 477, 282, 556, 419, 531, 187, 726, 704]"
266,15,4602,6045,7197,0,3949,653,"[183, 52, 127, 8, 157, 148, 122, 126, 165, 74, 165, 52, 114, 13, 0, 138, 31, 136, 60, 145, 181, 122, 156, 49, 20, 85, 155]"
267,15,3380,2198,8379,0,2258,1122,"[187, 266, 261, 316, 215, 28, 300, 130, 13, 90, 333, 293, 54, 229, 0, 323, 186, 97, 81, 174, 298, 144, 85, 328, 259, 194, 80]"
268,15,3466,7013,4832,0,2579,887,"[139, 69, 240, 225, 179, 243, 115, 225, 257, 259, 199, 75, 106, 222, 0, 128, 287, 117, 110, 257, 92, 96, 260, 294, 28, 184, 163]"
269,15,4935,3044,6723,0,1998,2937,"[956, 694, 216, 113, 612, 178, 483, 340, 115, 645, 398, 183, 742, 33, 0, 875, 532, 83, 556, 730, 361, 810, 811, 174, 799, 573, 246]"
270,15,3147,1022,8848,0,1246,1901,"[503, 196, 60, 611, 15, 629, 450, 394, 34, 225, 441, 212, 57, 327, 0, 548, 142, 493, 478, 515, 36, 50, 66, 167, 575, 38, 495]"
271,15,3864,6239,6473,0,1230,2634,"[789, 544, 577, 717, 218, 128, 115, 105, 682, 64, 226, 106, 58, 442, 0, 278, 651, 755, 703, 626, 854, 49, 107, 531, 343, 344, 779]"
272,15,3230,2297,7406,0,1914,1316,"[295, 247, 242, 220, 435, 200, 66, 181, 299, 243, 199, 244, 332, 372, 0, 389, 345, 138, 380, 126, 63, 365, 224, 389, 353, 112, 315]"
273,15,3584,2176,8814,0,2299,1285,"[15, 94, 290, 78, 94, 413, 293, 427, 410, 427, 303, 289, 232, 197, 0, 375, 306, 111, 210, 61, 99, 152, 142, 306, 221, 315, 321]"
274,15,3650,6931,5533,0,3538,112,"[1, 12, 12, 37, 31, 17, 26, 35, 1, 19, 35, 0, 30, 1, 0, 18, 23, 34, 15, 33, 28, 2, 31, 8, 37, 13, 34]"
275,15,4028,1596,7965,0,1310,2718,"[784, 528, 862, 854, 905, 528, 680, 306, 746, 49, 75, 138, 54, 310, 0, 56, 92, 607, 293, 191, 739, 813, 692, 803, 442, 770, 472]"
276,15,4010,6517,5458,0,1787,2223,"[202, 281, 721, 288, 477, 514, 61, 685, 254, 406, 184, 19, 46, 560, 0, 567, 22, 725, 650, 131, 567, 653, 628, 314, 524, 703, 15]"
277,15,3841,524,8775,0,3271,570,"[171, 16, 188, 21, 151, 138, 187, 95, 183, 173, 166, 1, 70, 32, 0, 26, 165, 190, 49, 25, 143, 67, 139, 84, 52, 109, 13]"
278,15,4298,5050,8023,0,3261,1037,"[100, 69, 139, 103, 44, 33, 91, 273, 333, 227, 46, 308, 174, 250, 0, 264, 98, 14, 284, 320, 248, 14, 284, 129, 48, 115, 251]"
279,15,4553,7397,5179,0,1188,3365,"[331, 379, 111, 534, 271, 850, 688, 265, 357, 224, 76, 997, 97, 448, 0, 391, 507, 1049, 606, 277, 621, 920, 779, 41, 834, 69, 104]"
280,15,3291,2385,6085,0,1219,2072,"[221, 662, 522, 46, 164, 100, 414, 533, 44, 229, 95, 615, 204, 245, 0, 559, 646, 495, 171, 308, 127, 591, 173, 320, 384, 314, 141]"
281,15,3469,117,9437,0,890,2579,"[366, 681, 608, 173, 59, 768, 275, 360, 318, 418, 666, 510, 269, 767, 0, 439, 477, 479, 461, 681, 302, 42, 261, 50, 821, 294, 747]"
282,15,4697,7383,6751,0,2227,2470,"[715, 525, 687, 658, 102, 146, 97, 769, 315, 696, 811, 141, 351, 632, 0, 537, 102, 814, 641, 601, 794, 183, 729, 362, 570, 401, 15]"
283,15,4223,1863,9111,0,3311,912,"[33, 225, 205, 154, 12, 79, 226, 98, 130, 205, 294, 209, 27, 285, 0, 238, 97, 12, 253, 298, 201, 127, 211, 5, 284, 138, 140]"
284,15,4488,5326,8273,0,2719,1769,"[252, 378, 174, 289, 95, 506, 147, 554, 518, 87, 0, 284, 435, 484, 0, 31, 334, 168, 220, 308, 561, 431, 177, 501, 229, 187, 310]"
285,15,4494,6926,5841,0,1688,2806,"[331, 7, 286, 159, 220, 200, 730, 460, 4, 291, 539, 675, 728, 293, 0, 273, 402, 404, 623, 257, 276, 602, 131, 58, 770, 764, 546]"
286,15,4883,4125,6599,0,2649,2234,"[144, 374, 46, 61, 215, 336, 535, 152, 348, 527, 423, 284, 292, 363, 0, 671, 333, 445, 102, 6, 138, 64, 404, 523, 315, 403, 349]"
287,15,3143,3131,6611,0,1188,1955,"[447, 189, 287, 62, 334, 91, 83, 503, 478, 96, 381, 140, 235, 53, 0, 540, 553, 82, 169, 534, 235, 59, 456, 494, 266, 252, 403]"
288,15,4714,5739,5586,0,1933,2781,"[840, 740, 708, 877, 352, 878, 98, 691, 814, 31, 823, 541, 757, 91, 0, 131, 184, 5, 307, 367, 766, 848, 49, 30, 926, 672, 757]"
289,15,4257,3754,6089,0,2304,1953,"[647, 26, 494, 102, 626, 325, 46, 84, 222, 592, 269, 486, 322, 555, 0, 553, 104, 327, 299, 381, 258, 634, 470, 422, 111, 7, 640]"
290,15,3637,1556,8170,0,3046,591,"[150, 133, 195, 185, 185, 51, 0, 163, 72, 11, 37, 53, 31, 119, 0, 169, 44, 57, 58, 96, 120, 5, 143, 33, 2, 117, 65]"
291,15,4920,5113,7977,0,2284,2636,"[316, 837, 805, 757, 322, 815, 217, 466, 456, 99, 45, 89, 515, 271, 0, 230, 8, 817, 474, 46, 33, 148, 862, 846, 2, 242, 490]"
292,15,3146,7245,3878,0,2267,879,"[149, 166, 139, 7, 66, 265, 198, 199, 249, 200, 43, 238, 59, 13, 0, 113, 11, 24, 10, 44, 228, 77, 122, 23, 141, 180, 106]"
293,15,3995,2220,5653,0,525,3470,"[130, 36, 298, 364, 954, 595, 498, 733, 486, 764, 178, 913, 34, 38, 0, 276, 745, 934, 817, 721, 856, 739, 88, 795, 1112, 915, 417]"
294,15,3011,2201,6463,0,1215,1796,"[381, 111, 515, 528, 493, 441, 75, 391, 361, 321, 253, 525, 374, 506, 0, 226, 296, 308, 353, 277, 207, 351, 342, 463, 555, 9, 322]"
295,15,4422,3649,7236,0,3500,922,"[277, 134, 275, 44, 252, 216, 297, 75, 61, 264, 138, 30, 171, 73, 0, 273, 182, 80, 284, 102, 228, 220, 110, 266, 30, 219, 163]"
296,15,3883,6711,4408,0,1215,2668,"[508, 208, 169, 150, 261, 663, 650, 24, 228, 226, 589, 423, 545, 458, 0, 136, 643, 502, 370, 221, 483, 36, 427, 579, 23, 517, 30]"
297,15,3505,3134,4779,0,901,2604,"[836, 195, 264, 443, 776, 670, 459, 26, 256, 825, 305, 332, 511, 828, 0, 282, 218, 442, 842, 35, 675, 676, 825, 24, 33, 53, 510]"
298,15,4430,499,8710,0,1247,3183,"[53, 469, 219, 614, 740, 733, 527, 129, 962, 943, 946, 258, 584, 607, 0, 730, 978, 295, 266, 639, 849, 833, 202, 400, 736, 743, 984]"
299,15,3474,7493,4691,0,2566,908,"[10, 261, 26, 184, 34, 276, 125, 19, 15, 258, 166, 246, 120, 113, 0, 240, 205, 256, 282, 79, 288, 186, 192, 189, 286, 85, 246]"
0,16,4683,0,4683,0,1284,3399,"[932, 289, 631, 348, 15, 740, 743, 755, 918, 1081, 11, 442, 1123, 1103, 613, 0, 612, 128, 784, 150, 718, 839, 1123, 174, 625, 200, 706]"
1,16,4811,3865,5629,0,4607,204,"[31, 19, 0, 61, 16, 14, 17, 10, 12, 19, 55, 21, 51, 58, 32, 0, 25, 3, 37, 42, 34, 59, 58, 45, 57, 65, 44]"
2,16,3240,2568,6301,0,2564,676,"[16, 221, 126, 69, 221, 154, 73, 44, 83, 213, 50, 42, 150, 180, 7, 0, 107, 156, 205, 199, 59, 119, 0, 148, 121, 50, 18]"
3,16,4145,3659,6787,0,1385,2760,"[436, 261, 437, 113, 329, 282, 307, 187, 86, 169, 738, 377, 444, 609, 857, 0, 400, 369, 654, 457, 689, 722, 889, 261, 914, 208, 498]"
4,16,3593,707,9673,0,2788,805,"[260, 123, 239, 189, 27, 168, 99, 176, 24, 106, 148, 263, 245, 75, 237, 0, 39, 152, 250, 28, 185, 143, 90, 20, 32, 5, 125]"
5,16,4928,7342,7259,0,2452,2476,"[17, 127, 363, 435, 206, 460, 799, 117, 68, 413, 677, 284, 345, 530, 618, 0, 8, 160, 446, 742, 50, 422, 483, 590, 328, 624, 370]"
6,16,4180,5352,6087,0,791,3389,"[690, 318, 309, 973, 144, 1119, 350, 196, 364, 460, 693, 99, 688, 965, 948, 0, 740, 900, 686, 531, 810, 350, 810, 516, 273, 604, 908]"
7,16,3673,1624,8136,0,2407,1266,"[46, 297, 50, 326, 348, 347, 237, 173, 187, 359, 81, 33, 72, 51, 191, 0, 83, 358, 105, 300, 72, 99, 376, 310, 74, 74, 211]"
8,16,3181,6183,5134,0,1195,1986,"[262, 166, 128, 232, 164, 315, 624, 500, 603, 337, 425, 324, 530, 512, 72, 0, 613, 9, 141, 291, 502, 268, 51, 281, 539, 472, 183]"
9,16,4125,3056,6203,0,291,3834,"[654, 942, 997, 1025, 269, 788, 297, 939, 1231, 777, 54, 0, 72, 211, 1115, 0, 951, 132, 283, 1084, 192, 728, 661, 856, 966, 460, 780]"
10,16,4692,4076,6819,0,744,3948,"[1271, 803, 1137, 1074, 1213, 141, 386, 302, 1005, 1243, 836, 883, 51, 527, 98, 0, 198, 368, 575, 154, 115, 958, 1244, 12, 989, 482, 167]"
11,16,3827,2238,8408,0,2270,1557,"[432, 307, 382, 26, 479, 119, 11, 269, 201, 36, 519, 435, 10, 158, 257, 0, 419, 46, 288, 27, 442, 405, 84, 243, 357, 436, 275]"
12,16,4609,6418,6599,0,4504,105,"[12, 22, 11, 4, 9, 1, 0, 34, 7, 30, 15, 20, 13, 16, 10, 0, 21, 34, 35, 6, 13, 13, 13, 16, 8, 31, 10]"
13,16,3883,1667,8815,0,1017,2866,"[37, 869, 949, 348, 330, 252, 166, 558, 355, 584, 800, 246, 368, 480, 194, 0, 911, 857, 126, 234, 374, 374, 162, 427, 659, 664, 924]"
14,16,4910,7348,6377,0,460,4450,"[1204, 130, 132, 1122, 1074, 108, 1184, 332, 1045, 145, 1064, 1264, 1198, 369, 1200, 0, 828, 386, 858, 22, 1413, 211, 1042, 660, 1268, 119, 1406]"
15,16,4528,3735,7170,0,4026,502,"[112, 5, 129, 70, 154, 47, 8, 128, 155, 56, 157, 138, 43, 34, 27, 0, 159, 111, 70, 166, 107, 132, 48, 150, 157, 115, 101]"
16,16,3651,2049,8772,0,2158,1493,"[312, 285, 188, 381, 100, 397, 236, 196, 128, 116, 259, 285, 11, 71, 21, 0, 388, 15, 474, 56, 321, 82, 44, 440, 6, 245, 397]"
17,16,4269,5120,7921,0,474,3795,"[525, 492, 567, 1201, 591, 137, 504, 1209, 1007, 593, 548, 254, 314, 155, 767, 0, 123, 656, 642, 857, 475, 399, 466, 795, 1198, 608, 1048]"
18,16,3920,5848,5993,0,3584,336,"[55, 105, 3, 80, 110, 101, 100, 55, 89, 63, 11, 105, 39, 50, 64, 0, 32, 27, 7, 33, 20, 49, 26, 89, 52, 37, 9]"
19,16,3715,3148,6560,0,1558,2157,"[175, 307, 658, 193, 688, 378, 660, 538, 221, 104, 46, 225, 311, 203, 335, 0, 5, 312, 488, 155, 122, 124, 405, 697, 23, 240, 528]"
20,16,4993,7148,4405,0,1668,3325,"[192, 869, 228, 994, 614, 918, 16, 10, 814, 483, 684, 343, 434, 585, 776, 0, 728, 960, 361, 155, 523, 336, 894, 552, 303, 486, 688]"
21,16,3683,3265,4823,0,3653,30,"[6, 5, 8, 10, 5, 10, 0, 2, 1, 3, 9, 2, 1, 2, 6, 0, 8, 2, 0, 3, 9, 4, 1, 4, 2, 1, 2]"
22,16,4579,3895,5507,0,3107,1472,"[248, 337, 372, 482, 461, 33, 465, 333, 57, 406, 363, 240, 69, 378, 379, 0, 134, 234, 234, 400, 57, 482, 381, 300, 128, 312, 135]"
23,16,4131,2251,7387,0,1602,2529,"[579, 178, 772, 818, 629, 470, 783, 346, 514, 186, 139, 352, 210, 709, 116, 0, 409, 319, 423, 56, 600, 464, 501, 109, 301, 470, 253]"
24,16,4138,7404,4121,0,2190,1948,"[123, 20, 338, 646, 259, 380, 281, 8, 45, 51, 70, 97, 560, 249, 185, 0, 478, 512, 602, 236, 53, 439, 475, 647, 635, 298, 601]"
25,16,4346,1199,7268,0,1804,2542,"[701, 180, 594, 168, 664, 743, 198, 64, 104, 578, 490, 295, 800, 261, 436, 0, 712, 832, 383, 123, 186, 384, 11, 485, 526, 245, 329]"
26,16,3728,2980,8016,0,112,3616,"[593, 688, 857, 423, 352, 305, 416, 1138, 507, 642, 60, 1088, 433, 644, 862, 0, 208, 594, 296, 450, 771, 659, 1149, 843, 335, 445, 461]"
27,16,3788,5289,6515,0,3468,320,"[28, 103, 55, 12, 97, 91, 101, 14, 75, 18, 5, 69, 56, 62, 44, 0, 33, 11, 6, 45, 43, 33, 47, 90, 17, 64, 68]"
28,16,4056,4044,6527,0,526,3530,"[975, 487, 470, 1096, 29, 416, 418, 128, 936, 422, 50, 326, 830, 176, 1019, 0, 815, 594, 937, 310, 476, 1109, 210, 152, 810, 1078, 597]"
29,16,3450,2682,7295,0,1571,1879,"[220, 481, 282, 37, 593, 225, 279, 600, 56, 256, 423, 162, 175, 16, 353, 0, 604, 614, 525, 237, 460, 500, 563, 436, 272, 573, 368]"
30,16,4560,5816,6039,0,2257,2303,"[557, 570, 464, 434, 468, 540, 56, 257, 765, 400, 137, 605, 708, 729, 28, 0, 752, 42, 723, 584, 396, 245, 596, 247, 88, 675, 632]"
31,16,4368,3686,6721,0,2354,2014,"[628, 563, 458, 472, 476, 70, 85, 0, 222, 159, 218, 402, 251, 41, 557, 0, 639, 86, 69, 46, 168, 373, 166, 669, 438, 312, 110]"
32,16,4862,5163,6420,0,1745,3117,"[904, 1006, 252, 75, 928, 26, 1020, 785, 44, 291, 128, 706, 219, 29, 409, 0, 260, 1023, 997, 52, 99, 183, 329, 552, 539, 442, 267]"
33,16,4181,3438,7163,0,1164,3017,"[305, 930, 266, 771, 963, 189, 125, 73, 861, 754, 642, 629, 793, 522, 947, 0, 116, 13, 437, 254, 318, 482, 293, 935, 710, 717, 855]"
34,16,4025,6723,4465,0,682,3343,"[959, 949, 474, 478, 238, 1021, 153, 357, 1085, 61, 1036, 1039, 243, 705, 137, 0, 228, 495, 726, 947, 170, 26, 886, 555, 951, 975, 526]"
35,16,3790,1086,7169,0,991,2799,"[862, 730, 768, 829, 761, 226, 456, 928, 814, 886, 497, 633, 905, 432, 668, 0, 307, 450, 195, 118, 567, 625, 852, 90, 8, 650, 305]"
36,16,4482,6848,4803,0,2003,2479,"[126, 822, 288, 122, 511, 810, 122, 666, 381, 342, 532, 792, 290, 471, 131, 0, 813, 392, 358, 286, 817, 758, 247, 805, 486, 242, 308]"
37,16,3648,1205,7246,0,580,3068,"[12, 87, 811, 196, 646, 703, 32, 945, 505, 129, 418, 362, 17, 82, 527, 0, 946, 60, 624, 53, 289, 288, 585, 362, 1009, 1007, 931]"
38,16,4631,6501,5376,0,347,4284,"[407, 782, 744, 654, 410, 520, 619, 1090, 1262, 1015, 627, 411, 144, 1179, 1121, 0, 281, 313, 944, 289, 869, 1126, 169, 1019, 1361, 1311, 85]"
39,16,3437,1300,7513,0,96,3341,"[1072, 947, 590, 934, 193, 990, 469, 777, 611, 455, 56, 607, 70, 138, 234, 0, 1016, 638, 273, 969, 454, 580, 415, 554, 916, 482, 628]"
40,16,4399,7283,4629,0,2774,1625,"[524, 134, 520, 57, 468, 469, 252, 358, 485, 379, 169, 172, 23, 39, 357, 0, 391, 148, 359, 435, 504, 489, 68, 88, 90, 517, 28]"
41,16,4070,1523,7176,0,3232,838,"[243, 255, 151, 230, 22, 79, 146, 193, 206, 74, 76, 11, 156, 21, 30, 0, 63, 189, 15, 21, 158, 37, 151, 90, 127, 136, 261]"
42,16,4846,5960,6062,0,2081,2765,"[158, 162, 550, 584, 759, 88, 180, 682, 240, 242, 259, 844, 581, 916, 295, 0, 95, 461, 27, 195, 500, 864, 90, 241, 187, 506, 450]"
43,16,3567,2520,7109,0,3117,450,"[73, 135, 91, 97, 98, 36, 51, 78, 6, 137, 26, 15, 79, 107, 148, 0, 25, 61, 37, 72, 113, 0, 147, 17, 98, 83, 90]"
44,16,4691,7247,4553,0,3072,1619,"[292, 153, 463, 31, 493, 195, 74, 452, 364, 508, 42, 416, 65, 238, 201, 0, 383, 195, 505, 416, 125, 384, 474, 388, 67, 87, 63]"
45,16,4706,1552,7707,0,3942,764,"[245, 84, 131, 45, 41, 45, 118, 162, 91, 111, 120, 198, 66, 16, 7, 0, 148, 111, 153, 105, 148, 123, 98, 97, 107, 236, 237]"
46,16,4956,6648,6015,0,4059,897,"[139, 299, 29, 91, 126, 84, 65, 220, 190, 8, 25, 232, 268, 131, 165, 0, 198, 48, 201, 258, 162, 284, 212, 290, 248, 8, 248]"
47,16,3324,492,8847,0,1587,1737,"[443, 142, 167, 259, 169, 156, 440, 369, 405, 231, 225, 185, 87, 508, 305, 0, 219, 126, 247, 512, 512, 37, 98, 482, 85, 133, 320]"
48,16,4398,5621,7624,0,1146,3252,"[564, 991, 89, 185, 1054, 481, 768, 309, 103, 362, 754, 760, 231, 994, 697, 0, 748, 67, 446, 468, 710, 144, 718, 448, 280, 398, 1046]"
49,16,4334,7006,4952,0,859,3475,"[1076, 266, 121, 870, 319, 159, 712, 902, 95, 75, 630, 747, 171, 963, 171, 0, 41, 513, 1001, 761, 646, 580, 792, 460, 946, 169, 754]"
50,16,4359,784,8527,0,802,3557,"[393, 29, 474, 864, 615, 639, 1136, 231, 940, 231, 637, 656, 251, 399, 1033, 0, 89, 282, 1129, 1033, 245, 938, 491, 649, 149, 369, 399]"
51,16,3222,7458,4291,0,2100,1122,"[30, 92, 14, 40, 25, 0, 40, 94, 32, 134, 221, 290, 117, 250, 338, 0, 256, 299, 249, 239, 151, 306, 214, 46, 175, 71, 250]"
52,16,3629,503,7417,0,1676,1953,"[0, 209, 452, 532, 332, 404, 344, 442, 365, 459, 334, 516, 288, 125, 365, 0, 611, 197, 408, 577, 620, 264, 544, 113, 242, 333, 278]"
53,16,4284,5783,5918,0,4247,37,"[5, 11, 11, 5, 7, 2, 3, 9, 8, 6, 10, 7, 0, 2, 12, 0, 11, 3, 12, 10, 10, 9, 5, 8, 11, 9, 2]"
54,16,4433,2254,8097,0,3213,1220,"[332, 259, 331, 99, 66, 304, 126, 184, 59, 34, 284, 108, 74, 129, 33, 0, 255, 92, 1, 332, 381, 173, 384, 298, 352, 41, 153]"
55,16,4556,5182,7471,0,3835,721,"[112, 55, 126, 155, 0, 204, 194, 147, 10, 116, 173, 124, 166, 205, 153, 0, 74, 42, 43, 232, 73, 212, 227, 201, 67, 188, 191]"
56,16,3380,243,10000,608,1175,2205,"[441, 310, 160, 130, 679, 245, 75, 693, 307, 410, 448, 227, 710, 377, 226, 0, 538, 415, 624, 149, 435, 544, 553, 246, 454, 346, 566]"
57,16,3833,6726,7107,0,3587,246,"[81, 58, 47, 80, 81, 59, 74, 33, 82, 35, 50, 23, 20, 53, 39, 0, 35, 9, 74, 2, 21, 4, 62, 60, 28, 52, 21]"
58,16,3673,2534,8246,0,2997,676,"[56, 139, 28, 13, 222, 153, 0, 58, 129, 81, 182, 38, 90, 5, 18, 0, 60, 107, 115, 135, 113, 142, 195, 108, 4, 207, 151]"
59,16,3469,7022,4693,0,2951,518,"[130, 56, 37, 111, 75, 41, 125, 170, 34, 95, 1, 33, 29, 115, 143, 0, 100, 143, 161, 141, 23, 140, 99, 132, 103, 46, 26]"
60,16,4021,3304,5410,0,3324,697,"[63, 172, 73, 113, 27, 70, 224, 163, 169, 14, 39, 44, 24, 56, 2, 0, 70, 178, 142, 51, 133, 142, 33, 135, 29, 132, 32]"
61,16,3286,3177,5519,0,2752,534,"[58, 33, 54, 62, 1, 92, 115, 58, 111, 9, 135, 129, 70, 45, 1, 0, 89, 33, 54, 71, 153, 77, 53, 169, 155, 162, 34]"
62,16,3417,707,8229,0,1072,2345,"[190, 491, 231, 491, 84, 130, 42, 223, 410, 748, 176, 771, 187, 111, 395, 0, 297, 766, 634, 438, 204, 112, 179, 270, 619, 93, 304]"
63,16,4735,5508,7456,0,1041,3694,"[213, 228, 630, 279, 897, 397, 139, 825, 314, 133, 1172, 981, 890, 823, 898, 0, 469, 931, 437, 680, 1042, 22, 679, 202, 731, 195, 277]"
64,16,3033,419,10000,70,1220,1813,"[335, 149, 162, 317, 214, 264, 589, 406, 489, 556, 100, 37, 31, 84, 337, 0, 258, 111, 284, 326, 449, 387, 4, 91, 373, 394, 264]"
65,16,3801,5275,8526,0,3002,799,"[230, 137, 31, 176, 105, 14, 228, 266, 194, 98, 120, 171, 24, 230, 16, 0, 131, 90, 106, 245, 196, 181, 161, 70, 256, 89, 201]"
66,16,4043,6087,6482,0,2347,1696,"[507, 252, 537, 221, 70, 183, 441, 200, 378, 58, 300, 326, 109, 396, 257, 0, 200, 541, 233, 285, 93, 50, 373, 378, 349, 151, 432]"
67,16,4525,6436,4571,0,2577,1948,"[569, 197, 387, 65, 297, 545, 370, 581, 251, 212, 31, 580, 287, 186, 627, 0, 91, 421, 478, 254, 608, 31, 212, 90, 321, 190, 506]"
68,16,4054,1544,7081,0,3116,938,"[17, 141, 94, 246, 240, 138, 54, 100, 221, 301, 141, 199, 40, 149, 116, 0, 311, 225, 105, 63, 152, 182, 52, 123, 226, 164, 75]"
69,16,3216,1161,9136,0,2978,238,"[43, 24, 37, 45, 11, 19, 46, 41, 2, 7, 70, 79, 26, 59, 23, 0, 33, 33, 28, 77, 17, 70, 20, 40, 6, 63, 30]"
70,16,3143,7143,5136,0,2805,338,"[39, 95, 90, 56, 97, 70, 59, 47, 6, 109, 54, 51, 6, 29, 96, 0, 59, 63, 29, 19, 77, 22, 37, 82, 83, 85, 54]"
71,16,4991,3274,6853,0,1257,3734,"[1216, 137, 1150, 846, 1226, 473, 217, 452, 177, 1127, 308, 1077, 1219, 313, 665, 0, 375, 368, 1201, 1205, 1098, 571, 782, 1182, 148, 915, 507]"
72,16,3195,1976,8072,0,2809,386,"[49, 126, 1, 77, 117, 21, 92, 39, 108, 54, 96, 54, 92, 42, 92, 0, 49, 28, 15, 69, 110, 27, 68, 34, 110, 104, 39]"
73,16,3591,7479,4184,0,548,3043,"[814, 465, 472, 220, 392, 812, 583, 520, 379, 104, 412, 850, 375, 140, 260, 0, 1002, 813, 741, 398, 392, 700, 194, 527, 908, 937, 633]"
74,16,3202,332,7054,0,1725,1477,"[403, 293, 471, 93, 290, 117, 141, 368, 475, 79, 44, 293, 110, 295, 464, 0, 67, 214, 297, 3, 104, 86, 43, 23, 243, 168, 242]"
75,16,3109,95,10000,68,2240,869,"[199, 150, 120, 86, 174, 163, 228, 244, 264, 32, 190, 252, 232, 273, 205, 0, 20, 84, 192, 26, 260, 107, 86, 60, 17, 124, 13]"
76,16,3687,6885,6802,0,824,2863,"[742, 742, 943, 197, 888, 306, 754, 454, 782, 948, 236, 841, 305, 944, 439, 0, 646, 763, 21, 659, 442, 47, 670, 180, 536, 363, 385]"
77,16,4526,6898,4430,0,1284,3242,"[483, 419, 331, 836, 442, 91, 80, 1003, 198, 836, 220, 48, 882, 942, 60, 0, 550, 287, 330, 559, 204, 740, 258, 830, 534, 549, 303]"
78,16,4243,1810,6863,0,4142,101,"[29, 16, 27, 11, 26, 11, 32, 2, 28, 21, 23, 17, 25, 5, 13, 0, 19, 17, 1, 17, 32, 3, 30, 30, 25, 10, 16]"
79,16,4192,5801,5254,0,852,3340,"[12, 168, 351, 844, 653, 546, 976, 308, 539, 60, 529, 632, 751, 897, 905, 0, 897, 1071, 1004, 451, 1043, 269, 419, 813, 870, 580, 1099]"
80,16,3911,381,8784,0,2769,1142,"[370, 44, 238, 182, 53, 42, 246, 90, 314, 48, 229, 212, 317, 300, 27, 0, 177, 216, 27, 125, 346, 67, 111, 20, 36, 263, 32]"
81,16,3406,7178,5012,0,2761,645,"[9, 150, 155, 131, 166, 192, 202, 206, 147, 12, 108, 94, 24, 145, 100, 0, 212, 190, 146, 39, 8, 16, 140, 17, 112, 39, 190]"
82,16,4895,3651,6256,0,4396,499,"[159, 63, 33, 69, 13, 124, 83, 150, 106, 73, 60, 47, 103, 94, 126, 0, 100, 22, 93, 90, 62, 137, 107, 29, 28, 133, 128]"
83,16,3884,1302,8838,0,3628,256,"[57, 55, 55, 63, 26, 40, 84, 71, 58, 36, 57, 81, 20, 59, 43, 0, 7, 58, 11, 4, 23, 73, 5, 66, 79, 74, 75]"
84,16,4158,7300,5696,0,1990,2168,"[132, 483, 38, 497, 599, 476, 478, 401, 291, 545, 527, 192, 528, 345, 76, 0, 718, 173, 605, 544, 343, 502, 75, 262, 587, 139, 442]"
85,16,4631,2929,7398,0,1008,3623,"[729, 875, 571, 926, 1197, 775, 310, 151, 277, 253, 470, 1116, 179, 885, 873, 0, 541, 253, 207, 628, 988, 98, 1127, 476, 1035, 690, 699]"
86,16,3996,6007,5387,0,65,3931,"[324, 76, 1274, 606, 522, 452, 970, 1007, 1220, 491, 256, 1273, 369, 1294, 1184, 0, 771, 725, 379, 902, 958, 1152, 1282, 216, 329, 1251, 1286]"
87,16,4116,2386,7117,0,2063,2053,"[71, 333, 147, 281, 581, 424, 322, 27, 463, 554, 679, 278, 350, 444, 241, 0, 413, 675, 517, 25, 355, 54, 134, 7, 132, 588, 280]"
88,16,3952,6172,4897,0,3820,132,"[36, 15, 4, 12, 22, 43, 12, 37, 11, 13, 32, 34, 37, 16, 7, 0, 26, 40, 36, 38, 41, 22, 33, 21, 32, 20, 42]"
89,16,4732,4341,5288,0,4390,342,"[113, 99, 56, 62, 111, 49, 29, 65, 85, 18, 111, 64, 1, 51, 87, 0, 83, 28, 23, 16, 2, 77, 69, 24, 72, 29, 90]"
90,16,3264,2815,5737,0,2734,530,"[30, 160, 82, 87, 69, 22, 7, 147, 19, 93, 105, 70, 74, 156, 73, 0, 99, 93, 73, 139, 69, 71, 42, 130, 147, 153, 29]"
91,16,4951,3863,6825,0,2904,2047,"[648, 562, 622, 4, 208, 168, 677, 68, 384, 450, 174, 215, 9, 452, 522, 0, 323, 522, 188, 381, 638, 123, 504, 500, 312, 603, 613]"
92,16,4168,3486,7507,0,2647,1521,"[377, 295, 119, 179, 350, 352, 360, 506, 355, 406, 67, 101, 378, 186, 360, 0, 391, 469, 13, 357, 410, 3, 180, 501, 334, 22, 264]"
93,16,3823,6451,4879,0,672,3151,"[73, 60, 345, 31, 164, 308, 513, 233, 620, 853, 91, 468, 700, 536, 472, 0, 137, 743, 8, 450, 662, 181, 940, 486, 875, 745, 1019]"
94,16,4644,2969,6554,0,1596,3048,"[269, 1000, 390, 622, 228, 587, 728, 240, 716, 176, 459, 346, 712, 399, 254, 0, 918, 695, 533, 149, 309, 815, 595, 263, 696, 997, 666]"
95,16,3181,246,9489,0,2101,1080,"[8, 272, 334, 77, 124, 249, 302, 336, 267, 141, 103, 317, 153, 179, 267, 0, 341, 63, 289, 92, 186, 327, 34, 228, 47, 234, 148]"
96,16,4549,6945,7093,0,2756,1793,"[338, 306, 264, 410, 512, 21, 142, 106, 308, 53, 256, 547, 373, 414, 104, 0, 590, 180, 97, 166, 358, 91, 136, 41, 135, 44, 534]"
97,16,4019,6972,4140,0,1638,2381,"[460, 509, 77, 662, 633, 490, 116, 471, 320, 571, 610, 574, 216, 776, 490, 0, 622, 211, 451, 448, 383, 638, 743, 704, 743, 738, 448]"
98,16,4921,320,8741,0,3838,1083,"[54, 340, 73, 87, 37, 154, 339, 47, 18, 52, 357, 168, 258, 244, 219, 0, 210, 348, 233, 111, 216, 0, 168, 193, 119, 292, 1]"
99,16,4269,6068,6942,0,4234,35,"[10, 1, 7, 2, 9, 3, 3, 6, 11, 4, 10, 9, 5, 7, 6, 0, 5, 1, 8, 10, 11, 5, 4, 1, 6, 5, 4]"
100,16,4267,5508,5701,0,3116,1151,"[111, 48, 0, 358, 276, 287, 192, 48, 147, 272, 266, 346, 143, 245, 149, 0, 172, 257, 122, 231, 341, 267, 7, 115, 137, 346, 283]"
101,16,3885,2924,6662,0,982,2903,"[804, 61, 833, 338, 535, 458, 272, 866, 700, 923, 574, 130, 75, 267, 953, 0, 403, 308, 690, 310, 14, 505, 766, 237, 630, 773, 912]"
102,16,4037,1443,9256,0,3085,952,"[172, 163, 73, 53, 128, 85, 200, 15, 240, 81, 259, 36, 65, 276, 219, 0, 91, 72, 1, 96, 174, 168, 31, 258, 295, 154, 64]"
103,16,3989,6939,6306,0,2388,1601,"[311, 434, 470, 270, 2, 23, 132, 337, 286, 205, 333, 179, 482, 319, 57, 0, 343, 362, 289, 447, 68, 360, 346, 2, 137, 303, 44]"
104,16,4241,3266,7281,0,3749,492,"[55, 28, 48, 92, 160, 60, 96, 52, 76, 140, 63, 73, 112, 39, 77, 0, 35, 30, 4, 49, 132, 79, 101, 44, 109, 112, 87]"
105,16,4601,5920,5962,0,3248,1353,"[429, 38, 433, 355, 237, 235, 365, 69, 36, 103, 28, 418, 282, 78, 135, 0, 141, 64, 74, 182, 386, 226, 337, 309, 105, 305, 355]"
106,16,4817,995,9784,0,2947,1870,"[361, 615, 45, 36, 89, 64, 71, 133, 619, 538, 362, 185, 105, 84, 101, 0, 132, 408, 383, 97, 173, 216, 98, 499, 429, 239, 16]"
107,16,4354,5238,8900,0,787,3567,"[589, 364, 318, 46, 839, 134, 781, 484, 123, 1168, 999, 627, 82, 772, 195, 0, 525, 230, 728, 811, 585, 468, 428, 633, 386, 865, 1142]"
108,16,4775,5163,8512,0,4521,254,"[16, 74, 26, 2, 31, 79, 57, 27, 5, 2, 6, 7, 8, 11, 7, 0, 67, 53, 79, 0, 8, 59, 74, 70, 55, 25, 39]"
109,16,4260,6940,5832,0,1363,2897,"[784, 921, 549, 606, 370, 545, 709, 943, 41, 662, 792, 571, 841, 873, 546, 0, 654, 5, 743, 168, 802, 804, 240, 441, 475, 194, 922]"
110,16,3038,3026,5844,0,2514,524,"[82, 78, 119, 105, 132, 146, 106, 154, 98, 65, 76, 79, 38, 121, 31, 0, 21, 83, 76, 37, 18, 130, 50, 124, 149, 68, 61]"
111,16,3900,582,9162,0,455,3445,"[960, 196, 524, 38, 333, 83, 64, 967, 587, 234, 817, 498, 83, 277, 638, 0, 286, 941, 403, 514, 547, 72, 686, 961, 502, 1016, 99]"
112,16,3676,5213,7625,0,2115,1561,"[25, 462, 374, 17, 250, 485, 113, 517, 473, 206, 94, 213, 21, 486, 217, 0, 244, 465, 88, 344, 29, 90, 17, 12, 291, 515, 32]"
113,16,3920,6883,4662,0,2178,1742,"[322, 37, 32, 76, 458, 175, 202, 267, 429, 124, 184, 232, 182, 298, 248, 0, 491, 57, 296, 187, 214, 448, 96, 284, 514, 31, 490]"
114,16,3583,2218,6027,0,77,3506,"[603, 445, 954, 45, 1152, 223, 1028, 343, 685, 542, 1021, 516, 879, 372, 445, 0, 467, 687, 791, 1139, 433, 444, 554, 795, 1103, 1027, 116]"
115,16,4137,2442,7722,0,632,3505,"[483, 1050, 603, 1122, 585, 663, 537, 742, 789, 558, 508, 989, 1037, 228, 1077, 0, 202, 1018, 415, 764, 735, 75, 695, 875, 237, 852, 1168]"
116,16,3229,2646,8305,0,2093,1136,"[127, 269, 123, 136, 226, 113, 329, 227, 213, 93, 97, 278, 373, 188, 181, 0, 267, 144, 185, 83, 195, 147, 114, 334, 141, 231, 244]"
117,16,4337,5452,7190,0,2363,1974,"[654, 413, 132, 252, 278, 173, 135, 19, 242, 311, 412, 545, 650, 111, 634, 0, 135, 256, 528, 352, 134, 556, 592, 44, 205, 343, 43]"
118,16,3442,3116,7516,0,3191,251,"[28, 51, 74, 79, 39, 75, 60, 29, 8, 65, 45, 2, 66, 25, 34, 0, 72, 52, 80, 12, 83, 68, 14, 20, 26, 44, 42]"
119,16,3314,613,10000,217,1167,2147,"[287, 436, 147, 711, 444, 518, 565, 38, 185, 573, 568, 594, 704, 290, 227, 0, 500, 547, 631, 209, 672, 263, 672, 668, 124, 677, 403]"
120,16,4573,7150,7423,0,1132,3441,"[184, 757, 144, 200, 1072, 192, 843, 876, 966, 190, 155, 387, 368, 774, 563, 0, 223, 353, 525, 61, 904, 157, 494, 657, 754, 947, 431]"
121,16,3385,2224,8584,0,1386,1999,"[109, 90, 270, 456, 398, 362, 107, 106, 541, 540, 442, 213, 636, 402, 94, 0, 410, 287, 20, 551, 223, 235, 305, 604, 417, 499, 241]"
122,16,3140,5006,6718,0,1625,1515,"[319, 171, 179, 158, 462, 312, 421, 149, 333, 0, 278, 15, 298, 270, 492, 0, 211, 409, 128, 321, 258, 167, 188, 462, 376, 377, 412]"
123,16,4597,5717,5598,0,4224,373,"[44, 17, 86, 110, 25, 27, 61, 16, 54, 8, 55, 55, 72, 26, 49, 0, 99, 72, 121, 85, 58, 18, 29, 84, 37, 106, 13]"
124,16,4888,3134,7352,0,858,4030,"[139, 152, 1019, 203, 1162, 858, 87, 644, 649, 280, 1271, 906, 182, 112, 1119, 0, 929, 308, 1305, 46, 1326, 1268, 517, 197, 1155, 1206, 578]"
125,16,4703,5375,6680,0,4674,29,"[8, 9, 2, 0, 9, 4, 8, 0, 5, 0, 5, 7, 3, 5, 1, 0, 4, 8, 5, 8, 7, 0, 1, 5, 6, 7, 6]"
126,16,4838,6664,4854,0,1321,3517,"[824, 809, 700, 179, 496, 981, 348, 369, 515, 244, 104, 186, 696, 772, 89, 0, 27, 789, 184, 438, 889, 683, 59, 1024, 944, 915, 616]"
127,16,4423,4160,5117,0,3000,1423,"[166, 39, 53, 41, 418, 39, 86, 120, 441, 220, 439, 332, 173, 26, 128, 0, 242, 432, 125, 356, 195, 69, 388, 77, 190, 344, 410]"
128,16,4214,1777,7554,0,131,4083,"[45, 410, 231, 1258, 803, 1190, 219, 877, 509, 892, 539, 261, 311, 381, 751, 0, 408, 512, 1079, 945, 1287, 1220, 1337, 591, 634, 1080, 1250]"
129,16,3970,5880,5644,0,3530,440,"[137, 122, 79, 145, 17, 122, 75, 102, 88, 83, 95, 108, 23, 76, 72, 0, 89, 51, 82, 139, 4, 113, 4, 46, 111, 115, 92]"
130,16,4079,2112,7611,0,804,3275,"[465, 251, 459, 196, 520, 413, 795, 333, 909, 392, 617, 195, 288, 383, 227, 0, 1039, 657, 953, 699, 354, 873, 840, 119, 555, 654, 412]"
131,16,3901,6309,5203,0,206,3695,"[1118, 273, 923, 640, 888, 544, 1069, 550, 212, 1074, 989, 1048, 133, 1056, 750, 0, 889, 972, 379, 691, 848, 46, 385, 882, 364, 765, 752]"
132,16,3893,1337,7759,0,2261,1632,"[242, 445, 486, 210, 495, 128, 59, 87, 420, 325, 456, 242, 176, 214, 422, 0, 397, 273, 259, 148, 390, 96, 339, 15, 454, 1, 295]"
133,16,4507,7362,4904,0,522,3985,"[759, 1156, 1230, 96, 0, 1122, 338, 959, 947, 964, 495, 839, 1274, 1179, 1012, 0, 687, 1060, 1270, 1170, 160, 974, 422, 1170, 534, 577, 301]"
134,16,4539,2796,6647,0,3682,857,"[273, 77, 269, 58, 130, 165, 148, 246, 71, 177, 95, 258, 92, 94, 48, 0, 86, 249, 200, 242, 134, 48, 259, 20, 215, 274, 146]"
135,16,4343,3377,7613,0,3800,543,"[127, 176, 156, 126, 58, 86, 142, 34, 19, 110, 12, 37, 127, 75, 69, 0, 82, 156, 94, 12, 50, 40, 170, 4, 105, 34, 57]"
136,16,4909,5779,6743,0,3062,1847,"[565, 611, 357, 355, 320, 151, 508, 475, 37, 3, 225, 159, 160, 13, 614, 0, 123, 607, 558, 395, 382, 398, 529, 93, 274, 602, 406]"
137,16,3202,2096,7849,0,2916,286,"[54, 52, 56, 33, 18, 8, 27, 24, 7, 25, 39, 27, 8, 63, 85, 0, 93, 15, 2, 64, 27, 1, 39, 80, 8, 24, 50]"
138,16,3745,5738,5856,0,602,3143,"[783, 552, 554, 773, 843, 180, 925, 486, 566, 753, 327, 741, 400, 945, 839, 0, 1021, 82, 956, 909, 297, 84, 841, 60, 694, 287, 938]"
139,16,3193,1558,7491,0,1315,1878,"[177, 66, 504, 166, 319, 39, 519, 298, 465, 438, 123, 241, 281, 60, 517, 0, 157, 6, 215, 391, 56, 526, 348, 518, 400, 447, 572]"
140,16,4708,5470,6729,0,37,4671,"[1428, 1069, 1452, 271, 994, 1442, 1247, 262, 469, 128, 153, 1429, 89, 431, 931, 0, 1078, 1454, 1467, 336, 1028, 594, 1129, 575, 1199, 1206, 683]"
141,16,3574,2511,7792,0,37,3537,"[699, 673, 209, 44, 370, 294, 68, 870, 635, 1147, 711, 687, 530, 718, 466, 0, 653, 769, 751, 232, 1042, 406, 251, 148, 648, 908, 22]"
142,16,4244,6518,5518,0,2058,2186,"[616, 509, 71, 314, 277, 179, 328, 187, 359, 29, 352, 244, 172, 428, 209, 0, 440, 8, 409, 448, 209, 562, 445, 13, 223, 199, 300]"
143,16,3322,1938,6902,0,2756,566,"[4, 187, 16, 107, 106, 4, 148, 167, 101, 148, 49, 179, 42, 151, 117, 0, 95, 4, 120, 167, 104, 51, 160, 166, 25, 6, 148]"
144,16,3281,3139,7044,0,892,2389,"[490, 361, 158, 412, 670, 671, 301, 70, 375, 397, 468, 508, 30, 239, 372, 0, 73, 293, 180, 693, 152, 520, 676, 248, 38, 490, 670]"
145,16,3509,3048,7505,0,594,2915,"[114, 223, 494, 3, 194, 502, 940, 724, 163, 433, 408, 880, 50, 604, 183, 0, 732, 787, 644, 566, 214, 162, 907, 555, 791, 155, 236]"
146,16,4485,6154,5836,0,1250,3235,"[899, 1040, 448, 440, 290, 186, 613, 815, 967, 621, 536, 864, 560, 972, 464, 0, 544, 211, 317, 882, 160, 607, 360, 553, 31, 177, 915]"
147,16,4181,3671,6346,0,1421,2760,"[761, 791, 513, 205, 202, 163, 628, 328, 102, 409, 612, 373, 114, 892, 323, 0, 265, 314, 2, 722, 360, 348, 474, 616, 830, 698, 29]"
148,16,3461,2213,7594,0,672,2789,"[423, 32, 676, 287, 396, 702, 175, 431, 925, 911, 923, 489, 552, 671, 701, 0, 888, 546, 566, 634, 471, 465, 548, 471, 889, 359, 813]"
149,16,3687,6026,5255,0,779,2908,"[68, 719, 268, 628, 392, 736, 565, 428, 957, 769, 815, 889, 631, 646, 281, 0, 969, 762, 30, 82, 767, 28, 1, 830, 537, 181, 479]"
150,16,3088,713,7630,0,491,2597,"[42, 760, 491, 372, 651, 10, 414, 645, 168, 523, 211, 31, 180, 759, 46, 0, 470, 473, 500, 779, 555, 789, 150, 645, 243, 164, 760]"
151,16,3676,6192,5114,0,1929,1747,"[575, 408, 196, 90, 155, 410, 103, 305, 250, 313, 240, 487, 56, 556, 124, 0, 466, 569, 577, 381, 541, 442, 459, 469, 360, 496, 92]"
152,16,3108,1741,6481,0,131,2977,"[815, 67, 703, 220, 222, 759, 511, 446, 24, 37, 914, 556, 443, 285, 516, 0, 853, 694, 579, 462, 807, 922, 46, 240, 165, 679, 457]"
153,16,4562,6299,4744,0,576,3986,"[526, 512, 536, 507, 100, 632, 871, 550, 999, 1130, 516, 487, 128, 1104, 823, 0, 247, 679, 681, 197, 1039, 29, 592, 481, 39, 25, 304]"
154,16,3226,2037,5933,0,3069,157,"[22, 43, 24, 27, 1, 12, 27, 8, 52, 38, 38, 14, 5, 24, 48, 0, 49, 42, 1, 7, 10, 4, 5, 40, 47, 0, 26]"
155,16,4079,863,9149,0,180,3899,"[727, 555, 345, 79, 51, 191, 1020, 455, 125, 1174, 449, 96, 272, 494, 1042, 0, 20, 581, 1238, 869, 471, 1069, 561, 56, 12, 397, 817]"
156,16,4546,6584,7111,0,1259,3287,"[661, 250, 379, 1084, 915, 578, 721, 300, 949, 135, 665, 447, 676, 701, 279, 0, 841, 189, 526, 100, 917, 798, 1076, 123, 51, 896, 614]"
157,16,4704,5043,6772,0,2569,2135,"[274, 520, 555, 674, 129, 184, 324, 247, 179, 546, 529, 614, 597, 300, 141, 0, 358, 667, 72, 437, 571, 78, 308, 149, 61, 42, 100]"
158,16,4702,6185,5289,0,2987,1715,"[362, 165, 555, 404, 237, 403, 237, 570, 112, 70, 180, 102, 542, 467, 0, 0, 448, 359, 278, 210, 298, 450, 283, 476, 349, 203, 335]"
159,16,4872,2380,7781,0,120,4752,"[440, 368, 1105, 1251, 205, 594, 191, 77, 1554, 809, 1172, 469, 869, 296, 593, 0, 1062, 1437, 325, 631, 212, 675, 344, 247, 1071, 283, 528]"
160,16,3766,6209,5338,0,468,3298,"[393, 260, 100, 843, 970, 729, 182, 705, 864, 501, 176, 319, 258, 448, 868, 0, 704, 1051, 126, 236, 342, 193, 195, 8, 460, 145, 384]"
161,16,3554,302,8590,0,2610,944,"[6, 70, 139, 248, 232, 306, 119, 212, 107, 154, 77, 238, 240, 163, 93, 0, 50, 314, 230, 258, 46, 101, 68, 113, 106, 103, 237]"
162,16,4637,6905,6322,0,1779,2858,"[862, 493, 63, 943, 74, 229, 921, 764, 670, 434, 572, 281, 420, 96, 480, 0, 604, 239, 913, 485, 351, 620, 912, 815, 657, 389, 375]"
163,16,4984,6506,4800,0,2778,2206,"[174, 345, 566, 710, 119, 48, 547, 318, 728, 298, 506, 555, 571, 164, 272, 0, 169, 6, 125, 448, 23, 28, 140, 204, 206, 298, 203]"
164,16,4882,1757,7925,0,4034,848,"[40, 253, 76, 57, 91, 128, 30, 194, 117, 263, 229, 245, 64, 260, 37, 0, 201, 43, 138, 34, 22, 45, 14, 110, 153, 168, 134]"
165,16,3045,2338,8632,0,424,2621,"[256, 206, 455, 261, 803, 498, 753, 378, 440, 160, 615, 416, 311, 68, 256, 0, 834, 482, 224, 772, 709, 6, 406, 9, 122, 257, 709]"
166,16,4758,7053,6337,0,4197,561,"[156, 90, 79, 145, 67, 8, 76, 142, 25, 176, 39, 11, 83, 74, 22, 0, 70, 163, 112, 71, 185, 85, 140, 11, 170, 128, 3]"
167,16,3239,878,8698,0,427,2812,"[144, 250, 200, 483, 235, 925, 438, 767, 237, 89, 556, 118, 337, 312, 529, 0, 379, 476, 262, 376, 608, 441, 121, 814, 395, 520, 170]"
168,16,4213,6335,6576,0,2866,1347,"[398, 212, 56, 138, 433, 301, 355, 95, 113, 396, 391, 252, 393, 54, 255, 0, 371, 60, 154, 368, 86, 210, 247, 283, 383, 338, 309]"
169,16,3453,1874,8155,0,2584,869,"[250, 48, 236, 244, 110, 158, 149, 248, 12, 157, 2, 213, 88, 141, 210, 0, 1, 285, 67, 206, 165, 214, 96, 119, 86, 9, 149]"
170,16,4008,7270,4893,0,1868,2140,"[581, 534, 509, 168, 494, 144, 397, 372, 254, 684, 32, 643, 35, 635, 397, 0, 633, 126, 491, 624, 545, 683, 417, 389, 273, 452, 206]"
171,16,3308,2034,6167,0,2127,1181,"[308, 323, 359, 245, 195, 286, 215, 4, 271, 119, 181, 14, 210, 287, 298, 0, 254, 9, 216, 256, 207, 359, 233, 372, 173, 301, 361]"
172,16,4320,1975,8512,0,2572,1748,"[246, 382, 317, 230, 433, 220, 292, 105, 125, 387, 67, 386, 280, 116, 74, 0, 208, 189, 112, 453, 257, 87, 248, 155, 95, 557, 177]"
173,16,3718,6859,5371,0,1495,2223,"[165, 141, 110, 127, 168, 523, 1, 2, 466, 682, 108, 573, 81, 695, 640, 0, 209, 227, 16, 671, 684, 370, 428, 420, 596, 662, 452]"
174,16,3345,711,8005,0,2690,655,"[92, 208, 64, 24, 139, 27, 175, 7, 18, 194, 29, 70, 167, 122, 143, 0, 115, 11, 14, 2, 57, 45, 133, 31, 16, 41, 168]"
175,16,4414,6709,5710,0,9,4405,"[1363, 98, 909, 532, 1383, 1225, 958, 320, 949, 938, 1002, 1192, 745, 904, 608, 0, 880, 1442, 376, 1227, 1425, 41, 380, 499, 229, 542, 141]"
176,16,3473,1030,8153,0,1194,2279,"[55, 703, 163, 493, 263, 390, 308, 268, 261, 297, 366, 313, 77, 357, 284, 0, 250, 557, 29, 513, 156, 400, 202, 681, 709, 166, 303]"
177,16,3668,7171,4650,0,988,2680,"[280, 691, 323, 371, 219, 223, 221, 356, 173, 677, 793, 287, 288, 577, 348, 0, 725, 572, 809, 877, 549, 808, 184, 716, 352, 272, 572]"
178,16,3827,2684,5793,0,3678,149,"[17, 21, 32, 9, 18, 26, 14, 32, 11, 29, 9, 12, 39, 18, 29, 0, 0, 48, 32, 31, 24, 21, 7, 42, 15, 7, 12]"
179,16,3134,3072,5855,0,3118,16,"[5, 2, 0, 0, 2, 0, 1, 5, 5, 4, 3, 5, 5, 0, 3, 0, 0, 5, 0, 0, 0, 4, 0, 3, 1, 0, 1]"
180,16,4229,874,9210,0,710,3519,"[54, 191, 1113, 619, 574, 602, 902, 55, 365, 274, 604, 187, 32, 929, 1005, 0, 84, 210, 1125, 1117, 269, 589, 293, 103, 574, 146, 775]"
181,16,4218,7136,6292,0,889,3329,"[279, 983, 1066, 335, 931, 281, 21, 436, 169, 1088, 176, 757, 423, 1098, 883, 0, 828, 475, 296, 782, 433, 998, 10, 813, 28, 556, 444]"
182,16,3389,3062,6619,0,2454,935,"[43, 203, 174, 48, 241, 90, 149, 103, 126, 40, 70, 19, 201, 143, 206, 0, 87, 286, 138, 269, 72, 96, 199, 186, 28, 39, 58]"
183,16,4282,2130,8771,0,2262,2020,"[414, 645, 255, 313, 532, 167, 170, 213, 561, 414, 165, 588, 586, 169, 571, 0, 374, 146, 315, 70, 121, 543, 578, 636, 195, 229, 608]"
184,16,3294,7412,4653,0,439,2855,"[596, 40, 298, 317, 160, 645, 128, 6, 679, 254, 21, 836, 131, 461, 153, 0, 545, 334, 464, 469, 756, 706, 790, 926, 483, 33, 348]"
185,16,3577,1904,6326,0,480,3097,"[974, 697, 653, 896, 924, 613, 848, 521, 14, 113, 396, 868, 754, 581, 827, 0, 29, 445, 931, 629, 348, 202, 1005, 159, 416, 819, 574]"
186,16,4577,1959,8944,0,1141,3436,"[1126, 1025, 43, 512, 308, 1084, 408, 692, 1011, 300, 862, 66, 446, 388, 760, 0, 257, 705, 806, 694, 221, 136, 167, 346, 645, 594, 447]"
187,16,3696,5737,6903,0,3272,424,"[54, 7, 40, 62, 26, 94, 14, 55, 106, 118, 98, 62, 121, 132, 136, 0, 66, 11, 131, 98, 59, 107, 25, 128, 40, 30, 101]"
188,16,4238,5389,5752,0,2472,1766,"[467, 115, 276, 317, 504, 23, 375, 343, 422, 173, 260, 166, 318, 207, 327, 0, 174, 41, 349, 37, 298, 335, 315, 322, 491, 502, 145]"
189,16,4278,2114,7916,0,2844,1434,"[174, 475, 322, 201, 396, 11, 278, 221, 346, 210, 410, 244, 238, 243, 36, 0, 6, 369, 109, 353, 314, 36, 141, 171, 216, 455, 123]"
190,16,4240,6162,5994,0,1925,2315,"[655, 6, 724, 616, 366, 715, 59, 345, 336, 5, 468, 761, 633, 12, 662, 0, 662, 357, 339, 456, 714, 744, 38, 350, 49, 679, 353]"
191,16,4737,1399,9332,0,3881,856,"[96, 254, 165, 264, 69, 39, 275, 120, 152, 127, 62, 215, 50, 31, 64, 0, 195, 243, 242, 27, 71, 285, 236, 12, 162, 107, 83]"
192,16,3030,5940,6422,0,1302,1728,"[11, 446, 63, 153, 59, 322, 106, 162, 563, 347, 151, 574, 87, 256, 534, 0, 32, 472, 491, 404, 545, 63, 402, 52, 511, 421, 47]"
193,16,4261,1291,9392,0,211,4050,"[830, 931, 1240, 643, 758, 454, 1232, 1259, 729, 1134, 754, 708, 1269, 127, 501, 0, 899, 889, 626, 1031, 1256, 630, 1326, 484, 328, 698, 751]"
194,16,4858,7206,7044,0,884,3974,"[83, 603, 330, 214, 731, 77, 885, 1054, 688, 241, 446, 324, 266, 1004, 6, 0, 950, 1040, 865, 928, 1, 279, 846, 647, 846, 606, 397]"
195,16,4212,6749,4507,0,2203,2009,"[234, 25, 511, 473, 607, 537, 40, 107, 596, 384, 527, 341, 163, 522, 3, 0, 366, 438, 642, 651, 273, 522, 384, 401, 177, 365, 516]"
196,16,4954,967,8494,0,893,4061,"[1029, 55, 489, 780, 1250, 916, 1011, 615, 1087, 690, 1075, 162, 106, 780, 1253, 0, 758, 1065, 89, 1331, 941, 1127, 1305, 660, 216, 670, 183]"
197,16,3174,6203,5465,0,2917,257,"[80, 60, 22, 31, 36, 4, 58, 57, 32, 16, 67, 29, 84, 46, 83, 0, 21, 37, 28, 11, 21, 27, 73, 44, 7, 51, 47]"
198,16,4247,3921,5791,0,3072,1175,"[14, 263, 81, 175, 367, 358, 389, 96, 101, 252, 207, 386, 100, 354, 270, 0, 336, 387, 10, 137, 155, 320, 272, 320, 312, 64, 46]"
199,16,3864,2361,7294,0,279,3585,"[370, 926, 1054, 408, 639, 791, 60, 529, 324, 708, 436, 844, 960, 992, 151, 0, 744, 432, 220, 950, 28, 383, 1150, 494, 103, 923, 277]"
200,16,4351,6892,4753,0,700,3651,"[525, 801, 798, 986, 673, 252, 853, 578, 35, 705, 83, 1019, 1086, 264, 583, 0, 584, 618, 1086, 458, 543, 332, 936, 260, 1000, 507, 895]"
201,16,4483,2943,6293,0,3277,1206,"[381, 130, 215, 383, 340, 193, 175, 264, 210, 64, 206, 210, 228, 185, 383, 0, 123, 210, 182, 152, 152, 270, 3, 238, 238, 164, 363]"
202,16,4702,4566,6429,0,490,4212,"[808, 418, 1357, 1389, 681, 186, 131, 1266, 1230, 1019, 880, 1082, 1144, 793, 387, 0, 763, 492, 448, 273, 170, 1314, 560, 1290, 223, 1220, 46]"
203,16,4271,1318,9382,0,2351,1920,"[502, 544, 150, 223, 163, 381, 160, 323, 222, 405, 287, 193, 425, 81, 50, 0, 97, 518, 188, 403, 21, 306, 447, 417, 500, 265, 466]"
204,16,4517,7129,6770,0,2150,2367,"[739, 499, 327, 384, 243, 337, 669, 782, 123, 420, 304, 691, 707, 518, 667, 0, 16, 141, 290, 411, 652, 427, 537, 305, 572, 764, 491]"
205,16,4632,5161,6241,0,2857,1775,"[28, 427, 419, 435, 520, 118, 591, 270, 468, 471, 271, 24, 196, 583, 22, 0, 260, 210, 137, 527, 168, 62, 196, 260, 476, 210, 444]"
206,16,3696,1851,8086,0,2750,946,"[114, 261, 244, 126, 265, 33, 140, 135, 64, 74, 200, 161, 230, 85, 220, 0, 75, 21, 314, 53, 230, 181, 81, 298, 91, 54, 157]"
207,16,4027,6561,5552,0,948,3079,"[235, 558, 611, 636, 803, 490, 935, 718, 604, 994, 663, 235, 199, 505, 639, 0, 268, 344, 548, 189, 381, 637, 121, 472, 314, 112, 154]"
208,16,3012,1965,6599,0,439,2573,"[172, 271, 89, 119, 742, 700, 79, 524, 82, 246, 609, 539, 327, 12, 518, 0, 512, 437, 82, 93, 575, 817, 591, 714, 564, 205, 287]"
209,16,4624,5048,6175,0,1279,3345,"[616, 537, 356, 550, 680, 343, 111, 1008, 859, 310, 19, 282, 398, 908, 786, 0, 651, 1087, 110, 700, 872, 792, 88, 673, 272, 678, 662]"
210,16,3854,170,9859,0,2544,1310,"[33, 284, 237, 153, 254, 303, 185, 240, 277, 271, 411, 419, 32, 388, 75, 0, 132, 53, 86, 181, 191, 67, 248, 319, 432, 262, 297]"
211,16,4265,7275,6849,0,1961,2304,"[454, 421, 329, 515, 292, 199, 456, 258, 183, 606, 68, 309, 5, 548, 227, 0, 684, 566, 506, 580, 593, 547, 556, 226, 756, 513, 514]"
212,16,4576,6241,5184,0,3654,922,"[34, 239, 41, 305, 28, 156, 278, 251, 129, 255, 225, 300, 191, 38, 234, 0, 88, 120, 207, 154, 97, 62, 180, 131, 73, 139, 36]"
213,16,3331,3208,5307,0,55,3276,"[443, 388, 1089, 222, 919, 473, 374, 433, 778, 230, 520, 506, 610, 127, 718, 0, 534, 335, 430, 778, 368, 353, 170, 103, 843, 496, 137]"
214,16,3931,1907,7331,0,709,3222,"[561, 476, 689, 547, 1011, 714, 290, 396, 4, 91, 411, 1009, 910, 994, 442, 0, 279, 765, 969, 246, 300, 326, 703, 854, 398, 917, 118]"
215,16,4057,5708,5680,0,1781,2276,"[316, 597, 498, 329, 404, 631, 584, 183, 371, 436, 478, 282, 261, 137, 702, 0, 259, 718, 42, 475, 230, 182, 321, 559, 510, 340, 110]"
216,16,4535,4039,6176,0,923,3612,"[1130, 219, 228, 906, 1119, 812, 637, 685, 1047, 249, 116, 499, 821, 744, 250, 0, 46, 831, 96, 1086, 35, 883, 326, 995, 554, 843, 778]"
217,16,4179,2489,7866,0,3517,662,"[32, 51, 141, 189, 95, 160, 85, 24, 156, 184, 128, 61, 200, 189, 153, 0, 175, 56, 126, 65, 117, 87, 106, 66, 24, 105, 78]"
218,16,4021,7093,4794,0,2102,1919,"[578, 401, 33, 573, 172, 501, 46, 543, 474, 493, 358, 342, 62, 607, 126, 0, 144, 257, 528, 122, 1, 428, 232, 580, 306, 208, 21]"
219,16,3918,1529,7183,0,16,3902,"[443, 420, 1166, 916, 1184, 632, 967, 477, 373, 543, 929, 158, 147, 26, 482, 0, 597, 1145, 987, 65, 184, 540, 761, 1129, 363, 1051, 796]"
220,16,4340,7146,4377,0,628,3712,"[1106, 13, 933, 328, 253, 589, 759, 843, 313, 409, 55, 739, 1186, 403, 83, 0, 643, 705, 406, 684, 1015, 81, 1032, 493, 53, 49, 1035]"
221,16,3086,1586,5877,0,743,2343,"[176, 16, 176, 224, 614, 649, 560, 436, 88, 639, 171, 302, 407, 639, 33, 0, 663, 16, 647, 412, 620, 585, 593, 680, 238, 438, 42]"
222,16,4038,1516,8399,0,534,3504,"[261, 668, 35, 831, 1115, 736, 45, 231, 432, 1135, 928, 951, 878, 743, 708, 0, 789, 1162, 569, 198, 233, 1113, 49, 446, 331, 204, 307]"
223,16,4935,6193,7141,0,623,4312,"[1106, 224, 873, 365, 774, 1289, 53, 258, 810, 953, 709, 258, 444, 306, 509, 0, 563, 948, 615, 246, 1232, 369, 1324, 398, 836, 872, 114]"
224,16,3347,991,9497,0,1453,1894,"[210, 353, 209, 51, 198, 338, 583, 98, 426, 328, 343, 19, 287, 397, 583, 0, 477, 592, 43, 436, 284, 518, 88, 149, 83, 82, 621]"
225,16,3367,5247,7617,0,1202,2165,"[279, 116, 71, 172, 171, 133, 445, 512, 572, 600, 682, 553, 321, 175, 356, 0, 54, 334, 311, 637, 335, 705, 188, 648, 330, 162, 609]"
226,16,3700,7380,3937,0,1536,2164,"[585, 154, 476, 629, 435, 237, 141, 422, 700, 675, 16, 212, 570, 656, 144, 0, 222, 111, 684, 436, 518, 254, 366, 451, 285, 168, 634]"
227,16,3777,2109,5605,0,635,3142,"[916, 640, 1019, 179, 305, 370, 198, 944, 1, 263, 641, 64, 871, 973, 748, 0, 942, 287, 888, 265, 220, 982, 202, 965, 449, 303, 617]"
228,16,3750,500,8855,0,335,3415,"[557, 520, 825, 473, 841, 588, 40, 291, 1110, 359, 262, 854, 394, 743, 62, 0, 414, 840, 674, 766, 393, 392, 590, 891, 179, 825, 35]"
229,16,3955,6236,6574,0,2108,1847,"[317, 509, 389, 598, 302, 578, 466, 168, 33, 477, 39, 564, 544, 124, 326, 0, 593, 31, 49, 55, 500, 575, 495, 206, 149, 205, 437]"
230,16,3591,283,9882,0,1614,1977,"[281, 377, 405, 425, 472, 533, 100, 325, 632, 288, 416, 287, 47, 434, 418, 0, 312, 173, 311, 15, 397, 473, 162, 599, 315, 417, 75]"
231,16,4731,7263,7350,0,3656,1075,"[341, 99, 17, 305, 174, 238, 113, 238, 242, 320, 212, 135, 315, 309, 25, 0, 203, 357, 121, 299, 291, 90, 75, 3, 200, 202, 152]"
232,16,3615,1667,9298,0,1421,2194,"[714, 581, 409, 568, 127, 569, 11, 708, 480, 313, 29, 431, 504, 413, 282, 0, 469, 303, 43, 585, 160, 222, 364, 494, 507, 281, 455]"
233,16,3236,6627,5907,0,751,2485,"[732, 440, 507, 671, 696, 216, 171, 337, 363, 343, 226, 405, 110, 597, 1, 0, 778, 50, 641, 788, 66, 310, 301, 26, 417, 800, 124]"
234,16,3129,1436,7600,0,1133,1996,"[185, 149, 586, 149, 323, 34, 345, 259, 17, 405, 399, 485, 147, 546, 524, 0, 413, 31, 361, 451, 457, 239, 583, 659, 334, 374, 144]"
235,16,3431,6321,4710,0,3417,14,"[1, 1, 4, 2, 2, 0, 3, 1, 4, 2, 1, 3, 1, 3, 3, 0, 3, 3, 3, 1, 0, 4, 0, 3, 2, 0, 0]"
236,16,3557,3447,4820,0,1437,2120,"[622, 218, 85, 283, 407, 255, 570, 16, 681, 592, 393, 396, 118, 329, 227, 0, 420, 182, 497, 223, 82, 129, 656, 591, 54, 489, 584]"
237,16,3185,660,7345,0,68,3117,"[1004, 19, 324, 575, 974, 872, 583, 532, 238, 754, 380, 414, 198, 1013, 294, 0, 882, 42, 787, 771, 883, 1018, 621, 916, 237, 721, 859]"
238,16,4285,7163,4467,0,2996,1289,"[341, 243, 355, 216, 334, 229, 208, 293, 44, 184, 97, 64, 336, 232, 18, 0, 348, 168, 392, 302, 101, 309, 162, 249, 26, 422, 286]"
239,16,3314,253,7528,0,1356,1958,"[104, 420, 21, 172, 513, 490, 223, 64, 391, 411, 295, 211, 346, 234, 378, 0, 239, 129, 633, 415, 132, 183, 571, 212, 205, 28, 646]"
240,16,4380,6480,5428,0,1501,2879,"[363, 453, 280, 244, 270, 21, 590, 615, 907, 143, 221, 944, 700, 540, 332, 0, 433, 753, 569, 761, 31, 911, 301, 120, 857, 417, 761]"
241,16,4437,2341,7524,0,223,4214,"[1104, 808, 359, 1272, 948, 87, 602, 551, 1164, 1095, 488, 972, 1016, 712, 37, 0, 881, 1153, 111, 1168, 333, 102, 1402, 1139, 764, 1300, 1013]"
242,16,3948,5751,5721,0,3807,141,"[46, 40, 39, 30, 17, 24, 13, 19, 40, 22, 17, 42, 13, 45, 37, 0, 29, 3, 5, 34, 37, 14, 6, 6, 42, 4, 25]"
243,16,4019,323,9417,0,1292,2727,"[417, 831, 881, 636, 695, 130, 293, 856, 157, 412, 289, 723, 798, 119, 394, 0, 735, 743, 543, 440, 742, 703, 109, 292, 59, 771, 38]"
244,16,4561,5561,8417,0,412,4149,"[345, 11, 1156, 413, 871, 1089, 630, 393, 911, 218, 1186, 537, 1107, 1153, 161, 0, 814, 1250, 79, 1300, 544, 952, 1037, 97, 67, 710, 1382]"
245,16,4283,7473,5227,0,3371,912,"[158, 153, 224, 264, 301, 208, 204, 153, 41, 73, 203, 39, 63, 148, 205, 0, 263, 262, 154, 154, 183, 192, 28, 20, 123, 58, 3]"
246,16,4157,1857,7527,0,4152,5,"[1, 1, 0, 0, 1, 0, 0, 1, 0, 1, 0, 0, 0, 0, 1, 0, 0, 0, 0, 0, 0, 1, 0, 1, 0, 0, 0]"
247,16,3351,109,10000,769,2624,727,"[221, 146, 235, 224, 197, 16, 230, 166, 101, 225, 149, 15, 55, 242, 84, 0, 167, 241, 19, 44, 54, 15, 27, 111, 68, 133, 42]"
248,16,3482,5580,7902,0,534,2948,"[816, 408, 68, 945, 942, 516, 310, 970, 826, 35, 150, 325, 100, 45, 25, 0, 452, 359, 48, 698, 976, 743, 587, 976, 811, 382, 510]"
249,16,3965,6253,5614,0,1799,2166,"[99, 224, 194, 231, 562, 452, 667, 715, 624, 480, 594, 386, 477, 451, 656, 0, 173, 409, 218, 400, 476, 694, 83, 285, 528, 334, 285]"
250,16,4503,3850,6267,0,2343,2160,"[473, 489, 30, 314, 638, 60, 365, 56, 41, 608, 21, 629, 305, 124, 330, 0, 129, 106, 417, 175, 501, 636, 438, 140, 83, 391, 452]"
251,16,3446,984,8729,0,1658,1788,"[586, 511, 95, 86, 195, 65, 61, 199, 290, 247, 556, 284, 207, 258, 210, 0, 261, 310, 93, 477, 265, 88, 147, 310, 154, 197, 54]"
252,16,3561,6987,5303,0,1817,1744,"[239, 45, 2, 117, 115, 110, 378, 170, 363, 0, 396, 370, 77, 486, 49, 0, 75, 47, 425, 101, 295, 262, 291, 90, 99, 315, 69]"
253,16,3954,3325,5932,0,3822,132,"[41, 9, 6, 44, 2, 11, 34, 39, 37, 34, 4, 8, 16, 22, 14, 0, 2, 22, 14, 17, 20, 9, 20, 26, 28, 24, 28]"
254,16,3566,2398,7100,0,2524,1042,"[148, 259, 29, 153, 116, 277, 300, 277, 145, 88, 19, 221, 182, 332, 256, 0, 322, 154, 188, 197, 213, 304, 247, 333, 31, 302, 344]"
255,16,3390,3344,7146,0,3228,162,"[23, 54, 45, 52, 43, 49, 12, 52, 46, 22, 40, 37, 32, 38, 27, 0, 11, 53, 7, 34, 11, 0, 36, 50, 22, 30, 50]"
256,16,3797,2923,8020,0,1828,1969,"[162, 307, 456, 229, 359, 577, 84, 281, 606, 251, 425, 52, 608, 304, 348, 0, 31, 398, 42, 652, 492, 279, 214, 324, 211, 42, 153]"
257,16,4023,6131,5912,0,547,3476,"[45, 881, 389, 562, 1117, 96, 815, 841, 769, 1105, 1118, 11, 488, 301, 658, 0, 73, 168, 137, 487, 520, 328, 151, 1092, 88, 141, 908]"
258,16,4329,2357,7884,0,263,4066,"[392, 950, 103, 515, 122, 283, 1041, 61, 1216, 96, 1121, 1130, 485, 1337, 1055, 0, 247, 17, 965, 224, 520, 176, 864, 221, 378, 675, 202]"
259,16,3677,5850,5711,0,329,3348,"[819, 444, 190, 785, 784, 664, 1052, 679, 1051, 700, 331, 551, 370, 618, 955, 0, 716, 220, 747, 153, 434, 1115, 96, 297, 39, 315, 1114]"
260,16,4706,1318,9099,0,1510,3196,"[385, 450, 931, 358, 846, 465, 707, 1024, 263, 24, 401, 996, 405, 438, 88, 0, 806, 1043, 604, 764, 457, 846, 573, 515, 845, 247, 305]"
261,16,3111,6293,5917,0,2016,1095,"[66, 180, 94, 0, 112, 347, 113, 44, 243, 181, 91, 74, 100, 103, 75, 0, 180, 19, 176, 85, 82, 213, 42, 280, 68, 71, 220]"
262,16,4736,2421,8232,0,4538,198,"[20, 49, 42, 3, 15, 2, 53, 2, 58, 45, 47, 32, 32, 35, 4, 0, 64, 59, 41, 44, 42, 5, 49, 21, 63, 65, 62]"
263,16,3321,6581,4972,0,2885,436,"[99, 98, 145, 118, 10, 125, 119, 14, 47, 140, 92, 56, 54, 66, 120, 0, 20, 73, 115, 144, 36, 39, 19, 32, 118, 74, 36]"
264,16,3001,1613,6360,0,609,2392,"[205, 776, 19, 702, 537, 162, 154, 642, 701, 601, 285, 766, 307, 684, 146, 0, 544, 452, 295, 732, 49, 357, 720, 272, 600, 694, 205]"
265,16,3907,3863,6404,0,302,3605,"[1132, 743, 427, 75, 1044, 268, 308, 1112, 362, 75, 973, 893, 0, 382, 763, 0, 227, 739, 757, 878, 297, 145, 355, 1185, 740, 844, 137]"
266,16,3556,3227,6733,0,1087,2469,"[428, 793, 88, 817, 237, 693, 715, 165, 430, 255, 784, 134, 507, 324, 751, 0, 610, 757, 788, 708, 507, 782, 446, 268, 823, 165, 760]"
267,16,3215,2156,7792,0,2334,881,"[165, 50, 198, 120, 245, 159, 76, 11, 72, 220, 195, 238, 244, 45, 156, 0, 146, 17, 171, 116, 263, 250, 135, 112, 21, 180, 202]"
268,16,4680,7395,5077,0,2144,2536,"[129, 829, 375, 818, 591, 759, 367, 95, 264, 200, 88, 274, 306, 337, 183, 0, 672, 800, 14, 466, 280, 74, 61, 442, 339, 814, 297]"
269,16,4616,4338,5355,0,1812,2804,"[110, 395, 799, 620, 685, 563, 101, 773, 368, 676, 836, 888, 635, 497, 712, 0, 672, 592, 543, 284, 173, 92, 673, 856, 758, 623, 264]"
270,16,4936,3949,6342,0,2123,2813,"[809, 928, 854, 833, 398, 2, 22, 252, 889, 606, 735, 924, 713, 480, 586, 0, 727, 330, 292, 671, 696, 1, 48, 885, 779, 451, 411]"
271,16,3487,1247,8582,0,1693,1794,"[101, 54, 597, 213, 11, 242, 504, 161, 261, 586, 98, 77, 489, 44, 90, 0, 187, 158, 258, 481, 347, 230, 547, 53, 364, 316, 174]"
272,16,3726,7147,5161,0,2096,1630,"[300, 277, 141, 87, 161, 351, 124, 398, 384, 539, 93, 109, 278, 425, 445, 0, 311, 365, 176, 459, 82, 37, 387, 234, 477, 213, 83]"
273,16,4008,2780,6389,0,566,3442,"[676, 167, 258, 115, 769, 665, 585, 414, 200, 182, 762, 343, 1127, 1073, 283, 0, 198, 688, 1071, 478, 543, 424, 922, 850, 515, 1023, 1044]"
274,16,3195,1060,8524,0,2515,680,"[208, 214, 129, 190, 75, 178, 60, 74, 112, 70, 51, 67, 185, 33, 170, 0, 3, 9, 102, 55, 115, 136, 111, 114, 52, 156, 192]"
275,16,3260,6813,4971,0,454,2806,"[888, 477, 296, 518, 70, 512, 726, 463, 528, 675, 201, 211, 626, 347, 556, 0, 322, 786, 72, 383, 658, 711, 47, 665, 517, 581, 934]"
276,16,3102,1523,6550,0,2674,428,"[59, 135, 125, 79, 129, 71, 122, 97, 28, 113, 88, 55, 135, 142, 53, 0, 125, 39, 75, 110, 81, 52, 70, 132, 126, 54, 49]"
277,16,3530,1884,8196,0,769,2761,"[661, 307, 259, 422, 728, 621, 565, 763, 527, 729, 183, 606, 581, 149, 422, 0, 305, 642, 801, 523, 512, 50, 812, 672, 646, 528, 734]"
278,16,3777,6097,5876,0,3549,228,"[5, 32, 22, 26, 61, 26, 39, 11, 55, 66, 76, 52, 41, 42, 71, 0, 48, 70, 66, 66, 75, 49, 5, 5, 33, 71, 10]"
279,16,3030,586,8320,0,1507,1523,"[270, 232, 336, 496, 158, 419, 484, 311, 25, 379, 443, 412, 320, 396, 122, 0, 335, 73, 134, 285, 308, 429, 464, 272, 81, 20, 507]"
280,16,4405,7021,5704,0,676,3729,"[1154, 1071, 159, 851, 804, 401, 1123, 749, 548, 1110, 42, 691, 1096, 1224, 855, 0, 587, 1060, 162, 726, 779, 211, 1118, 434, 175, 995, 565]"
281,16,3147,476,8375,0,501,2646,"[19, 365, 41, 482, 64, 501, 551, 561, 189, 870, 114, 763, 66, 807, 549, 0, 433, 281, 91, 465, 364, 196, 372, 858, 795, 617, 340]"
282,16,4348,6735,5988,0,121,4227,"[1193, 100, 382, 294, 1402, 426, 937, 781, 1217, 1048, 1150, 827, 1325, 89, 817, 0, 783, 472, 1033, 395, 1044, 41, 1038, 1137, 534, 286, 283]"
283,16,3564,2248,7304,0,2849,715,"[94, 35, 36, 14, 64, 56, 128, 137, 81, 12, 74, 1, 31, 59, 149, 0, 113, 216, 153, 136, 209, 59, 98, 105, 117, 80, 133]"
284,16,4193,5391,6106,0,2206,1987,"[384, 575, 544, 211, 148, 7, 28, 223, 446, 406, 189, 247, 115, 269, 89, 0, 404, 122, 328, 610, 577, 135, 407, 203, 347, 108, 342]"
285,16,4001,2759,7348,0,2560,1441,"[296, 39, 379, 406, 228, 463, 246, 214, 309, 395, 147, 174, 280, 427, 427, 0, 100, 241, 464, 109, 78, 183, 152, 371, 421, 39, 7]"
286,16,4014,5467,5895,0,1508,2506,"[789, 3, 632, 199, 518, 427, 706, 57, 507, 550, 822, 298, 560, 607, 109, 0, 45, 520, 70, 381, 473, 22, 197, 209, 301, 475, 454]"
287,16,3825,3028,6692,0,2669,1156,"[353, 334, 222, 196, 385, 342, 167, 164, 318, 375, 58, 23, 17, 160, 246, 0, 261, 307, 381, 86, 278, 59, 229, 189, 22, 181, 266]"
288,16,3602,875,9419,0,3066,536,"[81, 44, 143, 7, 174, 73, 84, 141, 178, 19, 31, 2, 101, 3, 57, 0, 122, 135, 5, 2, 172, 17, 70, 98, 2, 19, 177]"
289,16,4739,7048,7110,0,2739,2000,"[342, 389, 42, 13, 143, 3, 612, 538, 567, 316, 6, 659, 436, 377, 1, 0, 558, 339, 323, 353, 37, 334, 393, 191, 283, 148, 34]"
290,16,3477,1335,9252,0,811,2666,"[289, 432, 730, 441, 64, 685, 515, 379, 722, 658, 131, 684, 244, 131, 774, 0, 4, 580, 770, 397, 446, 10, 688, 7, 761, 416, 126]"
291,16,3012,6960,5304,0,2218,794,"[61, 224, 6, 126, 260, 132, 127, 190, 51, 174, 77, 70, 227, 93, 22, 0, 194, 128, 176, 223, 71, 0, 196, 22, 128, 229, 15]"
292,16,4096,2849,6551,0,259,3837,"[676, 1123, 736, 355, 595, 710, 765, 733, 673, 519, 306, 447, 947, 620, 983, 0, 1113, 828, 1129, 848, 832, 496, 1184, 523, 113, 791, 164]"
293,16,3746,2489,7808,0,2622,1124,"[122, 135, 171, 8, 176, 272, 297, 113, 246, 306, 276, 175, 91, 369, 38, 0, 116, 350, 161, 141, 121, 347, 126, 156, 143, 60, 300]"
294,16,4750,7192,5366,0,3734,1016,"[106, 126, 253, 94, 137, 105, 210, 66, 31, 32, 79, 129, 151, 46, 331, 0, 252, 210, 310, 174, 102, 223, 155, 130, 24, 167, 231]"
295,16,3618,598,8386,0,1838,1780,"[458, 198, 341, 451, 330, 197, 275, 253, 215, 64, 500, 559, 364, 330, 115, 0, 292, 70, 366, 321, 115, 118, 222, 437, 261, 548, 112]"
296,16,3497,6971,4912,0,1526,1971,"[221, 201, 190, 91, 274, 314, 501, 255, 25, 570, 297, 36, 339, 491, 216, 0, 462, 385, 629, 613, 278, 566, 284, 158, 607, 508, 211]"
297,16,3396,3288,5020,0,1191,2205,"[28, 238, 273, 692, 186, 4, 190, 128, 180, 668, 99, 163, 154, 144, 700, 0, 544, 7, 86, 33, 231, 87, 577, 133, 644, 509, 54]"
298,16,4879,1481,8418,0,3948,931,"[220, 119, 175, 40, 98, 235, 58, 256, 45, 54, 181, 290, 201, 27, 223, 0, 87, 276, 51, 230, 139, 70, 291, 19, 306, 10, 1]"
299,16,3808,7276,4950,0,3225,583,"[43, 44, 71, 11, 83, 60, 180, 146, 182, 141, 55, 36, 1, 27, 82, 0, 128, 138, 173, 20, 139, 159, 115, 190, 65, 84, 0]"
0,17,3029,0,3029,0,1858,1171,"[327, 197, 144, 226, 351, 10, 116, 118, 227, 352, 53, 324, 244, 143, 256, 0, 0, 201, 88, 232, 181, 10, 75, 378, 160, 359, 49]"
1,17,4592,2852,4769,0,1844,2748,"[832, 627, 894, 844, 794, 399, 621, 756, 702, 606, 484, 131, 819, 212, 249, 31, 0, 739, 883, 347, 737, 232, 199, 840, 157, 310, 627]"
2,17,3982,3021,5730,0,3178,804,"[63, 186, 227, 195, 252, 219, 189, 199, 89, 40, 126, 33, 192, 61, 257, 84, 0, 53, 69, 103, 18, 80, 120, 63, 100, 89, 238]"
3,17,4943,3142,7531,0,1919,3024,"[271, 157, 255, 538, 251, 362, 656, 189, 241, 595, 434, 640, 403, 808, 576, 388, 0, 121, 297, 617, 971, 75, 765, 975, 610, 898, 501]"
4,17,4641,5417,6755,0,1018,3623,"[50, 486, 227, 323, 728, 674, 220, 231, 1176, 417, 1048, 483, 559, 864, 648, 60, 0, 229, 631, 763, 1072, 629, 1122, 346, 556, 316, 1014]"
5,17,4557,5721,5591,0,769,3788,"[636, 996, 226, 1256, 35, 418, 564, 706, 826, 1262, 517, 1152, 373, 124, 895, 1047, 0, 1091, 1031, 735, 373, 464, 334, 66, 811, 1067, 943]"
6,17,3237,2599,6229,0,1913,1324,"[87, 427, 1, 304, 74, 102, 344, 200, 98, 201, 3, 104, 141, 281, 209, 324, 0, 286, 217, 189, 24, 276, 76, 258, 220, 436, 136]"
7,17,3872,3142,6959,0,2652,1220,"[189, 191, 115, 103, 350, 163, 179, 228, 249, 197, 263, 376, 29, 27, 326, 350, 0, 70, 225, 345, 388, 169, 364, 386, 90, 81, 372]"
8,17,3397,2574,7782,0,2378,1019,"[160, 118, 13, 99, 160, 322, 9, 72, 37, 149, 257, 86, 282, 99, 124, 22, 0, 244, 291, 120, 84, 75, 58, 10, 53, 81, 29]"
9,17,4746,6185,6343,0,395,4351,"[1294, 714, 40, 833, 1158, 256, 757, 988, 216, 1289, 23, 1210, 1005, 1328, 55, 722, 0, 393, 895, 364, 156, 576, 1117, 421, 748, 120, 44]"
10,17,4390,2997,7736,0,2759,1631,"[223, 319, 301, 4, 50, 379, 514, 347, 289, 240, 249, 282, 340, 392, 273, 288, 0, 515, 71, 541, 169, 247, 252, 446, 283, 96, 390]"
11,17,4363,6085,6014,0,2376,1987,"[401, 628, 388, 128, 52, 20, 479, 499, 573, 180, 555, 426, 147, 547, 109, 254, 0, 274, 95, 507, 159, 386, 38, 651, 637, 645, 568]"
12,17,3582,2756,6840,0,2631,951,"[60, 142, 277, 253, 9, 264, 74, 265, 58, 157, 305, 177, 115, 173, 53, 36, 0, 18, 282, 156, 2, 129, 86, 307, 275, 29, 57]"
13,17,3626,2477,7989,0,1657,1969,"[233, 376, 208, 652, 593, 22, 542, 336, 147, 113, 149, 343, 400, 51, 466, 625, 0, 276, 344, 569, 546, 129, 320, 354, 376, 337, 302]"
14,17,3486,6244,5231,0,3057,429,"[91, 87, 137, 67, 1, 140, 95, 70, 37, 103, 16, 94, 33, 15, 74, 77, 0, 94, 66, 57, 102, 91, 58, 108, 133, 97, 1]"
15,17,3475,3456,5250,0,2487,988,"[268, 49, 298, 68, 102, 36, 245, 299, 252, 257, 316, 55, 92, 75, 318, 243, 0, 328, 45, 120, 319, 121, 329, 215, 288, 295, 44]"
16,17,3310,2565,5995,0,3241,69,"[2, 22, 5, 15, 16, 17, 8, 22, 3, 11, 10, 7, 9, 1, 18, 19, 0, 3, 15, 11, 22, 10, 20, 14, 4, 16, 17]"
17,17,4665,4435,6225,0,2947,1718,"[442, 61, 359, 335, 261, 543, 60, 287, 510, 413, 430, 199, 347, 518, 86, 158, 0, 33, 217, 133, 51, 258, 137, 522, 208, 375, 212]"
18,17,3254,2474,7005,0,3080,174,"[35, 57, 0, 6, 34, 22, 12, 8, 19, 7, 32, 34, 3, 12, 46, 38, 0, 2, 13, 38, 13, 15, 13, 32, 1, 50, 56]"
19,17,4145,5456,5694,0,3251,894,"[95, 27, 56, 54, 40, 189, 291, 101, 28, 246, 283, 28, 236, 55, 74, 98, 0, 37, 58, 267, 128, 58, 234, 139, 268, 74, 67]"
20,17,4814,958,9550,0,4332,482,"[158, 2, 17, 27, 93, 155, 81, 1, 17, 77, 43, 120, 26, 20, 72, 71, 0, 132, 100, 140, 49, 9, 154, 160, 66, 128, 115]"
21,17,3398,6036,6912,0,241,3157,"[144, 557, 892, 674, 561, 1004, 26, 910, 528, 106, 8, 65, 368, 82, 754, 735, 0, 975, 709, 981, 411, 782, 503, 561, 279, 370, 37]"
22,17,3040,1358,8594,0,286,2754,"[726, 860, 33, 577, 23, 348, 887, 42, 744, 724, 763, 253, 739, 874, 784, 640, 0, 211, 859, 879, 839, 322, 321, 144, 412, 561, 378]"
23,17,3587,5530,6651,0,2436,1151,"[308, 268, 102, 285, 318, 263, 117, 132, 312, 47, 218, 298, 140, 39, 12, 182, 0, 174, 280, 363, 170, 266, 374, 21, 177, 366, 191]"
24,17,4325,1058,9918,0,985,3340,"[518, 416, 1108, 906, 262, 94, 1050, 835, 78, 803, 461, 752, 437, 385, 121, 551, 0, 496, 707, 220, 262, 941, 445, 700, 944, 1011, 1101]"
25,17,4477,5819,8576,0,2223,2254,"[25, 596, 475, 361, 397, 731, 149, 741, 109, 645, 688, 276, 564, 252, 716, 366, 0, 242, 544, 115, 366, 541, 366, 368, 674, 152, 291]"
26,17,4827,5895,7508,0,107,4720,"[93, 332, 846, 474, 1541, 346, 201, 946, 720, 1084, 229, 875, 34, 350, 1398, 744, 0, 1557, 55, 814, 75, 8, 91, 96, 335, 1068, 796]"
27,17,4887,7042,5353,0,4559,328,"[13, 7, 47, 85, 102, 2, 27, 30, 36, 84, 35, 47, 39, 0, 63, 28, 0, 43, 28, 69, 74, 9, 21, 68, 46, 25, 32]"
28,17,3360,2218,6495,0,1779,1581,"[466, 178, 409, 282, 298, 299, 357, 518, 437, 284, 265, 263, 102, 330, 482, 171, 0, 519, 78, 140, 334, 242, 427, 142, 446, 472, 232]"
29,17,4023,2700,7818,0,705,3318,"[154, 310, 706, 1106, 335, 558, 273, 630, 747, 906, 692, 1014, 987, 920, 961, 681, 0, 575, 815, 794, 667, 995, 60, 504, 183, 899, 569]"
30,17,3652,7333,4137,0,3222,430,"[24, 115, 37, 18, 18, 15, 15, 8, 18, 85, 103, 87, 19, 134, 20, 10, 0, 50, 115, 93, 8, 72, 47, 55, 19, 49, 12]"
31,17,3065,479,6723,0,836,2229,"[98, 645, 285, 182, 164, 637, 674, 492, 423, 430, 72, 189, 232, 49, 252, 679, 0, 675, 152, 739, 602, 410, 620, 576, 15, 96, 364]"
32,17,4289,7308,3704,0,4284,5,"[1, 0, 1, 1, 0, 0, 1, 0, 0, 1, 1, 1, 0, 1, 1, 1, 0, 0, 1, 0, 0, 0, 0, 0, 1, 1, 1]"
33,17,4582,3852,4434,0,1994,2588,"[11, 50, 223, 776, 100, 485, 540, 682, 320, 18, 290, 838, 70, 523, 593, 782, 0, 364, 832, 603, 684, 224, 532, 709, 96, 790, 385]"
34,17,3901,900,7435,0,2974,927,"[7, 201, 19, 95, 258, 136, 261, 184, 108, 137, 89, 117, 206, 177, 285, 64, 0, 60, 4, 138, 200, 162, 166, 170, 128, 169, 172]"
35,17,3222,2557,8100,0,1990,1232,"[401, 177, 352, 372, 247, 192, 73, 291, 241, 371, 394, 311, 354, 282, 297, 76, 0, 193, 160, 297, 48, 166, 44, 117, 361, 63, 147]"
36,17,4234,6432,5902,0,383,3851,"[466, 732, 1042, 263, 1133, 913, 1220, 980, 1044, 427, 232, 1134, 1209, 580, 1060, 1153, 0, 425, 726, 185, 340, 1005, 141, 12, 244, 1271, 338]"
37,17,3131,200,8833,0,1501,1630,"[183, 533, 374, 254, 207, 339, 459, 501, 403, 362, 161, 466, 52, 169, 321, 345, 0, 480, 264, 209, 512, 167, 278, 522, 185, 36, 342]"
38,17,4595,6599,6829,0,3872,723,"[43, 12, 16, 206, 82, 22, 30, 116, 17, 33, 190, 69, 231, 194, 198, 209, 0, 80, 48, 199, 89, 34, 138, 180, 192, 5, 149]"
39,17,3036,3004,6861,0,2427,609,"[152, 193, 29, 141, 41, 112, 195, 108, 131, 50, 130, 184, 49, 146, 151, 146, 0, 166, 87, 64, 133, 77, 131, 112, 109, 198, 189]"
40,17,3290,2315,7836,0,1445,1845,"[542, 98, 363, 589, 560, 191, 524, 12, 474, 85, 293, 419, 155, 352, 166, 224, 0, 72, 34, 3, 6, 26, 520, 15, 357, 370, 326]"
41,17,4869,7317,5388,0,574,4295,"[1306, 1160, 303, 288, 1019, 222, 1017, 1093, 948, 226, 835, 1061, 169, 35, 46, 225, 0, 719, 936, 382, 1075, 83, 824, 621, 648, 1167, 1184]"
42,17,4986,1300,9074,0,2876,2110,"[620, 443, 60, 421, 101, 554, 271, 678, 172, 269, 95, 81, 399, 437, 611, 189, 0, 230, 334, 564, 100, 57, 0, 103, 458, 451, 674]"
43,17,3798,5286,7586,0,527,3271,"[667, 801, 666, 1005, 767, 678, 588, 655, 342, 155, 243, 506, 499, 740, 1013, 371, 0, 4, 993, 957, 857, 868, 68, 549, 794, 608, 863]"
44,17,4803,7436,4953,0,1600,3203,"[898, 420, 661, 72, 802, 793, 791, 342, 1038, 828, 213, 647, 302, 1052, 534, 126, 0, 925, 86, 467, 111, 825, 426, 746, 340, 583, 694]"
45,17,4047,3864,5136,0,1135,2912,"[420, 871, 531, 456, 853, 193, 12, 843, 670, 18, 502, 38, 179, 191, 324, 878, 0, 285, 53, 141, 202, 857, 255, 884, 344, 468, 483]"
46,17,3455,2292,6299,0,224,3231,"[1023, 587, 523, 456, 968, 978, 391, 100, 383, 172, 106, 315, 891, 385, 417, 771, 0, 145, 277, 183, 576, 615, 919, 579, 142, 509, 532]"
47,17,4794,6713,4380,0,2121,2673,"[851, 469, 598, 693, 720, 615, 453, 255, 160, 332, 659, 748, 77, 2, 737, 105, 0, 198, 92, 704, 482, 367, 872, 636, 637, 676, 688]"
48,17,4380,2063,6697,0,412,3968,"[231, 341, 932, 280, 43, 214, 375, 569, 802, 864, 1302, 538, 880, 1111, 288, 687, 0, 489, 583, 178, 1263, 1188, 43, 71, 999, 463, 579]"
49,17,4823,6978,4542,0,951,3872,"[989, 784, 675, 152, 1090, 566, 588, 1032, 909, 492, 238, 547, 147, 486, 1089, 858, 0, 436, 494, 487, 598, 736, 738, 217, 1010, 720, 1224]"
50,17,3476,452,7566,0,829,2647,"[532, 68, 41, 191, 334, 431, 82, 479, 257, 801, 266, 186, 788, 281, 701, 828, 0, 86, 504, 384, 292, 175, 562, 502, 159, 447, 507]"
51,17,3888,6300,5154,0,2934,954,"[53, 41, 87, 127, 53, 209, 181, 48, 40, 180, 69, 272, 135, 218, 248, 193, 0, 255, 307, 203, 268, 106, 92, 44, 94, 139, 301]"
52,17,4400,1227,8327,0,4051,349,"[92, 44, 68, 47, 2, 105, 82, 87, 91, 90, 36, 75, 79, 10, 2, 43, 0, 0, 40, 75, 75, 30, 22, 32, 32, 62, 54]"
53,17,4338,5989,6676,0,15,4323,"[20, 272, 230, 247, 273, 369, 401, 428, 533, 196, 804, 1102, 774, 1338, 1361, 423, 0, 504, 840, 101, 605, 14, 915, 1391, 1360, 372, 1407]"
54,17,3606,120,10000,162,852,2754,"[778, 77, 64, 551, 20, 65, 321, 350, 911, 284, 851, 14, 546, 82, 347, 74, 0, 87, 338, 632, 509, 487, 159, 77, 825, 520, 739]"
55,17,4449,6035,8414,0,3559,890,"[260, 154, 282, 287, 125, 149, 162, 81, 271, 53, 173, 269, 249, 243, 61, 15, 0, 55, 91, 250, 148, 139, 115, 36, 241, 295, 244]"
56,17,4184,5637,6961,0,2135,2049,"[515, 472, 125, 151, 206, 253, 334, 372, 287, 279, 295, 314, 555, 167, 447, 528, 0, 578, 275, 604, 56, 381, 256, 328, 358, 475, 660]"
57,17,4554,5279,6236,0,1071,3483,"[1049, 191, 201, 321, 38, 1134, 813, 46, 101, 894, 235, 923, 1017, 319, 752, 505, 0, 1107, 823, 1079, 272, 748, 322, 186, 1073, 796, 241]"
58,17,4755,3047,7944,0,1553,3202,"[946, 533, 730, 302, 559, 65, 368, 748, 418, 232, 228, 567, 30, 747, 780, 105, 0, 455, 482, 746, 538, 802, 742, 129, 893, 1019, 239]"
59,17,3756,6749,4951,0,1078,2678,"[776, 43, 486, 182, 560, 581, 594, 139, 456, 789, 141, 564, 112, 802, 39, 521, 0, 699, 573, 702, 682, 769, 236, 597, 778, 628, 252]"
60,17,3502,3486,4967,0,1895,1607,"[505, 507, 484, 196, 308, 298, 89, 61, 80, 109, 33, 163, 210, 376, 376, 80, 0, 294, 433, 324, 331, 404, 75, 205, 212, 473, 61]"
61,17,3548,2612,5903,0,3243,305,"[76, 76, 7, 91, 11, 58, 10, 0, 18, 20, 51, 52, 19, 54, 98, 90, 0, 65, 94, 69, 53, 66, 46, 32, 93, 23, 22]"
62,17,4336,1839,8400,0,2363,1973,"[232, 574, 649, 408, 264, 441, 541, 554, 282, 545, 302, 288, 140, 153, 102, 78, 0, 438, 597, 148, 143, 387, 332, 178, 247, 206, 525]"
63,17,3302,6403,5299,0,1947,1355,"[359, 179, 189, 117, 414, 121, 176, 194, 328, 416, 197, 73, 31, 80, 73, 18, 0, 382, 392, 268, 380, 436, 373, 349, 76, 403, 244]"
64,17,3456,3393,5362,0,882,2574,"[808, 310, 130, 573, 775, 460, 476, 238, 602, 644, 266, 94, 475, 189, 193, 770, 0, 699, 251, 857, 610, 126, 64, 702, 588, 753, 371]"
65,17,4189,3814,5737,0,3990,199,"[15, 13, 4, 20, 61, 65, 0, 6, 27, 5, 47, 44, 10, 2, 20, 15, 0, 30, 50, 15, 5, 40, 29, 26, 18, 26, 18]"
66,17,3295,214,8818,0,1657,1638,"[359, 166, 204, 254, 494, 10, 63, 201, 30, 152, 35, 160, 220, 526, 49, 259, 0, 376, 427, 61, 276, 346, 540, 430, 314, 48, 160]"
67,17,4153,5878,7093,0,398,3755,"[237, 1083, 928, 615, 529, 1127, 213, 980, 832, 435, 456, 913, 657, 725, 496, 599, 0, 1045, 599, 323, 1218, 808, 117, 402, 1093, 558, 1008]"
68,17,3188,1812,8469,0,591,2597,"[173, 190, 830, 232, 86, 28, 253, 112, 504, 632, 565, 639, 854, 389, 417, 785, 0, 8, 779, 212, 337, 101, 274, 692, 558, 1, 667]"
69,17,3606,7474,4601,0,3536,70,"[9, 14, 19, 5, 4, 23, 23, 5, 18, 16, 9, 19, 15, 22, 19, 18, 0, 23, 11, 23, 9, 6, 8, 9, 15, 10, 4]"
70,17,3531,1498,6634,0,428,3103,"[1025, 493, 114, 196, 601, 303, 67, 553, 670, 938, 102, 197, 110, 601, 535, 826, 0, 835, 491, 650, 384, 357, 266, 883, 408, 87, 194]"
71,17,3343,998,8979,0,120,3223,"[650, 413, 491, 612, 132, 910, 31, 951, 465, 597, 319, 983, 505, 502, 963, 732, 0, 324, 754, 91, 699, 339, 307, 1013, 669, 178, 380]"
72,17,3985,6230,6734,0,2665,1320,"[222, 229, 206, 421, 151, 399, 68, 162, 61, 72, 340, 405, 58, 332, 437, 93, 0, 388, 104, 290, 410, 422, 438, 173, 300, 156, 327]"
73,17,4088,3757,7065,0,2887,1201,"[35, 187, 120, 41, 384, 6, 271, 77, 114, 56, 83, 2, 209, 186, 30, 293, 0, 4, 201, 394, 257, 122, 118, 374, 4, 100, 18]"
74,17,3134,2168,8031,0,3029,105,"[23, 19, 33, 3, 20, 17, 9, 4, 28, 10, 0, 13, 27, 4, 24, 34, 0, 8, 29, 19, 1, 27, 32, 7, 9, 2, 31]"
75,17,4421,5978,6474,0,3392,1029,"[98, 50, 69, 71, 29, 121, 161, 52, 110, 192, 230, 196, 288, 112, 195, 19, 0, 275, 175, 335, 266, 205, 319, 193, 326, 7, 334]"
76,17,4705,7473,3706,0,2935,1770,"[273, 503, 509, 65, 380, 218, 566, 166, 32, 26, 509, 514, 347, 515, 312, 34, 0, 310, 469, 517, 252, 136, 267, 240, 76, 193, 371]"
77,17,3029,1089,5646,0,2628,401,"[55, 26, 112, 22, 116, 113, 6, 82, 45, 95, 85, 109, 60, 121, 118, 105, 0, 41, 87, 23, 62, 35, 65, 61, 72, 5, 25]"
78,17,4670,97,10000,219,2386,2284,"[328, 152, 225, 159, 306, 686, 237, 682, 129, 556, 151, 651, 531, 238, 691, 689, 0, 468, 424, 563, 626, 287, 180, 68, 346, 473, 752]"
79,17,3094,5804,7290,0,445,2649,"[263, 83, 41, 154, 810, 846, 308, 661, 839, 690, 608, 865, 481, 165, 38, 496, 0, 815, 395, 410, 592, 88, 386, 135, 601, 808, 13]"
80,17,3571,2556,8305,0,1211,2360,"[489, 690, 359, 217, 585, 62, 539, 398, 117, 358, 276, 248, 403, 144, 505, 681, 0, 545, 118, 182, 149, 316, 421, 726, 99, 244, 217]"
81,17,3094,6309,5090,0,1015,2079,"[585, 186, 273, 318, 685, 555, 76, 368, 385, 254, 144, 369, 361, 619, 663, 418, 0, 352, 622, 65, 292, 304, 65, 169, 148, 269, 627]"
82,17,3945,1813,7222,0,1341,2604,"[238, 475, 752, 318, 409, 270, 5, 293, 650, 470, 219, 246, 335, 604, 697, 588, 0, 603, 335, 115, 173, 530, 654, 196, 778, 453, 364]"
83,17,3548,1888,8882,0,3310,238,"[16, 78, 69, 10, 24, 67, 65, 6, 68, 39, 3, 20, 6, 76, 32, 50, 0, 26, 46, 37, 71, 19, 23, 0, 70, 32, 72]"
84,17,3754,6781,5855,0,3347,407,"[80, 130, 72, 92, 5, 54, 100, 120, 1, 123, 41, 92, 28, 118, 53, 110, 0, 101, 9, 13, 44, 62, 123, 35, 94, 60, 42]"
85,17,4576,3946,6485,0,4511,65,"[4, 1, 1, 3, 13, 5, 17, 4, 19, 14, 20, 0, 2, 20, 12, 4, 0, 2, 4, 11, 10, 21, 0, 0, 7, 5, 4]"
86,17,4599,7267,3817,0,1107,3492,"[661, 1008, 1130, 1163, 161, 969, 656, 4, 492, 168, 255, 898, 225, 268, 164, 246, 0, 20, 619, 939, 326, 330, 988, 235, 933, 719, 1079]"
87,17,4377,1488,6706,0,2536,1841,"[397, 543, 525, 125, 284, 95, 578, 474, 599, 319, 496, 602, 581, 373, 318, 202, 0, 575, 195, 496, 603, 497, 438, 366, 584, 44, 133]"
88,17,4897,7465,4138,0,969,3928,"[699, 795, 936, 349, 1295, 1275, 1095, 295, 304, 745, 857, 78, 771, 579, 633, 193, 0, 4, 560, 863, 369, 1098, 285, 770, 1258, 355, 1118]"
89,17,4170,903,7405,0,1661,2509,"[688, 344, 65, 624, 797, 57, 36, 309, 761, 619, 226, 317, 426, 258, 833, 40, 0, 86, 266, 423, 35, 291, 75, 176, 320, 685, 343]"
90,17,3569,120,10000,854,3177,392,"[17, 57, 6, 7, 115, 28, 39, 6, 97, 103, 41, 95, 81, 123, 49, 75, 0, 88, 108, 62, 66, 111, 92, 125, 44, 38, 83]"
91,17,4941,5918,9023,0,796,4145,"[862, 299, 81, 1098, 136, 1045, 395, 813, 1344, 855, 132, 917, 869, 573, 1050, 372, 0, 463, 13, 668, 1109, 255, 788, 19, 710, 316, 1048]"
92,17,3410,6348,6085,0,558,2852,"[298, 171, 875, 594, 100, 770, 490, 159, 706, 856, 425, 110, 179, 457, 171, 42, 0, 778, 721, 522, 923, 888, 453, 44, 498, 924, 745]"
93,17,3938,214,9809,0,308,3630,"[560, 915, 967, 452, 254, 581, 256, 317, 1138, 250, 376, 84, 945, 621, 291, 453, 0, 971, 1011, 25, 686, 117, 640, 624, 944, 1034, 157]"
94,17,3353,6936,6226,0,533,2820,"[697, 847, 221, 44, 582, 498, 642, 44, 76, 692, 404, 194, 900, 460, 345, 581, 0, 871, 418, 919, 679, 929, 829, 148, 286, 791, 808]"
95,17,3401,1275,8352,0,1967,1434,"[48, 248, 412, 78, 257, 286, 418, 166, 217, 196, 3, 89, 299, 415, 356, 278, 0, 108, 131, 252, 410, 318, 259, 425, 458, 358, 239]"
96,17,3476,7247,4581,0,1690,1786,"[551, 525, 395, 595, 282, 153, 279, 207, 215, 479, 108, 580, 557, 214, 454, 24, 0, 519, 560, 554, 524, 450, 343, 293, 11, 393, 375]"
97,17,4241,530,8292,0,4158,83,"[27, 0, 1, 9, 8, 16, 24, 26, 22, 18, 15, 19, 18, 15, 8, 20, 0, 1, 1, 4, 16, 25, 0, 23, 15, 6, 8]"
98,17,4191,5907,6576,0,3338,853,"[8, 210, 238, 91, 168, 158, 117, 47, 49, 201, 215, 258, 1, 92, 53, 6, 0, 2, 142, 244, 14, 236, 222, 1, 261, 207, 202]"
99,17,4601,5953,5224,0,2720,1881,"[63, 485, 298, 301, 479, 348, 401, 489, 159, 221, 52, 171, 238, 586, 232, 301, 0, 324, 432, 9, 334, 229, 515, 217, 190, 555, 139]"
100,17,4042,610,8656,0,3318,724,"[72, 185, 84, 82, 132, 127, 23, 62, 218, 82, 139, 84, 90, 193, 110, 88, 0, 163, 65, 123, 29, 223, 189, 119, 48, 31, 92]"
101,17,4987,5590,8053,0,1261,3726,"[1057, 37, 717, 551, 103, 485, 507, 294, 1119, 385, 190, 983, 112, 698, 196, 952, 0, 35, 292, 9, 320, 1040, 108, 389, 235, 922, 155]"
102,17,4308,5055,7306,0,4216,92,"[28, 12, 19, 28, 19, 19, 4, 25, 13, 15, 18, 5, 24, 15, 16, 28, 0, 30, 12, 13, 22, 30, 14, 28, 11, 17, 3]"
103,17,3010,2756,7560,0,1592,1418,"[230, 33, 67, 348, 61, 248, 8, 224, 214, 199, 186, 130, 58, 125, 376, 323, 0, 314, 202, 429, 62, 267, 404, 39, 86, 317, 414]"
104,17,4109,5327,6342,0,2276,1833,"[383, 420, 468, 437, 208, 442, 99, 118, 43, 311, 504, 235, 219, 598, 304, 551, 0, 302, 327, 558, 389, 333, 543, 434, 54, 347, 526]"
105,17,3997,608,9731,0,2518,1479,"[176, 352, 344, 221, 350, 400, 275, 82, 370, 124, 279, 425, 161, 399, 141, 183, 0, 179, 321, 363, 381, 100, 57, 274, 126, 468, 212]"
106,17,4874,6022,8583,0,38,4836,"[1315, 1083, 116, 1331, 761, 130, 968, 899, 103, 1487, 362, 339, 33, 1008, 570, 774, 0, 111, 684, 1395, 1294, 1118, 841, 328, 158, 1358, 784]"
107,17,4046,5951,6678,0,3416,630,"[106, 127, 103, 78, 206, 163, 186, 93, 129, 188, 118, 149, 143, 50, 187, 52, 0, 57, 196, 5, 70, 135, 15, 55, 13, 175, 118]"
108,17,4192,47,10000,823,1128,3064,"[721, 530, 122, 942, 752, 773, 144, 197, 7, 660, 306, 545, 944, 384, 972, 980, 0, 221, 10, 875, 858, 776, 314, 775, 957, 401, 373]"
109,17,3444,5054,8390,0,2095,1349,"[144, 148, 311, 320, 157, 332, 355, 142, 229, 373, 267, 203, 75, 419, 151, 449, 0, 160, 327, 249, 99, 161, 342, 364, 147, 371, 436]"
110,17,4431,7354,5467,0,655,3776,"[827, 570, 666, 1217, 1218, 259, 1093, 486, 1174, 649, 738, 982, 492, 1244, 502, 1035, 0, 505, 186, 72, 438, 894, 934, 56, 618, 676, 69]"
111,17,4336,2487,7316,0,803,3533,"[390, 207, 563, 651, 796, 202, 980, 979, 835, 917, 717, 1150, 888, 709, 743, 339, 0, 287, 108, 805, 1082, 67, 690, 653, 1156, 924, 583]"
112,17,4438,7309,4445,0,3838,600,"[4, 62, 111, 0, 30, 143, 94, 39, 52, 193, 56, 160, 102, 178, 59, 90, 0, 77, 129, 188, 147, 128, 46, 154, 118, 114, 58]"
113,17,4767,1800,7412,0,2221,2546,"[53, 753, 612, 175, 482, 496, 173, 214, 633, 433, 496, 739, 477, 180, 13, 541, 0, 545, 416, 783, 569, 398, 466, 737, 399, 302, 349]"
114,17,3818,6651,4579,0,2071,1747,"[65, 421, 136, 326, 376, 115, 212, 349, 490, 356, 392, 341, 160, 212, 349, 135, 0, 535, 371, 180, 84, 361, 285, 308, 355, 407, 157]"
115,17,4300,1567,7312,0,380,3920,"[7, 22, 557, 1300, 876, 466, 928, 358, 1243, 458, 165, 828, 1, 1032, 1230, 209, 0, 716, 937, 419, 505, 398, 765, 762, 154, 829, 120]"
116,17,3441,3267,7486,0,1153,2288,"[592, 440, 126, 329, 54, 114, 742, 269, 491, 140, 379, 157, 656, 478, 338, 584, 0, 606, 354, 709, 460, 208, 145, 126, 78, 494, 585]"
117,17,3610,6000,5096,0,3458,152,"[18, 12, 37, 38, 49, 45, 34, 0, 20, 48, 18, 11, 7, 14, 3, 44, 0, 43, 21, 15, 41, 32, 25, 23, 27, 11, 11]"
118,17,4321,1721,7696,0,3954,367,"[66, 39, 53, 67, 75, 119, 5, 109, 11, 70, 89, 74, 17, 87, 2, 15, 0, 41, 28, 109, 114, 19, 81, 107, 114, 104, 20]"
119,17,3472,6722,4446,0,1603,1869,"[562, 417, 308, 505, 266, 147, 249, 425, 486, 515, 474, 261, 129, 363, 205, 563, 0, 351, 354, 575, 353, 259, 205, 65, 570, 342, 508]"
120,17,4730,1352,7824,0,1504,3226,"[311, 21, 495, 43, 144, 1051, 764, 1020, 1059, 458, 1029, 858, 71, 374, 869, 573, 0, 960, 388, 611, 952, 180, 111, 813, 240, 70, 608]"
121,17,3309,5665,5468,0,967,2342,"[352, 763, 58, 335, 200, 646, 446, 305, 346, 93, 311, 170, 765, 612, 261, 432, 0, 385, 101, 727, 657, 542, 169, 672, 470, 45, 702]"
122,17,4499,2775,7192,0,4205,294,"[70, 58, 3, 7, 15, 81, 60, 11, 63, 37, 51, 66, 0, 34, 94, 24, 0, 11, 51, 94, 43, 96, 44, 71, 63, 81, 88]"
123,17,4797,5555,6434,0,3540,1257,"[151, 330, 95, 195, 108, 251, 367, 370, 110, 168, 47, 394, 335, 118, 409, 368, 0, 17, 173, 339, 183, 324, 273, 354, 38, 70, 6]"
124,17,3190,154,9470,0,3088,102,"[33, 28, 15, 31, 23, 0, 12, 6, 28, 26, 9, 0, 1, 23, 33, 22, 0, 11, 5, 33, 25, 22, 12, 7, 18, 27, 23]"
125,17,3908,5427,7951,0,2704,1204,"[12, 346, 165, 263, 127, 107, 157, 91, 394, 116, 59, 181, 2, 150, 130, 56, 0, 53, 153, 400, 74, 68, 76, 234, 299, 68, 251]"
126,17,4214,7404,4761,0,3002,1212,"[273, 212, 15, 205, 267, 376, 222, 266, 182, 328, 40, 142, 252, 351, 163, 172, 0, 152, 351, 221, 217, 179, 95, 201, 1, 266, 203]"
127,17,4350,346,8765,0,1300,3050,"[324, 253, 547, 56, 277, 1011, 106, 335, 609, 35, 899, 329, 10, 222, 85, 259, 0, 432, 60, 646, 102, 475, 195, 142, 49, 760, 308]"
128,17,3400,6893,5272,0,3360,40,"[1, 1, 4, 9, 12, 7, 6, 9, 8, 12, 4, 2, 0, 3, 7, 0, 0, 8, 10, 8, 12, 1, 3, 11, 10, 3, 6]"
129,17,3774,1223,7823,0,1557,2217,"[301, 111, 552, 426, 129, 262, 396, 730, 325, 67, 718, 162, 259, 608, 359, 510, 0, 686, 272, 681, 547, 655, 645, 581, 195, 291, 97]"
130,17,4974,7484,5313,0,1129,3845,"[739, 425, 213, 206, 618, 1234, 210, 599, 380, 443, 590, 536, 169, 1007, 290, 503, 0, 588, 455, 233, 497, 474, 236, 565, 928, 1279, 988]"
131,17,4905,322,9896,0,3193,1712,"[401, 390, 559, 39, 348, 431, 199, 374, 371, 156, 454, 58, 441, 257, 408, 355, 0, 150, 348, 220, 106, 52, 271, 360, 166, 54, 335]"
132,17,4178,7022,7052,0,1097,3081,"[263, 466, 460, 920, 471, 553, 214, 328, 14, 606, 102, 283, 976, 340, 533, 650, 0, 804, 5, 73, 842, 651, 525, 584, 534, 868, 732]"
133,17,3438,431,10000,59,3105,333,"[94, 89, 24, 104, 17, 108, 47, 41, 75, 72, 28, 46, 74, 104, 93, 0, 0, 27, 77, 27, 36, 51, 13, 72, 14, 12, 92]"
134,17,3986,6176,7810,0,287,3699,"[1106, 712, 392, 230, 687, 170, 1228, 1106, 1181, 584, 398, 466, 98, 758, 177, 278, 0, 46, 651, 11, 1206, 881, 1084, 683, 235, 341, 284]"
135,17,4028,6190,5648,0,2732,1296,"[146, 69, 149, 245, 345, 90, 329, 291, 374, 97, 78, 176, 422, 5, 285, 253, 0, 429, 30, 198, 124, 101, 177, 338, 44, 328, 151]"
136,17,3631,1842,7437,0,3363,268,"[44, 7, 18, 49, 75, 58, 7, 65, 51, 68, 76, 75, 29, 81, 28, 64, 0, 39, 67, 5, 56, 27, 9, 77, 51, 89, 62]"
137,17,3861,6094,5204,0,3301,560,"[180, 13, 34, 50, 56, 54, 85, 100, 8, 170, 102, 33, 159, 55, 25, 27, 0, 17, 58, 24, 119, 9, 13, 0, 169, 171, 78]"
138,17,3603,2131,6676,0,3499,104,"[23, 27, 10, 4, 33, 3, 23, 33, 6, 25, 22, 17, 8, 5, 15, 30, 0, 2, 0, 15, 18, 31, 11, 21, 17, 6, 11]"
139,17,4000,578,10000,98,3955,45,"[9, 10, 12, 3, 1, 4, 11, 4, 2, 1, 11, 15, 0, 7, 7, 11, 0, 0, 5, 15, 5, 15, 12, 3, 9, 5, 5]"
140,17,4053,5459,8594,0,3560,493,"[89, 129, 53, 33, 138, 27, 36, 108, 125, 155, 2, 10, 103, 160, 133, 9, 0, 67, 74, 23, 83, 89, 124, 154, 87, 95, 156]"
141,17,3641,7138,5097,0,611,3030,"[821, 763, 2, 927, 166, 1003, 929, 594, 767, 723, 464, 625, 595, 173, 22, 1002, 0, 34, 389, 710, 660, 756, 709, 722, 40, 80, 709]"
142,17,3856,2482,6471,0,123,3733,"[523, 120, 813, 94, 545, 878, 528, 48, 335, 407, 1164, 1213, 878, 477, 148, 79, 0, 112, 724, 1144, 65, 1131, 734, 889, 817, 183, 360]"
143,17,3094,541,9024,0,2926,168,"[20, 7, 37, 38, 6, 37, 6, 55, 32, 4, 16, 44, 18, 53, 6, 10, 0, 17, 51, 4, 48, 33, 9, 7, 14, 10, 4]"
144,17,4581,6199,7406,0,1479,3102,"[966, 589, 780, 113, 544, 817, 708, 900, 106, 266, 445, 152, 681, 693, 693, 273, 0, 1034, 971, 689, 365, 411, 196, 51, 934, 1014, 62]"
145,17,4716,5541,6581,0,2073,2643,"[386, 449, 113, 157, 351, 29, 222, 85, 156, 827, 237, 875, 596, 221, 16, 621, 0, 511, 534, 465, 335, 204, 243, 860, 583, 757, 144]"
146,17,3829,1274,9136,0,2576,1253,"[140, 67, 218, 321, 52, 280, 314, 261, 153, 169, 370, 132, 299, 325, 217, 126, 0, 196, 270, 142, 279, 237, 7, 136, 337, 128, 234]"
147,17,3697,6939,5894,0,2039,1658,"[307, 89, 344, 214, 82, 152, 156, 194, 277, 449, 458, 65, 161, 235, 209, 244, 0, 231, 542, 269, 345, 11, 514, 360, 426, 530, 225]"
148,17,4456,3694,6656,0,1645,2811,"[404, 157, 54, 112, 753, 168, 355, 507, 263, 335, 469, 327, 927, 172, 740, 368, 0, 260, 700, 132, 524, 931, 198, 85, 8, 802, 728]"
149,17,4083,248,10000,491,3564,519,"[36, 94, 72, 83, 168, 110, 61, 81, 39, 25, 75, 169, 7, 76, 143, 54, 0, 89, 117, 152, 15, 63, 65, 105, 143, 166, 16]"
150,17,3676,7173,6503,0,2409,1267,"[367, 311, 285, 285, 303, 17, 173, 50, 395, 156, 342, 237, 405, 200, 210, 354, 0, 310, 100, 394, 327, 408, 144, 414, 151, 88, 187]"
151,17,3205,1759,7949,0,634,2571,"[727, 96, 523, 392, 224, 235, 393, 684, 84, 575, 570, 248, 104, 60, 653, 631, 0, 120, 615, 728, 704, 220, 755, 670, 355, 617, 420]"
152,17,4935,6438,6446,0,2098,2837,"[873, 37, 153, 85, 592, 810, 864, 341, 836, 704, 871, 866, 777, 202, 784, 427, 0, 317, 626, 452, 836, 692, 817, 433, 484, 609, 148]"
153,17,3142,1973,7615,0,2233,909,"[134, 235, 114, 274, 35, 265, 209, 255, 52, 298, 177, 42, 188, 303, 23, 214, 0, 133, 0, 291, 17, 57, 206, 247, 0, 252, 296]"
154,17,3980,6144,5451,0,1562,2418,"[753, 644, 204, 331, 122, 759, 164, 692, 622, 583, 157, 798, 74, 242, 664, 142, 0, 618, 437, 279, 348, 639, 345, 509, 710, 360, 766]"
155,17,3048,2538,5961,0,1377,1671,"[322, 503, 243, 21, 81, 237, 135, 207, 452, 203, 424, 86, 322, 433, 61, 439, 0, 451, 212, 250, 305, 554, 252, 509, 244, 521, 461]"
156,17,3602,567,8996,0,152,3450,"[968, 628, 1146, 381, 613, 234, 234, 810, 970, 1146, 497, 816, 291, 70, 84, 343, 0, 1015, 982, 620, 1062, 36, 246, 719, 754, 91, 1036]"
157,17,3761,6414,6343,0,3123,638,"[84, 115, 76, 14, 88, 183, 55, 62, 171, 205, 100, 76, 8, 52, 174, 179, 0, 64, 104, 139, 180, 124, 5, 75, 65, 10, 157]"
158,17,4064,3792,6615,0,1602,2462,"[98, 484, 324, 429, 34, 691, 732, 698, 552, 531, 610, 517, 645, 30, 263, 443, 0, 109, 650, 518, 635, 263, 814, 632, 70, 16, 439]"
159,17,4893,5169,6339,0,1348,3545,"[1000, 1133, 1099, 928, 208, 1024, 816, 758, 349, 666, 596, 315, 1074, 438, 167, 966, 0, 49, 126, 447, 923, 307, 851, 599, 670, 503, 826]"
160,17,3058,1722,7675,0,2518,540,"[122, 9, 113, 93, 127, 75, 160, 77, 105, 141, 118, 94, 92, 71, 107, 26, 0, 146, 11, 126, 140, 163, 114, 9, 90, 14, 123]"
161,17,4545,6544,5676,0,1368,3177,"[27, 704, 126, 307, 989, 1010, 18, 834, 1041, 396, 1045, 430, 578, 784, 920, 493, 0, 137, 787, 361, 881, 56, 20, 356, 1002, 177, 583]"
162,17,4423,2747,7352,0,324,4099,"[653, 1333, 1236, 1175, 23, 1140, 588, 761, 359, 930, 650, 310, 959, 201, 273, 550, 0, 1337, 752, 1251, 929, 1345, 1135, 555, 269, 1270, 1147]"
163,17,3319,963,9708,0,1132,2187,"[233, 245, 94, 191, 568, 381, 723, 115, 74, 191, 404, 559, 244, 565, 81, 87, 0, 553, 290, 364, 109, 340, 690, 139, 271, 10, 25]"
164,17,4289,6961,7036,0,3522,767,"[148, 225, 69, 150, 69, 244, 196, 146, 178, 151, 132, 137, 198, 155, 125, 2, 0, 204, 178, 135, 196, 180, 135, 137, 115, 150, 1]"
165,17,3591,1611,9016,0,1033,2558,"[491, 75, 659, 736, 810, 75, 850, 57, 783, 258, 590, 759, 595, 40, 236, 426, 0, 596, 683, 81, 522, 332, 93, 777, 606, 422, 780]"
166,17,3519,5828,6707,0,2718,801,"[43, 8, 184, 233, 100, 106, 99, 116, 38, 171, 166, 5, 204, 75, 132, 54, 0, 23, 188, 235, 216, 60, 153, 182, 64, 60, 120]"
167,17,3942,1782,8867,0,2402,1540,"[339, 211, 169, 40, 124, 114, 259, 460, 352, 461, 186, 126, 270, 385, 217, 198, 0, 79, 99, 334, 127, 17, 405, 222, 258, 150, 223]"
168,17,4910,5603,8174,0,1765,3145,"[51, 761, 708, 194, 810, 218, 894, 975, 869, 397, 48, 827, 641, 719, 109, 823, 0, 654, 716, 451, 746, 774, 291, 955, 937, 825, 850]"
169,17,3426,7470,4130,0,489,2937,"[430, 244, 462, 424, 428, 973, 508, 497, 914, 477, 674, 113, 893, 801, 347, 268, 0, 201, 396, 614, 3, 122, 535, 834, 484, 79, 539]"
170,17,3847,1132,6845,0,2591,1256,"[379, 84, 214, 367, 71, 50, 191, 149, 192, 388, 331, 254, 90, 416, 285, 53, 0, 374, 135, 270, 198, 229, 159, 114, 191, 249, 269]"
171,17,4169,6028,4986,0,923,3246,"[816, 772, 213, 932, 951, 493, 1074, 489, 74, 552, 211, 441, 319, 970, 829, 329, 0, 847, 925, 813, 187, 51, 304, 815, 1018, 100, 827]"
172,17,4678,2649,7015,0,2659,2019,"[326, 608, 383, 80, 33, 651, 61, 552, 536, 47, 523, 125, 139, 570, 276, 421, 0, 350, 15, 70, 649, 205, 291, 313, 380, 628, 551]"
173,17,4131,6679,4467,0,1604,2527,"[710, 324, 189, 506, 410, 610, 81, 458, 219, 711, 177, 345, 739, 226, 840, 34, 0, 511, 442, 662, 69, 326, 738, 60, 345, 211, 648]"
174,17,3213,2280,5400,0,2998,215,"[24, 4, 41, 17, 26, 66, 59, 31, 29, 63, 46, 69, 25, 3, 4, 30, 0, 17, 34, 55, 8, 30, 12, 59, 55, 44, 34]"
175,17,4649,4649,5400,0,3600,1049,"[77, 122, 254, 78, 69, 178, 154, 52, 12, 21, 156, 240, 166, 138, 76, 19, 0, 212, 183, 159, 224, 207, 144, 111, 256, 0, 219]"
176,17,4265,1809,7856,0,4121,144,"[48, 7, 5, 17, 9, 4, 12, 24, 34, 6, 23, 42, 8, 46, 19, 48, 0, 28, 39, 11, 20, 19, 14, 23, 3, 37, 6]"
177,17,3291,6133,5014,0,200,3091,"[965, 40, 213, 223, 57, 393, 1010, 463, 916, 857, 984, 149, 290, 25, 784, 765, 0, 110, 445, 74, 485, 592, 87, 999, 308, 217, 112]"
178,17,4684,2776,6922,0,4092,592,"[100, 192, 35, 119, 51, 72, 184, 13, 81, 30, 188, 57, 44, 86, 144, 51, 0, 45, 117, 23, 36, 112, 37, 21, 54, 41, 28]"
179,17,3121,1975,8068,0,133,2988,"[984, 323, 950, 46, 604, 952, 116, 938, 826, 457, 338, 845, 641, 891, 38, 744, 0, 603, 591, 673, 432, 311, 606, 55, 744, 735, 777]"
180,17,3917,6748,5237,0,1536,2381,"[498, 234, 208, 338, 569, 418, 3, 218, 59, 765, 73, 63, 119, 111, 563, 464, 0, 530, 535, 643, 153, 102, 257, 59, 434, 792, 243]"
181,17,4895,416,9716,0,906,3989,"[212, 382, 118, 435, 1053, 141, 591, 744, 243, 908, 558, 1316, 225, 735, 23, 403, 0, 1301, 22, 77, 540, 569, 1019, 228, 1131, 537, 795]"
182,17,3113,7051,5778,0,1067,2046,"[367, 446, 492, 119, 186, 673, 157, 294, 93, 92, 206, 677, 464, 301, 14, 478, 0, 41, 198, 511, 648, 281, 88, 106, 329, 249, 568]"
183,17,4296,2821,7253,0,1857,2439,"[247, 546, 49, 408, 0, 166, 164, 715, 52, 167, 244, 749, 644, 262, 559, 591, 0, 362, 653, 150, 183, 557, 731, 792, 345, 59, 24]"
184,17,3108,1965,8396,0,1001,2107,"[255, 96, 386, 16, 514, 215, 292, 32, 605, 393, 156, 575, 90, 634, 670, 488, 0, 500, 157, 38, 424, 421, 185, 506, 54, 230, 405]"
185,17,4811,6400,6807,0,3400,1411,"[377, 56, 398, 293, 391, 319, 21, 294, 336, 394, 185, 358, 143, 303, 318, 383, 0, 222, 249, 79, 165, 449, 168, 299, 152, 199, 18]"
186,17,4900,5588,6119,0,4316,584,"[35, 117, 183, 167, 4, 157, 126, 100, 139, 77, 28, 74, 61, 48, 102, 173, 0, 9, 149, 71, 33, 192, 3, 89, 189, 34, 120]"
187,17,4501,2752,7868,0,3906,595,"[156, 6, 162, 181, 195, 90, 144, 50, 35, 170, 130, 117, 118, 73, 34, 66, 0, 40, 115, 118, 118, 13, 41, 174, 107, 45, 152]"
188,17,4433,5385,6916,0,610,3823,"[1193, 600, 848, 370, 891, 881, 804, 442, 204, 1120, 108, 324, 88, 971, 1249, 357, 0, 1019, 653, 832, 519, 406, 702, 497, 408, 292, 863]"
189,17,3488,1007,9397,0,1448,2040,"[166, 163, 444, 382, 616, 454, 135, 492, 329, 618, 410, 484, 626, 22, 376, 111, 0, 334, 249, 379, 64, 651, 526, 454, 132, 204, 339]"
190,17,4343,6529,7211,0,4129,214,"[52, 61, 71, 44, 10, 56, 44, 54, 52, 25, 30, 53, 22, 11, 20, 49, 0, 36, 1, 3, 28, 44, 39, 1, 24, 37, 52]"
191,17,4492,5187,6516,0,145,4347,"[1349, 1076, 1175, 236, 1401, 641, 1151, 737, 711, 930, 158, 638, 34, 1351, 1262, 635, 0, 1404, 703, 631, 233, 644, 897, 54, 1310, 942, 560]"
192,17,3378,584,9310,0,1620,1758,"[570, 575, 302, 113, 151, 568, 35, 454, 360, 210, 293, 442, 290, 368, 540, 209, 0, 364, 339, 106, 57, 166, 173, 401, 16, 344, 244]"
193,17,3811,5918,7203,0,1611,2200,"[64, 707, 553, 506, 415, 444, 619, 580, 367, 291, 616, 20, 680, 588, 47, 51, 0, 534, 366, 368, 665, 459, 252, 260, 531, 332, 653]"
194,17,3428,103,10000,528,2214,1214,"[286, 314, 354, 76, 69, 148, 175, 135, 283, 36, 68, 46, 222, 45, 211, 313, 0, 343, 298, 285, 253, 124, 247, 258, 272, 268, 291]"
195,17,3542,6478,7064,0,2412,1130,"[14, 121, 367, 315, 9, 206, 52, 60, 33, 217, 254, 319, 214, 89, 173, 289, 0, 158, 294, 176, 192, 200, 182, 29, 162, 8, 346]"
196,17,3747,2924,7887,0,712,3035,"[293, 69, 50, 147, 685, 476, 131, 654, 628, 31, 313, 497, 819, 487, 450, 828, 0, 433, 434, 116, 899, 1007, 566, 314, 194, 362, 475]"
197,17,4945,5871,6961,0,3508,1437,"[190, 387, 457, 219, 93, 238, 270, 78, 31, 381, 102, 289, 337, 265, 3, 46, 0, 96, 329, 308, 404, 161, 123, 364, 66, 353, 22]"
198,17,3070,981,9050,0,2616,454,"[144, 94, 69, 62, 62, 2, 130, 36, 109, 10, 54, 124, 97, 81, 50, 123, 0, 47, 126, 113, 135, 66, 66, 20, 33, 60, 4]"
199,17,4157,5668,7539,0,3839,318,"[64, 2, 69, 11, 87, 55, 28, 36, 58, 33, 67, 94, 27, 51, 60, 57, 0, 91, 106, 72, 75, 36, 11, 69, 63, 8, 14]"
200,17,4093,6270,5362,0,735,3358,"[595, 637, 999, 865, 969, 952, 4, 193, 271, 105, 156, 132, 93, 4, 505, 879, 0, 1011, 1010, 610, 319, 27, 442, 588, 397, 1076, 664]"
201,17,3381,417,8326,0,1717,1664,"[455, 259, 276, 145, 546, 271, 524, 44, 170, 274, 504, 183, 380, 210, 189, 247, 0, 370, 222, 48, 85, 429, 198, 423, 55, 267, 537]"
202,17,3828,6933,5221,0,1596,2232,"[333, 343, 456, 606, 460, 669, 150, 389, 435, 211, 573, 328, 169, 199, 253, 231, 0, 552, 392, 116, 224, 129, 569, 551, 127, 302, 637]"
203,17,3021,809,7433,0,1665,1356,"[79, 250, 290, 266, 172, 163, 379, 291, 352, 429, 121, 371, 231, 218, 350, 388, 0, 110, 102, 420, 378, 61, 198, 384, 152, 230, 131]"
204,17,3337,2679,8091,0,676,2661,"[411, 105, 37, 507, 136, 817, 137, 424, 881, 789, 500, 285, 778, 285, 824, 407, 0, 286, 408, 99, 746, 447, 884, 497, 832, 21, 428]"
205,17,4380,5123,7348,0,2573,1807,"[208, 208, 399, 558, 157, 539, 443, 27, 545, 390, 324, 496, 128, 477, 556, 441, 0, 57, 199, 220, 258, 540, 191, 427, 6, 87, 335]"
206,17,3137,48,10000,437,2805,332,"[6, 85, 107, 46, 17, 53, 57, 91, 82, 44, 79, 36, 104, 4, 88, 68, 0, 11, 37, 83, 56, 36, 52, 57, 30, 102, 49]"
207,17,4392,6645,7747,0,4315,77,"[13, 12, 25, 2, 24, 8, 2, 3, 8, 12, 25, 10, 8, 6, 10, 3, 0, 1, 15, 6, 19, 13, 3, 23, 8, 10, 20]"
208,17,3692,5410,6029,0,1669,2023,"[528, 51, 73, 586, 402, 626, 207, 118, 175, 392, 284, 469, 589, 461, 371, 200, 0, 145, 3, 77, 515, 177, 470, 96, 126, 137, 590]"
209,17,3754,2541,7242,0,2412,1342,"[217, 320, 393, 36, 437, 332, 421, 159, 134, 138, 9, 333, 356, 36, 155, 49, 0, 144, 371, 222, 80, 300, 346, 351, 229, 324, 256]"
210,17,3868,6553,4557,0,2270,1598,"[402, 237, 170, 225, 531, 61, 220, 530, 333, 336, 219, 46, 470, 345, 13, 437, 0, 362, 440, 151, 457, 68, 339, 261, 442, 206, 85]"
211,17,4622,3892,5287,0,369,4253,"[784, 636, 1324, 486, 1160, 76, 285, 525, 1111, 681, 917, 175, 806, 1312, 636, 680, 0, 597, 1123, 1146, 1184, 123, 253, 969, 148, 716, 384]"
212,17,3697,3609,5375,0,1623,2074,"[273, 403, 204, 527, 535, 10, 3, 282, 429, 195, 607, 390, 436, 497, 543, 407, 0, 91, 143, 593, 237, 660, 4, 296, 542, 341, 40]"
213,17,3252,1478,7149,0,1971,1281,"[255, 186, 189, 113, 331, 282, 250, 374, 164, 110, 225, 70, 42, 269, 65, 250, 0, 125, 230, 90, 89, 315, 255, 130, 237, 185, 68]"
214,17,4446,6276,5319,0,277,4169,"[485, 398, 808, 621, 357, 25, 1273, 938, 757, 1220, 431, 369, 752, 967, 1007, 1232, 0, 201, 1170, 160, 1335, 437, 436, 420, 24, 807, 410]"
215,17,3041,2710,5650,0,1903,1138,"[226, 94, 10, 119, 221, 255, 190, 49, 183, 189, 30, 40, 82, 375, 268, 226, 0, 263, 246, 57, 335, 13, 139, 27, 65, 331, 169]"
216,17,4439,3771,6318,0,4302,137,"[40, 34, 36, 44, 21, 11, 5, 34, 13, 14, 20, 14, 23, 32, 7, 5, 0, 2, 11, 8, 41, 7, 15, 35, 21, 35, 23]"
217,17,3864,1781,8401,0,890,2974,"[547, 726, 217, 964, 255, 741, 621, 914, 949, 62, 955, 165, 529, 579, 404, 622, 0, 936, 286, 909, 100, 172, 882, 782, 317, 339, 273]"
218,17,4693,7035,6059,0,1142,3551,"[359, 639, 899, 1150, 800, 996, 259, 435, 34, 533, 122, 257, 227, 935, 1010, 161, 0, 193, 181, 1131, 1110, 943, 805, 333, 133, 1168, 1155]"
219,17,3452,2702,6809,0,2498,954,"[52, 55, 312, 300, 81, 139, 88, 73, 264, 20, 108, 208, 49, 255, 96, 78, 0, 114, 139, 207, 142, 104, 158, 192, 182, 26, 206]"
220,17,4822,5302,6329,0,1178,3644,"[1002, 805, 835, 876, 468, 751, 813, 135, 319, 882, 442, 566, 1044, 1166, 472, 916, 0, 446, 1120, 962, 568, 876, 1129, 269, 755, 899, 79]"
221,17,4492,689,10000,132,448,4044,"[1238, 673, 1244, 935, 1276, 868, 116, 861, 298, 668, 944, 1047, 1139, 985, 499, 291, 0, 29, 306, 680, 1289, 607, 1080, 1019, 669, 1194, 981]"
222,17,3587,5388,8199,0,2192,1395,"[351, 422, 383, 160, 296, 145, 289, 381, 105, 236, 397, 166, 289, 184, 113, 109, 0, 40, 33, 96, 291, 183, 148, 303, 393, 447, 179]"
223,17,3017,5072,6144,0,2592,425,"[50, 64, 69, 115, 11, 28, 13, 14, 27, 134, 127, 140, 12, 90, 62, 107, 0, 59, 60, 5, 39, 1, 86, 50, 4, 99, 16]"
224,17,3508,131,9521,0,3411,97,"[32, 25, 29, 25, 32, 1, 25, 24, 5, 5, 31, 12, 17, 5, 29, 28, 0, 13, 15, 7, 24, 10, 11, 1, 8, 27, 19]"
225,17,3842,5546,7817,0,140,3702,"[787, 589, 854, 1201, 787, 724, 452, 1180, 1024, 286, 672, 1148, 1170, 913, 1021, 965, 0, 713, 314, 61, 404, 825, 1028, 828, 156, 412, 413]"
226,17,3866,5616,6067,0,961,2905,"[517, 898, 965, 376, 92, 395, 843, 250, 52, 958, 342, 267, 525, 815, 836, 452, 0, 681, 464, 442, 101, 630, 394, 381, 910, 118, 129]"
227,17,3727,2674,7120,0,930,2797,"[418, 44, 814, 389, 739, 772, 281, 825, 213, 244, 759, 724, 85, 720, 287, 477, 0, 496, 538, 627, 482, 76, 859, 105, 798, 743, 548]"
228,17,4935,5889,6166,0,2786,2149,"[68, 660, 440, 41, 8, 264, 55, 401, 511, 612, 262, 289, 479, 180, 495, 545, 0, 54, 613, 263, 124, 483, 606, 425, 631, 316, 4]"
229,17,4694,2960,7900,0,1956,2738,"[339, 352, 646, 614, 393, 645, 905, 553, 151, 717, 474, 774, 747, 897, 136, 826, 0, 124, 330, 470, 263, 218, 464, 705, 819, 604, 387]"
230,17,4272,6681,5491,0,3692,580,"[84, 87, 122, 10, 182, 149, 102, 145, 62, 18, 183, 81, 88, 123, 54, 145, 0, 106, 42, 185, 171, 166, 30, 1, 185, 92, 189]"
231,17,4108,130,9469,0,1283,2825,"[928, 853, 653, 575, 407, 599, 195, 139, 739, 463, 240, 619, 32, 659, 494, 774, 0, 181, 511, 143, 272, 368, 121, 515, 850, 353, 110]"
232,17,3638,6264,6843,0,240,3398,"[814, 1047, 224, 848, 922, 667, 889, 93, 561, 1030, 1118, 983, 997, 245, 1036, 580, 0, 213, 0, 801, 354, 13, 393, 1046, 938, 169, 914]"
233,17,3123,3024,6942,0,45,3078,"[304, 64, 92, 66, 433, 921, 946, 837, 831, 679, 90, 510, 596, 471, 483, 248, 0, 15, 462, 48, 151, 689, 585, 772, 347, 821, 1013]"
234,17,3187,2380,7749,0,2827,360,"[98, 52, 84, 67, 107, 21, 76, 30, 75, 4, 36, 2, 52, 6, 87, 118, 0, 13, 12, 20, 68, 30, 61, 87, 113, 61, 44]"
235,17,3527,6279,4997,0,2681,846,"[188, 188, 181, 67, 104, 109, 178, 7, 204, 264, 230, 66, 192, 182, 182, 260, 0, 258, 133, 171, 150, 231, 50, 83, 142, 88, 254]"
236,17,4247,438,8806,0,1959,2288,"[663, 418, 116, 408, 429, 477, 498, 402, 363, 694, 176, 350, 409, 536, 601, 51, 0, 586, 171, 681, 695, 457, 132, 97, 619, 705, 298]"
237,17,3214,5943,6077,0,2726,488,"[40, 46, 153, 67, 134, 84, 110, 102, 35, 19, 117, 4, 109, 37, 49, 74, 0, 22, 125, 144, 84, 109, 14, 91, 92, 110, 30]"
238,17,3942,408,9611,0,88,3854,"[1156, 1197, 744, 744, 951, 1234, 5, 934, 1255, 925, 1084, 1081, 1095, 1192, 770, 914, 0, 843, 7, 785, 664, 954, 549, 740, 773, 869, 1006]"
239,17,4194,5582,8223,0,1064,3130,"[1041, 792, 29, 63, 814, 596, 504, 276, 764, 20, 397, 1023, 489, 323, 452, 629, 0, 662, 35, 764, 561, 183, 892, 57, 939, 1012, 959]"
240,17,3201,5858,5566,0,2133,1068,"[316, 175, 329, 299, 137, 344, 114, 132, 289, 286, 16, 178, 112, 173, 243, 234, 0, 283, 332, 174, 169, 19, 274, 218, 22, 248, 133]"
241,17,4112,896,8782,0,2734,1378,"[147, 386, 270, 130, 280, 455, 244, 269, 415, 382, 135, 161, 288, 360, 175, 37, 0, 140, 321, 19, 40, 78, 115, 255, 112, 399, 448]"
242,17,4279,7216,5845,0,3153,1126,"[247, 131, 263, 372, 112, 312, 158, 138, 295, 226, 25, 201, 346, 268, 246, 254, 0, 308, 38, 116, 2, 166, 34, 223, 173, 49, 8]"
243,17,3584,2329,7100,0,199,3385,"[186, 335, 1106, 373, 493, 281, 974, 831, 16, 525, 362, 190, 550, 266, 1093, 441, 0, 178, 242, 44, 152, 519, 879, 948, 318, 1083, 221]"
244,17,4761,7265,4596,0,1707,3054,"[816, 922, 961, 125, 198, 776, 497, 93, 535, 1006, 835, 821, 164, 341, 209, 609, 0, 813, 884, 939, 191, 147, 106, 539, 944, 147, 84]"
245,17,3317,1548,6365,0,3242,75,"[7, 22, 25, 5, 7, 16, 24, 6, 0, 20, 13, 22, 13, 6, 25, 18, 0, 15, 23, 13, 7, 7, 7, 19, 15, 21, 23]"
246,17,3374,3250,6489,0,2463,911,"[107, 164, 285, 88, 212, 155, 34, 278, 29, 124, 91, 43, 1, 41, 7, 256, 0, 241, 18, 269, 43, 87, 207, 15, 286, 177, 152]"
247,17,4537,6300,4726,0,2621,1916,"[67, 513, 534, 134, 22, 302, 157, 239, 32, 225, 253, 219, 371, 114, 268, 524, 0, 338, 71, 69, 605, 157, 509, 400, 601, 359, 315]"
248,17,4836,1060,8502,0,645,4191,"[1184, 551, 938, 154, 356, 1080, 1027, 866, 1223, 861, 658, 496, 230, 163, 567, 633, 0, 945, 1012, 467, 104, 1386, 355, 1031, 533, 1357, 949]"
249,17,4298,6680,6120,0,4200,98,"[25, 14, 3, 6, 15, 10, 10, 24, 28, 27, 5, 13, 14, 2, 10, 13, 0, 22, 6, 5, 10, 10, 21, 29, 10, 21, 3]"
250,17,4022,3041,7101,0,143,3879,"[1169, 656, 1172, 864, 891, 842, 657, 1148, 950, 1096, 108, 81, 951, 669, 487, 0, 0, 1104, 423, 102, 637, 433, 952, 17, 154, 851, 329]"
251,17,3850,3327,7624,0,3099,751,"[96, 110, 100, 209, 121, 136, 105, 20, 4, 133, 169, 101, 28, 137, 56, 7, 0, 247, 154, 202, 190, 159, 198, 234, 73, 129, 158]"
252,17,3469,5820,5273,0,2362,1107,"[191, 195, 78, 298, 343, 273, 369, 153, 321, 72, 45, 19, 134, 196, 305, 251, 0, 278, 7, 363, 7, 3, 101, 23, 135, 135, 16]"
253,17,4129,2375,7027,0,3384,745,"[143, 218, 241, 167, 101, 97, 25, 177, 82, 43, 223, 120, 91, 153, 226, 146, 0, 9, 196, 119, 194, 47, 25, 105, 237, 111, 50]"
254,17,3297,2266,8058,0,817,2480,"[400, 595, 797, 799, 769, 16, 712, 200, 792, 661, 108, 453, 262, 424, 562, 294, 0, 101, 274, 432, 317, 366, 205, 459, 31, 377, 284]"
255,17,4219,6629,5648,0,1056,3163,"[64, 713, 1021, 814, 467, 748, 673, 578, 969, 291, 584, 361, 839, 293, 5, 193, 0, 835, 806, 1049, 727, 234, 606, 79, 401, 699, 121]"
256,17,3519,808,8359,0,1246,2273,"[367, 450, 584, 50, 27, 101, 172, 30, 485, 511, 636, 413, 392, 452, 716, 292, 0, 589, 554, 27, 55, 133, 143, 244, 140, 744, 218]"
257,17,3128,6354,5133,0,2899,229,"[38, 39, 18, 38, 37, 57, 66, 47, 33, 27, 22, 75, 2, 15, 71, 33, 0, 62, 51, 70, 44, 56, 49, 64, 71, 50, 42]"
258,17,3790,2185,6738,0,2523,1267,"[366, 371, 324, 81, 77, 76, 41, 57, 82, 338, 267, 293, 145, 233, 318, 367, 0, 186, 230, 51, 169, 371, 70, 254, 397, 63, 395]"
259,17,3387,1208,8917,0,3034,353,"[88, 102, 59, 109, 52, 109, 6, 29, 67, 55, 68, 33, 62, 63, 87, 115, 0, 113, 24, 14, 108, 72, 115, 99, 83, 10, 49]"
260,17,3716,7105,5528,0,2446,1270,"[351, 84, 288, 304, 288, 80, 397, 377, 94, 65, 392, 408, 388, 413, 267, 115, 0, 256, 362, 198, 327, 210, 359, 108, 339, 176, 98]"
261,17,4540,1750,8318,0,3543,997,"[274, 275, 211, 210, 265, 38, 5, 208, 26, 217, 218, 309, 182, 70, 237, 137, 0, 41, 79, 328, 172, 258, 312, 50, 286, 68, 289]"
262,17,3632,5360,6590,0,1816,1816,"[246, 210, 514, 270, 560, 277, 66, 96, 463, 475, 493, 272, 530, 256, 148, 482, 0, 255, 339, 463, 160, 372, 534, 22, 45, 543, 404]"
263,17,3765,605,9750,0,1496,2269,"[588, 488, 403, 704, 331, 146, 61, 53, 223, 176, 8, 498, 646, 496, 267, 709, 0, 17, 529, 530, 639, 753, 743, 623, 513, 566, 279]"
264,17,3668,6995,6423,0,2987,681,"[25, 218, 31, 199, 132, 193, 84, 183, 16, 84, 172, 147, 218, 168, 42, 37, 0, 2, 180, 16, 157, 121, 118, 125, 214, 221, 1]"
265,17,4905,6154,5174,0,1967,2938,"[62, 32, 464, 226, 905, 815, 201, 849, 430, 105, 97, 353, 114, 190, 170, 808, 0, 685, 524, 452, 944, 363, 940, 140, 497, 453, 612]"
266,17,3926,690,8410,0,2157,1769,"[433, 206, 183, 589, 561, 257, 376, 3, 153, 417, 370, 385, 92, 380, 272, 315, 0, 213, 480, 350, 12, 423, 474, 242, 525, 432, 499]"
267,17,4538,6845,6103,0,4045,493,"[127, 51, 31, 123, 70, 140, 100, 107, 107, 56, 54, 130, 140, 42, 66, 104, 0, 140, 86, 14, 1, 132, 161, 20, 146, 138, 98]"
268,17,3797,196,9704,0,2024,1773,"[75, 61, 42, 413, 241, 153, 423, 360, 44, 394, 449, 227, 549, 366, 224, 247, 0, 483, 539, 442, 184, 398, 511, 140, 559, 221, 171]"
269,17,4841,5630,8915,0,2281,2560,"[479, 582, 625, 523, 464, 571, 97, 717, 10, 659, 807, 20, 198, 653, 308, 333, 0, 430, 97, 152, 695, 620, 558, 37, 23, 738, 451]"
270,17,3075,7286,4704,0,1576,1499,"[323, 312, 248, 328, 4, 240, 296, 184, 474, 394, 172, 120, 31, 468, 47, 212, 0, 485, 412, 376, 299, 95, 231, 295, 430, 85, 24]"
271,17,3180,2794,5090,0,2473,707,"[170, 177, 119, 231, 70, 180, 196, 128, 122, 182, 232, 74, 39, 173, 40, 188, 0, 84, 161, 171, 203, 47, 43, 218, 3, 95, 141]"
272,17,3969,1993,7066,0,2830,1139,"[202, 118, 201, 139, 290, 177, 366, 267, 231, 111, 163, 281, 209, 243, 286, 286, 0, 333, 152, 184, 265, 128, 165, 17, 275, 60, 2]"
273,17,3157,2636,7587,0,1489,1668,"[494, 400, 46, 64, 118, 95, 85, 377, 290, 370, 19, 213, 215, 122, 295, 174, 0, 554, 348, 295, 119, 495, 87, 417, 251, 475, 6]"
274,17,4281,6026,5842,0,3606,675,"[122, 50, 173, 211, 66, 203, 74, 48, 171, 114, 38, 221, 176, 180, 34, 23, 0, 107, 47, 23, 97, 150, 77, 132, 184, 161, 124]"
275,17,3661,343,9160,0,2183,1478,"[469, 139, 380, 188, 171, 57, 379, 168, 136, 178, 42, 49, 81, 193, 357, 175, 0, 398, 131, 308, 259, 175, 185, 340, 104, 373, 23]"
276,17,4247,7082,6325,0,3856,391,"[41, 55, 37, 109, 89, 96, 42, 115, 103, 5, 47, 4, 9, 91, 48, 106, 0, 85, 14, 74, 123, 112, 102, 9, 74, 108, 116]"
277,17,4126,2129,8322,0,3940,186,"[31, 20, 15, 38, 34, 18, 35, 10, 59, 3, 24, 6, 17, 42, 45, 7, 0, 36, 30, 3, 14, 60, 10, 50, 45, 45, 31]"
278,17,4099,6889,5532,0,1411,2688,"[172, 409, 345, 318, 847, 89, 186, 726, 318, 273, 177, 111, 307, 574, 690, 789, 0, 696, 54, 292, 572, 847, 532, 750, 307, 64, 73]"
279,17,4141,637,9036,0,3103,1038,"[43, 171, 292, 17, 337, 175, 29, 316, 66, 311, 39, 215, 166, 86, 171, 237, 0, 210, 200, 340, 122, 250, 46, 50, 28, 97, 239]"
280,17,3613,7467,5182,0,1252,2361,"[119, 245, 603, 163, 555, 139, 735, 81, 449, 112, 41, 411, 54, 357, 267, 256, 0, 713, 14, 452, 92, 176, 92, 85, 713, 573, 224]"
281,17,3666,2796,6052,0,665,3001,"[808, 597, 372, 21, 36, 826, 674, 876, 745, 27, 853, 53, 959, 970, 147, 399, 0, 528, 207, 116, 448, 583, 922, 900, 434, 434, 846]"
282,17,3435,2332,7155,0,844,2591,"[661, 246, 343, 634, 234, 683, 172, 643, 489, 409, 727, 612, 648, 305, 33, 402, 0, 62, 92, 698, 136, 789, 300, 848, 451, 94, 578]"
283,17,4909,7321,4743,0,1187,3722,"[340, 956, 691, 496, 807, 1177, 643, 521, 687, 996, 735, 1209, 1070, 157, 208, 476, 0, 996, 327, 798, 1122, 43, 367, 61, 1188, 537, 67]"
284,17,3431,653,7521,0,1694,1737,"[467, 9, 135, 516, 378, 394, 347, 423, 72, 543, 409, 575, 179, 418, 164, 551, 0, 48, 435, 337, 101, 173, 19, 11, 342, 394, 372]"
285,17,3452,1976,8997,0,2416,1036,"[282, 261, 334, 227, 115, 140, 50, 291, 154, 124, 173, 36, 231, 50, 60, 5, 0, 207, 222, 290, 134, 227, 163, 78, 142, 309, 285]"
286,17,3829,5578,7248,0,1370,2459,"[751, 190, 43, 684, 308, 376, 344, 28, 743, 481, 511, 56, 661, 640, 445, 401, 0, 247, 479, 305, 730, 666, 411, 399, 257, 619, 470]"
287,17,4299,7215,4332,0,2978,1321,"[35, 152, 295, 414, 215, 34, 224, 162, 287, 387, 286, 70, 336, 279, 254, 186, 0, 382, 156, 399, 348, 306, 324, 288, 103, 145, 209]"
288,17,4733,1649,7416,0,2264,2469,"[804, 479, 134, 758, 585, 243, 655, 168, 385, 443, 575, 206, 181, 275, 425, 460, 0, 765, 537, 801, 8, 56, 620, 159, 3, 545, 533]"
289,17,4637,6795,5258,0,3390,1247,"[344, 28, 184, 186, 169, 46, 294, 99, 391, 10, 324, 199, 193, 211, 244, 412, 0, 79, 48, 301, 144, 156, 72, 22, 315, 348, 165]"
290,17,3726,3359,5625,0,2720,1006,"[235, 151, 248, 319, 228, 301, 241, 135, 135, 321, 52, 334, 277, 192, 268, 264, 0, 205, 262, 67, 274, 20, 215, 145, 131, 88, 51]"
291,17,3451,1991,7085,0,50,3401,"[624, 548, 221, 730, 362, 950, 398, 179, 601, 1077, 261, 253, 300, 966, 836, 1005, 0, 679, 538, 785, 318, 662, 863, 612, 215, 793, 396]"
292,17,3273,3021,7337,0,587,2686,"[216, 309, 500, 324, 438, 57, 165, 803, 249, 749, 462, 751, 138, 571, 393, 535, 0, 832, 466, 598, 227, 493, 198, 235, 454, 472, 387]"
293,17,3077,1693,8721,0,1382,1695,"[36, 176, 276, 438, 508, 463, 301, 61, 28, 295, 538, 544, 413, 293, 305, 372, 0, 129, 286, 48, 344, 20, 505, 155, 68, 266, 6]"
294,17,4960,6496,7185,0,444,4516,"[1259, 125, 1393, 828, 1369, 1435, 177, 1481, 170, 965, 360, 1127, 309, 329, 318, 926, 0, 68, 1370, 1105, 363, 941, 748, 666, 77, 494, 391]"
295,17,4024,6790,4419,0,3974,50,"[15, 11, 15, 2, 10, 2, 16, 2, 4, 6, 13, 14, 3, 3, 6, 2, 0, 0, 11, 9, 5, 12, 2, 4, 8, 2, 5]"
296,17,4261,3181,5499,0,882,3379,"[1064, 1055, 67, 402, 817, 990, 376, 414, 635, 609, 876, 819, 963, 1125, 684, 730, 0, 60, 16, 406, 409, 471, 1081, 921, 492, 179, 903]"
297,17,3855,1215,8139,0,2666,1189,"[241, 222, 318, 204, 349, 194, 120, 137, 257, 122, 87, 122, 180, 383, 295, 235, 0, 300, 226, 260, 376, 313, 258, 311, 213, 171, 389]"
298,17,4679,6636,6182,0,1233,3446,"[902, 351, 400, 1015, 448, 323, 600, 146, 359, 248, 767, 473, 520, 266, 1106, 1112, 0, 411, 1039, 268, 128, 573, 405, 1101, 710, 752, 628]"
299,17,4024,3885,6321,0,2315,1709,"[465, 166, 495, 227, 156, 427, 247, 159, 499, 248, 167, 19, 339, 556, 14, 361, 0, 34, 398, 14, 281, 538, 90, 80, 118, 334, 238]"
0,18,95,0,95,0,73,22,"[4, 1, 4, 4, 7, 5, 1, 6, 6, 1, 0, 7, 0, 7, 1, 4, 3, 0, 1, 6, 4, 3, 7, 2, 5, 2, 3]"
1,18,4,4,95,0,0,4,"[0, 1, 0, 0, 1, 0, 0, 1, 1, 1, 0, 1, 0, 0, 1, 1, 0, 0, 0, 1, 0, 0, 0, 0, 0, 0, 1]"
2,18,38,7,126,0,24,14,"[1, 1, 2, 1, 3, 0, 1, 1, 0, 1, 1, 4, 3, 2, 2, 1, 4, 0, 0, 0, 0, 3, 2, 2, 3, 4, 1]"
3,18,96,40,182,0,10,86,"[10, 25, 23, 22, 19, 15, 13, 26, 17, 12, 15, 8, 9, 2, 18, 7, 2, 0, 6, 11, 25, 10, 13, 5, 26, 1, 1]"
4,18,38,27,193,0,4,34,"[6, 0, 0, 6, 10, 9, 6, 11, 6, 10, 3, 8, 11, 7, 6, 10, 2, 0, 7, 4, 4, 11, 9, 0, 6, 0, 1]"
5,18,34,30,197,0,34,0,"[0, 0, 0, 0, 0, 0, 0, 0, 0, 0, 0, 0, 0, 0, 0, 0, 0, 0, 0, 0, 0, 0, 0, 0, 0, 0, 0]"
6,18,95,18,274,0,52,43,"[10, 0, 10, 13, 4, 2, 10, 12, 1, 6, 8, 5, 6, 11, 14, 4, 14, 0, 13, 12, 0, 2, 2, 3, 3, 2, 4]"
7,18,53,14,313,0,8,45,"[9, 15, 2, 7, 2, 5, 0, 1, 0, 7, 4, 15, 5, 4, 14, 11, 4, 0, 6, 14, 15, 10, 14, 2, 6, 2, 11]"
8,18,66,31,348,0,21,45,"[7, 1, 1, 14, 6, 3, 14, 10, 14, 8, 13, 6, 13, 12, 6, 3, 12, 0, 0, 2, 5, 12, 3, 14, 4, 3, 15]"
9,18,79,13,414,0,56,23,"[6, 3, 5, 0, 3, 1, 3, 4, 1, 2, 2, 3, 2, 3, 1, 6, 4, 0, 0, 7, 7, 0, 3, 5, 2, 5, 7]"
10,18,14,3,425,0,14,0,"[0, 0, 0, 0, 0, 0, 0, 0, 0, 0, 0, 0, 0, 0, 0, 0, 0, 0, 0, 0, 0, 0, 0, 0, 0, 0, 0]"
11,18,52,52,425,0,18,34,"[5, 0, 6, 11, 0, 0, 4, 2, 7, 1, 10, 1, 0, 8, 11, 6, 11, 0, 11, 4, 2, 2, 11, 2, 4, 3, 6]"
12,18,85,27,483,0,75,10,"[2, 0, 3, 1, 0, 3, 2, 1, 2, 3, 2, 2, 2, 3, 0, 0, 1, 0, 1, 3, 3, 0, 3, 1, 1, 0, 0]"
13,18,28,5,506,0,12,16,"[4, 5, 5, 2, 0, 3, 3, 0, 2, 3, 0, 3, 2, 0, 5, 2, 4, 0, 0, 5, 4, 1, 5, 0, 3, 0, 2]"
14,18,94,55,545,0,66,28,"[6, 0, 3, 7, 4, 0, 5, 3, 0, 4, 9, 0, 5, 6, 4, 0, 3, 0, 4, 6, 2, 3, 8, 1, 3, 5, 2]"
15,18,59,4,600,0,39,20,"[0, 1, 2, 4, 0, 4, 3, 5, 1, 1, 3, 2, 5, 1, 2, 5, 2, 0, 6, 4, 5, 2, 2, 3, 5, 4, 0]"
16,18,32,24,608,0,0,32,"[9, 2, 6, 4, 6, 6, 3, 7, 4, 2, 10, 10, 2, 6, 5, 9, 2, 0, 10, 5, 10, 4, 3, 10, 7, 9, 10]"
17,18,70,22,656,0,24,46,"[0, 4, 1, 4, 12, 10, 3, 7, 7, 10, 2, 3, 9, 3, 4, 4, 12, 0, 15, 6, 7, 3, 14, 6, 2, 0, 11]"
18,18,53,40,669,0,40,13,"[0, 2, 4, 4, 0, 2, 3, 3, 2, 4, 2, 2, 3, 0, 1, 1, 1, 0, 4, 4, 0, 4, 4, 2, 2, 3, 4]"
19,18,25,22,672,0,8,17,"[3, 0, 4, 4, 1, 1, 5, 2, 1, 5, 4, 4, 0, 1, 1, 1, 1, 0, 4, 4, 2, 5, 0, 3, 0, 2, 3]"
20,18,40,32,680,0,23,17,"[1, 2, 3, 1, 1, 4, 5, 2, 1, 2, 1, 4, 5, 2, 2, 1, 4, 0, 3, 5, 0, 3, 4, 5, 0, 3, 0]"
21,18,36,29,687,0,8,28,"[7, 9, 9, 0, 4, 1, 7, 4, 1, 3, 9, 2, 6, 8, 1, 7, 9, 0, 1, 3, 6, 8, 8, 9, 1, 3, 9]"
22,18,57,7,737,0,24,33,"[6, 11, 2, 5, 9, 3, 6, 8, 9, 11, 4, 2, 1, 0, 0, 5, 2, 0, 7, 8, 4, 7, 5, 6, 11, 10, 9]"
23,18,83,11,809,0,34,49,"[15, 15, 6, 8, 10, 15, 4, 5, 9, 2, 1, 1, 0, 5, 4, 2, 13, 0, 12, 5, 1, 6, 7, 11, 9, 14, 3]"
24,18,12,3,818,0,12,0,"[0, 0, 0, 0, 0, 0, 0, 0, 0, 0, 0, 0, 0, 0, 0, 0, 0, 0, 0, 0, 0, 0, 0, 0, 0, 0, 0]"
25,18,21,17,822,0,10,11,"[3, 0, 1, 2, 3, 0, 1, 0, 1, 2, 1, 2, 3, 2, 3, 1, 3, 0, 2, 1, 1, 1, 0, 3, 3, 3, 0]"
26,18,19,4,837,0,1,18,"[5, 3, 3, 4, 3, 2, 6, 4, 0, 5, 2, 1, 2, 5, 3, 1, 1, 0, 5, 0, 1, 0, 4, 3, 6, 6, 5]"
27,18,88,65,860,0,5,83,"[1, 8, 21, 5, 7, 9, 22, 5, 0, 20, 12, 19, 25, 10, 24, 23, 23, 0, 23, 13, 14, 19, 20, 10, 0, 4, 11]"
28,18,75,55,880,0,16,59,"[3, 16, 12, 2, 3, 4, 6, 10, 5, 15, 7, 16, 16, 13, 3, 10, 15, 0, 15, 3, 5, 11, 2, 18, 10, 18, 4]"
29,18,19,16,883,0,2,17,"[2, 2, 5, 5, 1, 3, 0, 0, 0, 0, 2, 5, 2, 5, 1, 0, 1, 0, 4, 3, 5, 2, 2, 4, 4, 3, 1]"
30,18,63,17,929,0,41,22,"[5, 2, 5, 3, 4, 2, 7, 1, 1, 3, 3, 1, 2, 0, 2, 3, 5, 0, 2, 2, 0, 7, 6, 7, 7, 0, 7]"
31,18,16,0,945,0,9,7,"[2, 1, 0, 1, 0, 1, 2, 0, 0, 0, 1, 1, 0, 2, 0, 2, 0, 0, 0, 2, 2, 0, 2, 1, 0, 0, 2]"
32,18,68,7,1006,0,52,16,"[5, 0, 2, 0, 4, 3, 2, 2, 1, 3, 1, 5, 1, 5, 2, 4, 3, 0, 4, 1, 3, 2, 5, 1, 0, 2, 4]"
33,18,0,0,1006,0,0,0,"[0, 0, 0, 0, 0, 0, 0, 0, 0, 0, 0, 0, 0, 0, 0, 0, 0, 0, 0, 0, 0, 0, 0, 0, 0, 0, 0]"
34,18,64,55,1015,0,63,1,"[0, 0, 0, 0, 0, 0, 0, 0, 0, 0, 0, 0, 0, 0, 0, 0, 0, 0, 0, 0, 0, 0, 0, 0, 0, 0, 0]"
35,18,24,18,1021,0,9,15,"[1, 3, 1, 4, 0, 1, 1, 3, 5, 3, 3, 1, 0, 3, 5, 4, 2, 0, 0, 5, 3, 2, 1, 0, 4, 1, 3]"
36,18,83,59,1045,0,39,44,"[12, 0, 13, 12, 11, 5, 11, 13, 10, 0, 13, 10, 4, 6, 2, 10, 0, 0, 13, 14, 7, 3, 12, 0, 4, 7, 12]"
37,18,16,13,1048,0,3,13,"[1, 1, 4, 2, 0, 0, 0, 4, 4, 0, 2, 4, 3, 3, 4, 4, 3, 0, 3, 1, 1, 1, 4, 4, 1, 2, 3]"
38,18,18,10,1056,0,5,13,"[1, 4, 4, 4, 3, 1, 3, 1, 4, 3, 3, 1, 2, 1, 4, 4, 2, 0, 0, 4, 4, 3, 0, 4, 0, 0, 1]"
39,18,9,5,1060,0,4,5,"[0, 0, 0, 0, 0, 1, 1, 0, 0, 0, 0, 1, 0, 0, 0, 0, 0, 0, 0, 1, 0, 0, 0, 1, 0, 0, 0]"
40,18,9,5,1064,0,1,8,"[1, 1, 2, 0, 2, 2, 0, 1, 1, 2, 0, 0, 2, 0, 1, 2, 1, 0, 2, 0, 1, 0, 2, 0, 2, 0, 2]"
41,18,84,35,1113,0,37,47,"[7, 12, 14, 11, 11, 1, 9, 11, 2, 15, 1, 1, 5, 7, 5, 12, 11, 0, 14, 1, 0, 14, 6, 9, 9, 3, 13]"
42,18,16,15,1114,0,6,10,"[1, 2, 2, 2, 0, 2, 3, 2, 1, 3, 1, 2, 0, 2, 2, 2, 2, 0, 3, 1, 1, 2, 2, 0, 3, 0, 3]"
43,18,86,12,1188,0,84,2,"[0, 0, 0, 0, 0, 0, 0, 0, 0, 0, 0, 0, 0, 0, 0, 0, 0, 0, 0, 0, 0, 0, 0, 0, 0, 0, 0]"
44,18,32,11,1209,0,14,18,"[4, 2, 3, 2, 6, 5, 1, 5, 1, 2, 6, 3, 2, 3, 2, 1, 2, 0, 5, 1, 1, 0, 0, 6, 1, 0, 5]"
45,18,31,6,1234,0,13,18,"[0, 3, 1, 6, 4, 1, 1, 4, 1, 4, 5, 2, 1, 6, 0, 6, 2, 0, 3, 1, 3, 5, 2, 4, 1, 3, 6]"
46,18,1,0,1210,0,1,0,"[0, 0, 0, 0, 0, 0, 0, 0, 0, 0, 0, 0, 0, 0, 0, 0, 0, 0, 0, 0, 0, 0, 0, 0, 0, 0, 0]"
47,18,21,6,1225,0,0,21,"[1, 0, 5, 7, 4, 1, 7, 5, 1, 0, 0, 2, 3, 1, 0, 4, 5, 0, 0, 3, 4, 2, 3, 7, 6, 6, 1]"
48,18,4,4,1225,0,2,2,"[0, 0, 0, 0, 0, 0, 0, 0, 0, 0, 0, 0, 0, 0, 0, 0, 0, 0, 0, 0, 0, 0, 0, 0, 0, 0, 0]"
49,18,20,17,1228,0,15,5,"[0, 0, 1, 0, 0, 1, 0, 1, 0, 1, 1, 1, 1, 1, 1, 1, 0, 0, 1, 0, 0, 0, 1, 1, 0, 0, 1]"
50,18,22,8,1242,0,22,0,"[0, 0, 0, 0, 0, 0, 0, 0, 0, 0, 0, 0, 0, 0, 0, 0, 0, 0, 0, 0, 0, 0, 0, 0, 0, 0, 0]"
51,18,38,16,1264,0,31,7,"[2, 1, 2, 1, 0, 1, 2, 0, 0, 0, 2, 1, 2, 1, 2, 0, 2, 0, 2, 1, 1, 1, 2, 2, 2, 2, 0]"
52,18,96,5,1355,0,32,64,"[18, 10, 1, 18, 13, 10, 11, 1, 6, 18, 16, 18, 7, 16, 9, 1, 16, 0, 1, 12, 17, 18, 11, 10, 10, 21, 2]"
53,18,96,25,1426,0,57,39,"[10, 10, 7, 5, 7, 3, 10, 10, 3, 6, 3, 0, 0, 5, 12, 3, 12, 0, 9, 13, 7, 8, 4, 11, 2, 8, 11]"
54,18,5,5,1426,0,0,5,"[0, 0, 0, 1, 0, 0, 1, 1, 0, 0, 0, 0, 1, 1, 0, 0, 1, 0, 1, 0, 0, 1, 0, 1, 0, 0, 1]"
55,18,67,54,1439,0,7,60,"[8, 1, 19, 6, 9, 12, 15, 3, 13, 3, 17, 10, 0, 13, 14, 9, 7, 0, 15, 6, 15, 7, 4, 12, 2, 13, 6]"
56,18,87,43,1483,0,13,74,"[17, 24, 22, 4, 19, 0, 22, 0, 12, 12, 2, 0, 22, 16, 10, 4, 12, 0, 8, 4, 5, 17, 22, 11, 10, 20, 24]"
57,18,50,9,1524,0,39,11,"[2, 2, 1, 3, 1, 2, 1, 3, 1, 2, 0, 0, 2, 1, 1, 0, 1, 0, 3, 1, 1, 1, 2, 3, 3, 0, 0]"
58,18,1,0,1484,0,0,1,"[0, 0, 0, 0, 0, 0, 0, 0, 0, 0, 0, 0, 0, 0, 0, 0, 0, 0, 0, 0, 0, 0, 0, 0, 0, 0, 0]"
59,18,28,16,1496,0,28,0,"[0, 0, 0, 0, 0, 0, 0, 0, 0, 0, 0, 0, 0, 0, 0, 0, 0, 0, 0, 0, 0, 0, 0, 0, 0, 0, 0]"
60,18,83,20,1559,0,77,6,"[1, 1, 1, 2, 2, 2, 1, 0, 0, 2, 1, 0, 2, 2, 2, 1, 0, 0, 2, 1, 0, 2, 1, 1, 0, 2, 1]"
61,18,61,3,1617,0,60,1,"[0, 0, 0, 0, 0, 0, 0, 0, 0, 0, 0, 0, 0, 0, 0, 0, 0, 0, 0, 0, 0, 0, 0, 0, 0, 0, 0]"
62,18,24,3,1638,0,2,22,"[3, 4, 1, 5, 2, 5, 4, 7, 7, 1, 6, 5, 3, 7, 3, 6, 7, 0, 7, 1, 3, 4, 1, 7, 0, 4, 0]"
63,18,25,3,1660,0,18,7,"[0, 1, 2, 1, 1, 0, 1, 1, 2, 1, 1, 2, 2, 2, 0, 1, 1, 0, 1, 2, 2, 2, 1, 2, 1, 0, 2]"
64,18,17,8,1669,0,10,7,"[2, 2, 1, 1, 2, 0, 1, 1, 0, 0, 2, 2, 0, 0, 1, 0, 0, 0, 0, 0, 0, 0, 1, 1, 2, 0, 1]"
65,18,12,7,1674,0,3,9,"[1, 0, 1, 3, 1, 1, 0, 1, 3, 2, 3, 3, 1, 0, 2, 2, 0, 0, 3, 3, 3, 0, 1, 2, 0, 1, 3]"
66,18,8,4,1678,0,1,7,"[1, 1, 2, 2, 1, 2, 0, 1, 2, 1, 2, 0, 0, 0, 1, 2, 0, 0, 0, 2, 0, 1, 1, 0, 1, 2, 0]"
67,18,55,10,1723,0,24,31,"[2, 0, 9, 2, 9, 8, 2, 2, 5, 7, 8, 0, 2, 3, 8, 0, 1, 0, 5, 6, 8, 7, 5, 4, 2, 7, 3]"
68,18,88,48,1763,0,53,35,"[1, 10, 1, 1, 1, 6, 2, 9, 2, 7, 9, 0, 8, 2, 9, 1, 11, 0, 8, 11, 3, 7, 5, 8, 8, 10, 7]"
69,18,75,46,1792,0,54,21,"[5, 1, 6, 5, 0, 2, 1, 1, 6, 0, 0, 7, 3, 4, 4, 1, 7, 0, 7, 6, 6, 6, 3, 2, 7, 0, 4]"
70,18,17,2,1807,0,4,13,"[0, 0, 4, 4, 2, 2, 1, 0, 3, 3, 3, 3, 4, 0, 0, 3, 0, 0, 2, 1, 0, 1, 4, 2, 2, 0, 3]"
71,18,89,68,1828,0,86,3,"[0, 0, 1, 1, 0, 1, 1, 1, 1, 0, 1, 1, 1, 0, 1, 1, 0, 0, 0, 1, 1, 1, 0, 1, 1, 1, 0]"
72,18,56,54,1830,0,35,21,"[1, 6, 3, 2, 7, 2, 6, 2, 0, 2, 6, 0, 0, 5, 7, 7, 0, 0, 3, 3, 3, 7, 0, 4, 2, 6, 2]"
73,18,87,64,1853,0,7,80,"[26, 11, 18, 5, 19, 8, 1, 11, 19, 25, 1, 20, 8, 17, 7, 9, 6, 0, 26, 14, 14, 22, 21, 24, 4, 16, 9]"
74,18,33,22,1864,0,0,33,"[6, 10, 8, 7, 2, 9, 7, 5, 4, 1, 6, 3, 3, 1, 2, 1, 2, 0, 3, 1, 8, 7, 1, 1, 8, 9, 3]"
75,18,14,0,1878,0,4,10,"[2, 3, 2, 0, 1, 0, 3, 3, 1, 3, 1, 2, 3, 1, 1, 3, 2, 0, 0, 1, 0, 2, 2, 0, 0, 0, 1]"
76,18,48,48,1878,0,37,11,"[2, 0, 2, 2, 1, 3, 1, 3, 2, 2, 2, 1, 3, 1, 0, 3, 3, 0, 2, 1, 1, 0, 2, 2, 0, 1, 3]"
77,18,12,9,1881,0,3,9,"[2, 1, 2, 0, 3, 3, 1, 3, 3, 1, 3, 2, 2, 1, 1, 1, 2, 0, 3, 0, 1, 3, 1, 2, 2, 2, 1]"
78,18,59,52,1888,0,16,43,"[5, 11, 1, 13, 8, 4, 0, 8, 14, 12, 1, 7, 11, 4, 2, 14, 8, 0, 9, 3, 0, 13, 1, 1, 1, 2, 3]"
79,18,3,3,1888,0,0,3,"[1, 0, 0, 0, 0, 1, 1, 1, 1, 1, 1, 1, 1, 0, 0, 0, 0, 0, 0, 0, 1, 0, 0, 0, 1, 1, 1]"
80,18,92,62,1918,0,81,11,"[2, 1, 0, 0, 1, 1, 3, 0, 0, 0, 1, 1, 3, 3, 1, 3, 0, 0, 0, 0, 3, 1, 2, 1, 2, 2, 1]"
81,18,51,6,1963,0,44,7,"[1, 0, 0, 2, 0, 1, 2, 0, 1, 1, 0, 1, 2, 0, 2, 2, 1, 0, 2, 0, 1, 0, 2, 0, 0, 1, 2]"
82,18,37,21,1979,0,17,20,"[3, 2, 5, 5, 3, 2, 2, 2, 4, 4, 4, 4, 6, 5, 6, 6, 5, 0, 4, 4, 4, 3, 5, 6, 1, 1, 4]"
83,18,62,55,1986,0,16,46,"[2, 6, 11, 10, 8, 13, 3, 6, 4, 10, 15, 5, 0, 10, 6, 7, 2, 0, 4, 2, 12, 11, 7, 14, 10, 15, 3]"
84,18,18,17,1987,0,1,17,"[5, 5, 4, 0, 1, 5, 0, 5, 5, 2, 2, 1, 3, 1, 1, 1, 1, 0, 2, 5, 1, 0, 2, 2, 0, 3, 3]"
85,18,84,84,1987,0,57,27,"[0, 3, 1, 9, 1, 2, 9, 3, 6, 6, 0, 2, 4, 2, 3, 4, 1, 0, 9, 1, 8, 7, 4, 8, 2, 5, 4]"
86,18,11,7,1991,0,11,0,"[0, 0, 0, 0, 0, 0, 0, 0, 0, 0, 0, 0, 0, 0, 0, 0, 0, 0, 0, 0, 0, 0, 0, 0, 0, 0, 0]"
87,18,49,25,2015,0,47,2,"[0, 0, 0, 0, 0, 0, 0, 0, 0, 0, 0, 0, 0, 0, 0, 0, 0, 0, 0, 0, 0, 0, 0, 0, 0, 0, 0]"
88,18,52,31,2036,0,50,2,"[0, 0, 0, 0, 0, 0, 0, 0, 0, 0, 0, 0, 0, 0, 0, 0, 0, 0, 0, 0, 0, 0, 0, 0, 0, 0, 0]"
89,18,1,0,2016,0,0,1,"[0, 0, 0, 0, 0, 0, 0, 0, 0, 0, 0, 0, 0, 0, 0, 0, 0, 0, 0, 0, 0, 0, 0, 0, 0, 0, 0]"
90,18,11,0,2027,0,1,10,"[0, 0, 1, 3, 0, 1, 3, 1, 2, 0, 1, 2, 0, 2, 2, 3, 0, 0, 1, 2, 1, 3, 3, 3, 2, 0, 2]"
91,18,8,2,2033,0,0,8,"[0, 2, 1, 2, 2, 1, 1, 2, 2, 1, 0, 0, 2, 1, 2, 2, 0, 0, 1, 1, 0, 0, 2, 1, 0, 1, 2]"
92,18,71,55,2049,0,61,10,"[2, 0, 3, 0, 0, 3, 1, 0, 3, 0, 2, 2, 2, 0, 1, 2, 0, 0, 1, 0, 2, 2, 3, 3, 1, 0, 2]"
93,18,24,8,2065,0,8,16,"[4, 4, 2, 0, 3, 1, 3, 5, 3, 4, 1, 3, 5, 0, 5, 5, 1, 0, 2, 3, 4, 2, 2, 5, 0, 1, 3]"
94,18,22,22,2065,0,1,21,"[3, 6, 1, 0, 6, 4, 6, 3, 1, 4, 7, 4, 6, 2, 1, 0, 7, 0, 4, 2, 3, 3, 0, 5, 1, 2, 4]"
95,18,6,5,2066,0,1,5,"[1, 1, 1, 1, 0, 1, 0, 1, 0, 1, 0, 1, 1, 1, 1, 1, 0, 0, 1, 1, 1, 1, 1, 1, 1, 1, 0]"
96,18,16,8,2074,0,13,3,"[0, 0, 0, 1, 1, 0, 0, 0, 1, 0, 0, 0, 0, 1, 0, 1, 1, 0, 1, 0, 0, 1, 1, 0, 0, 0, 0]"
97,18,35,14,2095,0,33,2,"[0, 0, 0, 0, 0, 0, 0, 0, 0, 0, 0, 0, 0, 0, 0, 0, 0, 0, 0, 0, 0, 0, 0, 0, 0, 0, 0]"
98,18,47,47,2095,0,12,35,"[6, 9, 10, 5, 7, 8, 6, 4, 3, 11, 10, 4, 4, 11, 9, 10, 2, 0, 0, 0, 6, 3, 9, 1, 5, 11, 4]"
99,18,86,25,2156,0,25,61,"[8, 4, 4, 0, 15, 3, 4, 17, 5, 1, 16, 12, 8, 6, 1, 5, 13, 0, 4, 15, 11, 7, 19, 12, 15, 19, 11]"
100,18,61,31,2186,0,50,11,"[1, 2, 0, 0, 3, 1, 3, 2, 3, 2, 2, 3, 1, 1, 0, 2, 0, 0, 2, 3, 2, 0, 3, 0, 0, 3, 0]"
101,18,39,0,2225,0,36,3,"[1, 1, 1, 0, 0, 0, 0, 0, 0, 0, 0, 1, 0, 0, 1, 1, 0, 0, 0, 1, 0, 0, 0, 1, 0, 0, 1]"
102,18,15,12,2228,0,15,0,"[0, 0, 0, 0, 0, 0, 0, 0, 0, 0, 0, 0, 0, 0, 0, 0, 0, 0, 0, 0, 0, 0, 0, 0, 0, 0, 0]"
103,18,7,0,2235,0,4,3,"[0, 1, 0, 0, 1, 1, 0, 0, 1, 0, 0, 1, 1, 1, 1, 0, 0, 0, 1, 0, 0, 1, 1, 0, 1, 1, 0]"
104,18,18,15,2238,0,13,5,"[0, 0, 1, 1, 1, 1, 1, 0, 1, 1, 1, 0, 0, 0, 0, 1, 0, 0, 1, 0, 0, 0, 0, 1, 1, 1, 0]"
105,18,15,0,2253,0,11,4,"[1, 1, 0, 0, 1, 0, 0, 1, 1, 1, 1, 1, 0, 0, 1, 1, 1, 0, 1, 1, 0, 0, 0, 0, 0, 0, 0]"
106,18,66,57,2262,0,62,4,"[0, 0, 1, 1, 1, 1, 1, 1, 0, 1, 0, 1, 0, 1, 1, 0, 0, 0, 0, 1, 1, 1, 1, 0, 1, 1, 0]"
107,18,60,38,2284,0,37,23,"[5, 5, 0, 0, 0, 3, 1, 1, 0, 2, 0, 2, 3, 6, 1, 1, 3, 0, 1, 0, 5, 3, 4, 7, 1, 5, 0]"
108,18,3,3,2284,0,2,1,"[0, 0, 0, 0, 0, 0, 0, 0, 0, 0, 0, 0, 0, 0, 0, 0, 0, 0, 0, 0, 0, 0, 0, 0, 0, 0, 0]"
109,18,61,38,2307,0,43,18,"[2, 4, 0, 1, 5, 6, 5, 2, 3, 2, 4, 3, 6, 4, 5, 0, 1, 0, 5, 2, 2, 2, 4, 2, 3, 3, 0]"
110,18,26,22,2311,0,4,22,"[1, 2, 6, 5, 0, 5, 2, 5, 7, 2, 1, 0, 2, 6, 6, 4, 5, 0, 2, 0, 3, 6, 6, 4, 5, 3, 2]"
111,18,97,54,2354,0,8,89,"[6, 21, 6, 7, 10, 21, 26, 18, 14, 2, 11, 1, 2, 24, 20, 13, 0, 0, 4, 29, 13, 23, 14, 14, 27, 0, 16]"
112,18,84,61,2377,0,10,74,"[14, 0, 20, 5, 11, 5, 5, 9, 6, 6, 7, 24, 18, 7, 13, 21, 10, 0, 5, 19, 15, 2, 3, 2, 4, 13, 4]"
113,18,55,5,2427,0,38,17,"[0, 1, 3, 2, 4, 1, 1, 5, 1, 4, 3, 0, 0, 0, 3, 0, 2, 0, 0, 4, 4, 0, 2, 5, 2, 2, 3]"
114,18,4,2,2429,0,2,2,"[0, 0, 0, 0, 0, 0, 0, 0, 0, 0, 0, 0, 0, 0, 0, 0, 0, 0, 0, 0, 0, 0, 0, 0, 0, 0, 0]"
115,18,81,78,2432,0,15,66,"[9, 0, 10, 16, 3, 0, 17, 9, 6, 20, 8, 8, 21, 0, 17, 7, 7, 0, 7, 18, 10, 16, 8, 21, 5, 15, 16]"
116,18,50,19,2463,0,16,34,"[11, 7, 5, 11, 11, 0, 6, 3, 3, 6, 8, 5, 3, 3, 7, 1, 0, 0, 10, 9, 0, 3, 1, 9, 5, 6, 7]"
117,18,4,0,2467,0,1,3,"[1, 0, 1, 0, 1, 1, 0, 0, 0, 0, 1, 0, 1, 0, 0, 0, 0, 0, 0, 0, 0, 1, 1, 0, 1, 1, 1]"
118,18,88,58,2497,0,12,76,"[9, 12, 22, 20, 0, 10, 20, 3, 3, 23, 10, 18, 18, 24, 16, 19, 10, 0, 19, 2, 0, 14, 0, 5, 0, 5, 25]"
119,18,78,3,2572,0,55,23,"[7, 5, 1, 6, 5, 4, 4, 4, 4, 0, 2, 3, 6, 1, 6, 0, 1, 0, 6, 1, 4, 7, 3, 2, 7, 7, 3]"
120,18,34,1,2605,0,15,19,"[0, 3, 0, 1, 1, 5, 5, 3, 4, 0, 0, 5, 6, 4, 0, 6, 2, 0, 4, 4, 2, 2, 3, 5, 2, 0, 5]"
121,18,98,47,2656,0,10,88,"[22, 18, 12, 10, 3, 8, 17, 14, 2, 26, 3, 8, 22, 28, 8, 17, 29, 0, 18, 21, 3, 25, 6, 28, 10, 5, 27]"
122,18,50,46,2660,0,47,3,"[0, 0, 0, 1, 1, 0, 0, 0, 1, 0, 0, 0, 0, 0, 1, 1, 0, 0, 1, 0, 0, 1, 1, 1, 1, 0, 0]"
123,18,95,3,2752,0,80,15,"[5, 5, 0, 3, 0, 2, 3, 5, 2, 2, 1, 5, 0, 5, 2, 5, 3, 0, 0, 3, 5, 4, 4, 5, 5, 2, 1]"
124,18,30,12,2770,0,7,23,"[2, 3, 5, 6, 7, 0, 4, 6, 6, 7, 2, 0, 0, 4, 2, 6, 2, 0, 7, 7, 2, 5, 5, 5, 6, 3, 4]"
125,18,62,49,2783,0,45,17,"[0, 2, 1, 1, 3, 1, 3, 2, 2, 2, 0, 4, 2, 2, 2, 3, 1, 0, 0, 5, 5, 1, 3, 2, 3, 3, 4]"
126,18,24,7,2800,0,2,22,"[5, 1, 2, 6, 7, 0, 4, 4, 3, 7, 7, 4, 4, 2, 7, 6, 5, 0, 0, 4, 3, 3, 7, 2, 1, 3, 2]"
127,18,55,13,2842,0,32,23,"[2, 3, 2, 2, 7, 1, 0, 7, 3, 0, 6, 4, 1, 4, 6, 0, 1, 0, 7, 7, 3, 3, 7, 2, 0, 3, 0]"
128,18,68,58,2852,0,3,65,"[13, 7, 21, 9, 14, 5, 1, 17, 5, 10, 21, 7, 5, 16, 4, 14, 2, 0, 21, 4, 21, 15, 12, 21, 12, 5, 10]"
129,18,35,29,2858,0,1,34,"[3, 5, 0, 11, 2, 8, 6, 3, 7, 1, 10, 0, 4, 0, 11, 2, 7, 0, 7, 0, 5, 0, 1, 8, 5, 6, 10]"
130,18,13,11,2860,0,0,13,"[4, 2, 2, 0, 1, 4, 2, 1, 1, 2, 1, 1, 1, 0, 3, 4, 3, 0, 3, 1, 2, 2, 0, 1, 2, 0, 0]"
131,18,2,0,2862,0,0,2,"[0, 0, 0, 0, 0, 0, 0, 0, 0, 0, 0, 0, 0, 0, 0, 0, 0, 0, 0, 0, 0, 0, 0, 0, 0, 0, 0]"
132,18,22,8,2876,0,3,19,"[4, 4, 0, 4, 4, 2, 1, 0, 1, 3, 3, 1, 4, 5, 3, 1, 4, 0, 4, 2, 2, 0, 2, 5, 1, 4, 4]"
133,18,16,16,2876,0,7,9,"[2, 0, 1, 0, 1, 2, 0, 3, 0, 2, 1, 0, 1, 1, 1, 3, 0, 0, 0, 2, 0, 1, 3, 2, 0, 2, 0]"
134,18,17,9,2884,0,5,12,"[2, 0, 0, 0, 3, 1, 3, 3, 3, 3, 4, 2, 1, 3, 0, 2, 0, 0, 2, 3, 4, 1, 3, 1, 2, 1, 0]"
135,18,71,37,2918,0,42,29,"[4, 2, 8, 9, 4, 8, 7, 8, 9, 9, 1, 4, 6, 6, 7, 4, 6, 0, 9, 2, 5, 8, 5, 4, 4, 4, 4]"
136,18,40,29,2929,0,0,40,"[8, 10, 0, 2, 5, 0, 9, 7, 1, 11, 8, 13, 0, 4, 6, 4, 3, 0, 6, 0, 1, 7, 10, 1, 0, 5, 7]"
137,18,18,1,2946,0,12,6,"[1, 2, 0, 1, 1, 2, 0, 1, 1, 2, 2, 1, 1, 0, 1, 0, 1, 0, 2, 0, 2, 2, 2, 1, 0, 1, 2]"
138,18,83,53,2976,0,24,59,"[8, 7, 14, 13, 1, 16, 6, 1, 10, 19, 0, 16, 9, 10, 4, 5, 7, 0, 3, 10, 5, 2, 10, 11, 12, 3, 13]"
139,18,70,27,3019,0,44,26,"[1, 4, 6, 8, 3, 6, 4, 0, 3, 2, 8, 5, 1, 6, 1, 4, 8, 0, 6, 0, 3, 2, 7, 4, 5, 3, 0]"
140,18,28,8,3039,0,28,0,"[0, 0, 0, 0, 0, 0, 0, 0, 0, 0, 0, 0, 0, 0, 0, 0, 0, 0, 0, 0, 0, 0, 0, 0, 0, 0, 0]"
141,18,68,10,3097,0,11,57,"[6, 0, 6, 12, 8, 16, 13, 0, 19, 3, 18, 1, 13, 12, 11, 9, 5, 0, 7, 5, 8, 4, 11, 4, 11, 12, 2]"
142,18,56,21,3132,0,1,55,"[4, 10, 13, 9, 4, 14, 18, 7, 8, 14, 4, 15, 4, 2, 14, 10, 14, 0, 3, 14, 14, 6, 11, 7, 1, 3, 4]"
143,18,70,31,3171,0,39,31,"[9, 5, 0, 1, 0, 4, 0, 0, 2, 10, 4, 0, 8, 5, 2, 2, 5, 0, 5, 0, 8, 5, 5, 10, 10, 0, 4]"
144,18,57,42,3186,0,51,6,"[2, 1, 1, 1, 0, 2, 0, 0, 2, 0, 1, 0, 1, 1, 1, 0, 1, 0, 1, 1, 2, 0, 0, 0, 0, 0, 0]"
145,18,92,46,3232,0,2,90,"[8, 29, 23, 12, 7, 3, 10, 29, 3, 22, 15, 2, 18, 6, 24, 13, 9, 0, 1, 14, 26, 23, 29, 27, 24, 4, 22]"
146,18,27,6,3253,0,19,8,"[0, 1, 2, 2, 2, 1, 2, 1, 1, 1, 0, 0, 2, 0, 1, 1, 1, 0, 2, 2, 1, 1, 0, 2, 2, 1, 2]"
147,18,19,9,3263,0,14,5,"[0, 0, 1, 1, 1, 1, 0, 0, 1, 0, 1, 0, 1, 1, 0, 1, 0, 0, 1, 0, 1, 1, 1, 1, 1, 0, 1]"
148,18,10,2,3271,0,3,7,"[0, 2, 0, 0, 1, 2, 0, 1, 1, 0, 0, 2, 1, 0, 2, 2, 0, 0, 1, 2, 1, 2, 1, 0, 2, 0, 2]"
149,18,14,9,3276,0,12,2,"[0, 0, 0, 0, 0, 0, 0, 0, 0, 0, 0, 0, 0, 0, 0, 0, 0, 0, 0, 0, 0, 0, 0, 0, 0, 0, 0]"
150,18,40,24,3292,0,31,9,"[0, 3, 1, 1, 2, 2, 2, 0, 3, 3, 3, 2, 3, 1, 1, 0, 1, 0, 2, 0, 2, 3, 0, 2, 3, 0, 1]"
151,18,43,30,3305,0,24,19,"[6, 0, 4, 0, 2, 5, 1, 0, 4, 0, 0, 6, 0, 0, 4, 4, 5, 0, 4, 4, 3, 1, 1, 1, 2, 2, 5]"
152,18,24,8,3321,0,11,13,"[2, 4, 2, 1, 2, 3, 2, 3, 2, 4, 2, 4, 2, 3, 0, 4, 3, 0, 2, 2, 0, 3, 2, 2, 3, 4, 0]"
153,18,88,65,3344,0,67,21,"[5, 6, 1, 1, 2, 7, 2, 4, 5, 3, 7, 6, 1, 3, 3, 1, 3, 0, 1, 6, 1, 5, 5, 2, 6, 0, 1]"
154,18,99,8,3435,0,86,13,"[2, 2, 2, 1, 2, 3, 2, 4, 3, 0, 3, 2, 0, 4, 1, 3, 0, 0, 1, 1, 2, 1, 1, 4, 1, 1, 1]"
155,18,86,44,3477,0,4,82,"[23, 16, 12, 7, 17, 16, 22, 5, 15, 23, 12, 14, 20, 27, 22, 27, 18, 0, 1, 26, 15, 17, 8, 23, 9, 6, 0]"
156,18,79,59,3497,0,23,56,"[16, 7, 12, 2, 1, 0, 15, 6, 8, 0, 0, 7, 2, 15, 2, 2, 6, 0, 5, 15, 11, 13, 7, 8, 9, 13, 10]"
157,18,55,19,3533,0,10,45,"[3, 0, 8, 11, 3, 11, 11, 13, 13, 8, 7, 9, 11, 4, 1, 15, 0, 0, 3, 11, 11, 0, 8, 11, 4, 2, 15]"
158,18,79,5,3607,0,64,15,"[5, 0, 1, 0, 4, 0, 2, 2, 4, 3, 0, 5, 1, 5, 4, 3, 1, 0, 0, 2, 0, 4, 1, 3, 5, 4, 4]"
159,18,35,10,3632,0,23,12,"[3, 1, 2, 1, 2, 2, 2, 3, 0, 4, 2, 3, 1, 2, 0, 0, 4, 0, 0, 4, 1, 2, 0, 3, 4, 3, 4]"
160,18,61,33,3660,0,22,39,"[13, 5, 12, 5, 9, 11, 12, 12, 7, 11, 12, 1, 10, 8, 8, 5, 13, 0, 13, 8, 2, 5, 11, 9, 10, 1, 9]"
161,18,88,69,3679,0,20,68,"[1, 9, 10, 5, 12, 4, 8, 13, 11, 6, 8, 2, 8, 10, 0, 17, 4, 0, 4, 22, 14, 18, 20, 9, 2, 14, 14]"
162,18,49,37,3691,0,22,27,"[1, 4, 3, 4, 8, 6, 5, 5, 9, 9, 7, 0, 4, 4, 8, 0, 3, 0, 4, 0, 0, 5, 6, 4, 1, 6, 7]"
163,18,39,17,3713,0,16,23,"[0, 1, 3, 4, 0, 4, 5, 1, 1, 1, 6, 5, 3, 6, 6, 7, 2, 0, 1, 6, 0, 7, 1, 5, 0, 5, 7]"
164,18,21,7,3727,0,12,9,"[2, 2, 1, 3, 3, 0, 2, 3, 2, 3, 0, 1, 2, 1, 2, 2, 0, 0, 3, 0, 2, 2, 0, 3, 2, 1, 1]"
165,18,70,15,3782,0,39,31,"[3, 0, 1, 6, 9, 6, 9, 9, 6, 2, 9, 4, 1, 7, 1, 8, 9, 0, 0, 1, 1, 8, 4, 10, 9, 2, 8]"
166,18,81,59,3804,0,48,33,"[3, 10, 7, 4, 3, 4, 6, 10, 11, 7, 1, 2, 10, 4, 4, 1, 10, 0, 0, 4, 6, 5, 0, 0, 7, 5, 5]"
167,18,58,58,3804,0,34,24,"[7, 5, 4, 8, 5, 7, 3, 2, 2, 4, 0, 3, 1, 0, 0, 0, 5, 0, 7, 0, 2, 3, 5, 5, 2, 5, 8]"
168,18,51,25,3830,0,31,20,"[5, 5, 3, 3, 3, 4, 6, 3, 1, 6, 6, 1, 0, 0, 6, 4, 0, 0, 4, 1, 3, 1, 4, 0, 3, 0, 5]"
169,18,52,28,3854,0,41,11,"[2, 1, 0, 0, 0, 0, 2, 3, 0, 3, 2, 1, 2, 2, 3, 1, 3, 0, 3, 3, 3, 2, 0, 1, 3, 3, 3]"
170,18,55,10,3899,0,6,49,"[0, 14, 8, 0, 0, 13, 15, 4, 4, 12, 2, 12, 16, 11, 16, 3, 11, 0, 13, 9, 1, 14, 14, 11, 7, 4, 7]"
171,18,46,7,3938,0,15,31,"[4, 6, 6, 9, 3, 8, 8, 7, 8, 5, 1, 6, 9, 4, 7, 3, 6, 0, 9, 0, 4, 5, 10, 8, 0, 8, 1]"
172,18,86,54,3970,0,17,69,"[2, 15, 4, 9, 13, 6, 17, 22, 23, 19, 11, 19, 5, 12, 18, 3, 17, 0, 7, 5, 9, 23, 4, 21, 11, 16, 1]"
173,18,80,36,4014,0,74,6,"[2, 2, 0, 0, 1, 1, 2, 0, 1, 0, 0, 2, 0, 2, 0, 0, 2, 0, 1, 2, 0, 2, 0, 0, 2, 1, 1]"
174,18,49,24,4039,0,42,7,"[1, 1, 2, 2, 0, 1, 0, 2, 1, 0, 0, 2, 1, 1, 0, 2, 0, 0, 2, 0, 1, 0, 2, 1, 1, 2, 2]"
175,18,63,8,4094,0,61,2,"[0, 0, 0, 0, 0, 0, 0, 0, 0, 0, 0, 0, 0, 0, 0, 0, 0, 0, 0, 0, 0, 0, 0, 0, 0, 0, 0]"
176,18,31,3,4122,0,29,2,"[0, 0, 0, 0, 0, 0, 0, 0, 0, 0, 0, 0, 0, 0, 0, 0, 0, 0, 0, 0, 0, 0, 0, 0, 0, 0, 0]"
177,18,38,18,4142,0,12,26,"[1, 8, 1, 0, 4, 6, 3, 5, 7, 8, 1, 8, 6, 3, 7, 7, 8, 0, 2, 6, 2, 8, 7, 8, 8, 1, 3]"
178,18,10,5,4147,0,6,4,"[1, 1, 0, 1, 1, 0, 0, 1, 0, 1, 0, 0, 1, 1, 0, 0, 0, 0, 0, 0, 0, 0, 1, 1, 1, 1, 1]"
179,18,24,0,4171,0,1,23,"[6, 3, 2, 0, 7, 7, 3, 2, 5, 6, 0, 0, 7, 7, 2, 0, 0, 0, 1, 6, 5, 3, 4, 2, 0, 0, 0]"
180,18,30,19,4182,0,22,8,"[0, 2, 1, 0, 2, 1, 2, 0, 2, 2, 2, 0, 2, 0, 1, 2, 2, 0, 2, 2, 0, 0, 2, 2, 0, 2, 2]"
181,18,89,41,4230,0,3,86,"[7, 21, 14, 16, 18, 2, 12, 20, 0, 1, 5, 10, 18, 26, 8, 27, 6, 0, 6, 26, 23, 12, 19, 10, 1, 14, 13]"
182,18,60,42,4248,0,55,5,"[0, 0, 1, 1, 0, 0, 1, 1, 1, 0, 1, 1, 1, 1, 1, 0, 1, 0, 0, 0, 1, 0, 0, 1, 1, 0, 0]"
183,18,77,69,4256,0,51,26,"[6, 3, 3, 0, 8, 7, 7, 6, 0, 8, 8, 1, 1, 8, 0, 8, 3, 0, 1, 3, 6, 7, 4, 6, 4, 5, 2]"
184,18,6,5,4257,0,2,4,"[1, 0, 1, 1, 0, 0, 0, 0, 1, 1, 0, 0, 1, 0, 1, 1, 0, 0, 0, 0, 0, 1, 1, 1, 1, 1, 0]"
185,18,12,3,4266,0,12,0,"[0, 0, 0, 0, 0, 0, 0, 0, 0, 0, 0, 0, 0, 0, 0, 0, 0, 0, 0, 0, 0, 0, 0, 0, 0, 0, 0]"
186,18,82,55,4293,0,40,42,"[11, 11, 6, 0, 12, 10, 1, 2, 4, 13, 1, 5, 4, 7, 14, 11, 1, 0, 1, 5, 13, 13, 0, 7, 11, 6, 8]"
187,18,53,4,4342,0,48,5,"[1, 1, 0, 0, 0, 1, 1, 0, 1, 0, 1, 0, 1, 1, 0, 0, 1, 0, 1, 1, 0, 1, 0, 0, 1, 1, 1]"
188,18,31,29,4344,0,25,6,"[2, 2, 2, 1, 0, 1, 2, 2, 2, 0, 0, 2, 1, 2, 0, 0, 0, 0, 0, 1, 2, 0, 1, 0, 0, 1, 2]"
189,18,72,34,4382,0,72,0,"[0, 0, 0, 0, 0, 0, 0, 0, 0, 0, 0, 0, 0, 0, 0, 0, 0, 0, 0, 0, 0, 0, 0, 0, 0, 0, 0]"
190,18,28,3,4407,0,4,24,"[5, 4, 3, 7, 8, 8, 6, 7, 2, 1, 7, 7, 3, 6, 2, 6, 5, 0, 4, 4, 6, 7, 1, 8, 5, 8, 7]"
191,18,93,93,4407,0,34,59,"[2, 10, 13, 3, 0, 17, 7, 13, 0, 19, 7, 6, 14, 1, 16, 18, 2, 0, 0, 12, 14, 19, 3, 3, 0, 8, 9]"
192,18,57,1,4463,0,24,33,"[7, 6, 2, 1, 2, 5, 0, 11, 9, 11, 3, 11, 9, 10, 5, 5, 10, 0, 1, 8, 8, 10, 2, 7, 9, 11, 0]"
193,18,96,51,4508,0,13,83,"[12, 14, 16, 11, 25, 3, 5, 9, 2, 17, 12, 25, 17, 14, 15, 22, 17, 0, 21, 8, 27, 1, 3, 14, 14, 13, 10]"
194,18,70,4,4574,0,56,14,"[3, 0, 1, 2, 1, 2, 2, 4, 1, 3, 4, 1, 4, 3, 3, 0, 4, 0, 2, 2, 2, 0, 1, 4, 2, 2, 1]"
195,18,83,16,4641,0,55,28,"[2, 5, 4, 5, 0, 6, 3, 9, 3, 7, 0, 5, 3, 9, 7, 8, 1, 0, 8, 7, 8, 4, 1, 2, 4, 1, 7]"
196,18,12,4,4649,0,2,10,"[3, 1, 1, 2, 0, 3, 3, 3, 3, 3, 3, 2, 2, 0, 2, 1, 2, 0, 3, 0, 3, 0, 2, 1, 3, 2, 2]"
197,18,49,1,4697,0,15,34,"[0, 8, 2, 11, 2, 8, 8, 10, 7, 9, 9, 0, 6, 4, 1, 6, 2, 0, 1, 10, 10, 11, 6, 4, 6, 0, 7]"
198,18,14,0,4711,0,14,0,"[0, 0, 0, 0, 0, 0, 0, 0, 0, 0, 0, 0, 0, 0, 0, 0, 0, 0, 0, 0, 0, 0, 0, 0, 0, 0, 0]"
199,18,7,2,4716,0,6,1,"[0, 0, 0, 0, 0, 0, 0, 0, 0, 0, 0, 0, 0, 0, 0, 0, 0, 0, 0, 0, 0, 0, 0, 0, 0, 0, 0]"
200,18,66,31,4751,0,36,30,"[8, 9, 10, 4, 0, 8, 8, 6, 6, 5, 4, 7, 7, 9, 3, 0, 7, 0, 9, 6, 8, 6, 4, 6, 2, 5, 0]"
201,18,3,3,4751,0,1,2,"[0, 0, 0, 0, 0, 0, 0, 0, 0, 0, 0, 0, 0, 0, 0, 0, 0, 0, 0, 0, 0, 0, 0, 0, 0, 0, 0]"
202,18,28,18,4761,0,22,6,"[2, 0, 1, 0, 1, 1, 0, 2, 0, 1, 1, 0, 2, 1, 0, 2, 2, 0, 2, 0, 2, 2, 2, 1, 1, 1, 2]"
203,18,68,33,4796,0,23,45,"[2, 7, 3, 3, 13, 5, 10, 11, 0, 3, 10, 13, 11, 14, 4, 1, 5, 0, 15, 10, 4, 2, 5, 14, 7, 12, 1]"
204,18,61,53,4804,0,44,17,"[0, 4, 3, 4, 5, 0, 0, 2, 1, 4, 2, 2, 5, 2, 3, 4, 2, 0, 4, 4, 1, 5, 0, 3, 2, 3, 4]"
205,18,38,4,4838,0,21,17,"[0, 1, 1, 4, 2, 2, 2, 0, 2, 2, 5, 0, 4, 3, 5, 3, 2, 0, 1, 5, 3, 5, 1, 3, 0, 1, 1]"
206,18,57,13,4882,0,3,54,"[17, 10, 2, 4, 2, 15, 18, 3, 17, 18, 7, 16, 15, 8, 15, 13, 2, 0, 9, 4, 12, 12, 1, 12, 13, 2, 11]"
207,18,40,8,4914,0,1,39,"[11, 10, 13, 12, 8, 5, 12, 2, 2, 10, 5, 8, 10, 13, 1, 3, 11, 0, 6, 4, 8, 5, 4, 10, 2, 5, 7]"
208,18,13,8,4919,0,3,10,"[3, 3, 3, 0, 2, 0, 1, 2, 3, 0, 0, 1, 2, 0, 1, 1, 3, 0, 0, 1, 1, 3, 1, 1, 3, 2, 1]"
209,18,72,46,4945,0,49,23,"[4, 7, 0, 3, 4, 3, 5, 5, 4, 1, 6, 3, 3, 3, 2, 7, 6, 0, 0, 4, 0, 7, 6, 3, 6, 3, 0]"
210,18,74,42,4977,0,33,41,"[10, 12, 3, 12, 6, 13, 0, 3, 10, 8, 0, 8, 10, 8, 7, 11, 2, 0, 5, 11, 2, 10, 3, 10, 5, 13, 2]"
211,18,71,8,5040,0,12,59,"[15, 16, 11, 13, 4, 4, 19, 9, 4, 3, 3, 1, 16, 3, 7, 13, 6, 0, 12, 13, 1, 17, 14, 10, 1, 16, 10]"
212,18,15,4,5051,0,4,11,"[3, 2, 3, 1, 3, 1, 1, 0, 2, 0, 0, 2, 3, 0, 3, 3, 0, 0, 2, 1, 2, 0, 2, 3, 3, 2, 3]"
213,18,84,56,5079,0,29,55,"[11, 7, 13, 14, 17, 1, 2, 8, 17, 0, 2, 1, 17, 8, 11, 6, 15, 0, 15, 2, 7, 0, 15, 11, 18, 7, 15]"
214,18,83,40,5122,0,40,43,"[11, 11, 2, 11, 4, 2, 10, 5, 7, 9, 6, 5, 13, 7, 5, 11, 13, 0, 2, 14, 10, 1, 10, 6, 5, 13, 14]"
215,18,66,49,5139,0,21,45,"[14, 10, 7, 9, 8, 0, 6, 15, 0, 10, 12, 15, 4, 10, 5, 6, 8, 0, 10, 2, 4, 1, 15, 1, 10, 4, 8]"
216,18,28,17,5150,0,14,14,"[3, 0, 0, 0, 1, 3, 4, 1, 3, 4, 0, 1, 3, 0, 2, 1, 2, 0, 0, 2, 1, 4, 4, 4, 0, 0, 4]"
217,18,24,1,5173,0,1,23,"[4, 4, 6, 1, 2, 5, 0, 6, 4, 4, 3, 3, 6, 1, 2, 5, 3, 0, 6, 6, 2, 6, 5, 7, 5, 1, 7]"
218,18,15,9,5179,0,8,7,"[2, 1, 0, 1, 0, 1, 1, 0, 1, 1, 2, 0, 2, 2, 2, 1, 0, 0, 1, 1, 0, 0, 1, 1, 0, 2, 2]"
219,18,83,30,5232,0,60,23,"[2, 0, 3, 4, 4, 0, 2, 2, 4, 2, 5, 2, 5, 6, 3, 7, 1, 0, 5, 6, 3, 7, 4, 2, 2, 5, 4]"
220,18,69,67,5234,0,48,21,"[5, 0, 5, 7, 4, 6, 6, 0, 1, 7, 7, 2, 3, 4, 5, 7, 2, 0, 7, 6, 1, 0, 1, 0, 2, 7, 7]"
221,18,89,40,5283,0,37,52,"[13, 0, 13, 14, 16, 0, 14, 11, 13, 8, 15, 4, 3, 5, 8, 3, 7, 0, 0, 6, 15, 4, 10, 0, 15, 10, 1]"
222,18,2,1,5284,0,0,2,"[0, 0, 0, 0, 0, 0, 0, 0, 0, 0, 0, 0, 0, 0, 0, 0, 0, 0, 0, 0, 0, 0, 0, 0, 0, 0, 0]"
223,18,97,68,5313,0,8,89,"[16, 11, 24, 8, 0, 13, 1, 23, 1, 25, 28, 0, 1, 13, 18, 25, 16, 0, 8, 29, 15, 28, 20, 16, 7, 25, 25]"
224,18,25,17,5321,0,2,23,"[5, 7, 7, 5, 1, 1, 6, 0, 4, 5, 0, 5, 7, 0, 5, 2, 6, 0, 7, 5, 1, 2, 4, 2, 5, 6, 5]"
225,18,49,18,5352,0,36,13,"[4, 3, 4, 1, 0, 2, 1, 0, 2, 0, 4, 1, 2, 2, 1, 3, 2, 0, 4, 2, 0, 1, 1, 3, 0, 3, 4]"
226,18,95,60,5387,0,63,32,"[10, 3, 0, 6, 7, 3, 9, 4, 6, 7, 6, 1, 0, 8, 2, 7, 7, 0, 4, 3, 5, 2, 7, 3, 9, 10, 0]"
227,18,99,3,5483,0,4,95,"[9, 22, 11, 29, 1, 23, 13, 31, 18, 15, 23, 10, 5, 1, 3, 31, 11, 0, 12, 20, 25, 28, 20, 0, 10, 10, 25]"
228,18,42,12,5513,0,18,24,"[7, 4, 0, 1, 1, 7, 3, 1, 6, 2, 7, 4, 0, 1, 0, 6, 3, 0, 1, 4, 5, 3, 3, 0, 1, 7, 6]"
229,18,43,13,5543,0,12,31,"[5, 1, 4, 0, 4, 6, 2, 2, 4, 4, 7, 1, 1, 7, 5, 4, 5, 0, 1, 2, 6, 2, 3, 6, 6, 9, 1]"
230,18,0,0,5543,0,0,0,"[0, 0, 0, 0, 0, 0, 0, 0, 0, 0, 0, 0, 0, 0, 0, 0, 0, 0, 0, 0, 0, 0, 0, 0, 0, 0, 0]"
231,18,2,1,5544,0,2,0,"[0, 0, 0, 0, 0, 0, 0, 0, 0, 0, 0, 0, 0, 0, 0, 0, 0, 0, 0, 0, 0, 0, 0, 0, 0, 0, 0]"
232,18,23,19,5548,0,11,12,"[4, 2, 2, 3, 1, 2, 3, 2, 2, 4, 0, 1, 1, 3, 0, 4, 3, 0, 3, 3, 3, 1, 2, 2, 4, 1, 2]"
233,18,73,5,5616,0,62,11,"[1, 2, 0, 1, 0, 0, 0, 0, 2, 0, 2, 3, 3, 3, 1, 2, 3, 0, 0, 2, 1, 1, 2, 2, 2, 2, 1]"
234,18,60,24,5652,0,5,55,"[0, 14, 1, 3, 17, 10, 3, 2, 13, 13, 2, 10, 12, 17, 18, 10, 15, 0, 9, 12, 12, 12, 10, 1, 0, 8, 0]"
235,18,69,33,5688,0,5,64,"[1, 20, 0, 17, 19, 19, 4, 19, 14, 10, 7, 15, 16, 13, 15, 15, 20, 0, 21, 13, 4, 8, 18, 19, 6, 1, 10]"
236,18,50,32,5706,0,0,50,"[9, 9, 14, 15, 15, 8, 7, 3, 7, 4, 14, 11, 5, 16, 0, 7, 13, 0, 1, 15, 1, 8, 7, 5, 10, 15, 11]"
237,18,57,31,5732,0,0,57,"[0, 13, 16, 2, 14, 11, 0, 15, 12, 5, 1, 16, 1, 10, 13, 13, 1, 0, 14, 15, 5, 9, 16, 17, 2, 15, 11]"
238,18,3,0,5735,0,0,3,"[1, 0, 1, 1, 0, 1, 0, 1, 0, 0, 1, 1, 1, 0, 1, 1, 1, 0, 0, 0, 0, 0, 1, 0, 0, 1, 1]"
239,18,23,22,5736,0,19,4,"[0, 1, 1, 1, 1, 1, 0, 0, 1, 0, 0, 1, 0, 1, 0, 1, 1, 0, 0, 1, 0, 0, 0, 1, 1, 0, 1]"
240,18,87,86,5737,0,48,39,"[5, 5, 12, 8, 8, 12, 8, 6, 11, 13, 3, 11, 8, 5, 0, 5, 12, 0, 7, 6, 13, 1, 6, 2, 1, 5, 12]"
241,18,55,49,5743,0,52,3,"[0, 0, 0, 1, 1, 0, 1, 0, 1, 1, 1, 1, 0, 0, 0, 1, 0, 0, 0, 1, 0, 1, 0, 0, 1, 0, 0]"
242,18,78,44,5777,0,0,78,"[23, 18, 2, 16, 23, 16, 8, 4, 6, 2, 18, 13, 21, 5, 1, 24, 24, 0, 6, 13, 20, 2, 20, 17, 4, 11, 5]"
243,18,75,12,5840,0,21,54,"[4, 10, 1, 17, 3, 5, 6, 12, 12, 7, 0, 3, 5, 9, 17, 8, 15, 0, 15, 12, 1, 10, 11, 15, 18, 7, 9]"
244,18,17,4,5853,0,15,2,"[0, 0, 0, 0, 0, 0, 0, 0, 0, 0, 0, 0, 0, 0, 0, 0, 0, 0, 0, 0, 0, 0, 0, 0, 0, 0, 0]"
245,18,74,3,5924,0,42,32,"[5, 5, 6, 0, 6, 1, 10, 4, 3, 6, 0, 7, 8, 3, 3, 4, 6, 0, 0, 8, 2, 0, 8, 9, 9, 7, 6]"
246,18,28,3,5949,0,24,4,"[1, 1, 1, 0, 1, 0, 1, 1, 1, 0, 0, 0, 0, 0, 1, 1, 1, 0, 1, 1, 1, 1, 0, 1, 1, 1, 0]"
247,18,63,10,6002,0,34,29,"[3, 6, 0, 8, 3, 3, 5, 8, 9, 2, 6, 5, 8, 5, 6, 3, 4, 0, 6, 9, 3, 1, 6, 1, 6, 9, 2]"
248,18,30,10,6022,0,27,3,"[1, 1, 1, 1, 0, 0, 1, 1, 0, 1, 0, 1, 0, 0, 0, 1, 1, 0, 1, 0, 0, 1, 1, 0, 1, 1, 0]"
249,18,81,17,6086,0,50,31,"[4, 7, 0, 9, 0, 5, 5, 4, 1, 10, 4, 10, 3, 3, 2, 0, 9, 0, 9, 0, 0, 2, 9, 3, 4, 6, 0]"
250,18,33,24,6095,0,22,11,"[0, 1, 1, 3, 1, 1, 2, 0, 3, 2, 1, 1, 2, 1, 0, 2, 3, 0, 3, 3, 3, 1, 1, 0, 0, 0, 0]"
251,18,56,53,6098,0,1,55,"[6, 8, 16, 6, 3, 18, 11, 15, 15, 7, 0, 14, 1, 17, 13, 12, 2, 0, 5, 6, 8, 5, 2, 3, 17, 11, 3]"
252,18,92,10,6180,0,14,78,"[12, 0, 21, 26, 9, 9, 25, 25, 16, 7, 9, 9, 19, 1, 12, 5, 12, 0, 3, 10, 4, 5, 8, 11, 5, 21, 2]"
253,18,88,76,6192,0,4,84,"[23, 7, 25, 20, 1, 18, 7, 25, 8, 2, 14, 17, 16, 0, 27, 1, 18, 0, 5, 25, 12, 18, 12, 5, 22, 22, 18]"
254,18,23,20,6195,0,13,10,"[0, 0, 3, 1, 1, 0, 0, 2, 2, 3, 2, 2, 2, 1, 2, 0, 1, 0, 1, 2, 0, 2, 3, 0, 1, 3, 3]"
255,18,67,2,6260,0,52,15,"[2, 3, 4, 5, 0, 4, 0, 1, 0, 1, 0, 4, 5, 3, 0, 3, 5, 0, 5, 3, 1, 3, 3, 2, 2, 2, 0]"
256,18,68,12,6316,0,30,38,"[2, 1, 9, 5, 6, 6, 7, 6, 7, 10, 8, 9, 3, 8, 5, 6, 2, 0, 2, 0, 12, 9, 9, 2, 12, 10, 9]"
257,18,59,54,6321,0,26,33,"[4, 3, 11, 4, 3, 3, 9, 2, 6, 5, 8, 4, 0, 8, 0, 0, 4, 0, 8, 9, 11, 3, 9, 0, 5, 2, 6]"
258,18,32,24,6329,0,27,5,"[0, 0, 1, 1, 1, 0, 1, 0, 1, 1, 0, 0, 1, 1, 0, 0, 0, 0, 1, 0, 0, 0, 1, 0, 0, 1, 0]"
259,18,42,29,6342,0,26,16,"[1, 3, 5, 1, 2, 3, 0, 3, 5, 0, 3, 0, 4, 2, 1, 2, 3, 0, 1, 5, 0, 4, 5, 2, 1, 0, 5]"
260,18,19,3,6358,0,4,15,"[5, 5, 0, 1, 5, 5, 3, 4, 5, 4, 2, 5, 4, 3, 4, 0, 1, 0, 0, 1, 1, 3, 3, 3, 5, 2, 2]"
261,18,41,3,6396,0,15,26,"[2, 2, 6, 4, 8, 5, 3, 5, 5, 8, 1, 8, 0, 5, 4, 3, 4, 0, 5, 3, 6, 1, 6, 4, 5, 5, 4]"
262,18,91,33,6454,0,63,28,"[9, 9, 4, 1, 4, 7, 7, 7, 9, 5, 6, 0, 4, 6, 0, 2, 1, 0, 3, 8, 0, 2, 7, 0, 5, 0, 7]"
263,18,62,32,6484,0,5,57,"[5, 1, 19, 7, 8, 5, 1, 6, 18, 18, 2, 16, 2, 18, 13, 6, 6, 0, 6, 2, 4, 9, 7, 4, 10, 10, 12]"
264,18,57,1,6540,0,14,43,"[11, 7, 13, 0, 6, 9, 13, 10, 6, 11, 2, 12, 5, 10, 12, 10, 14, 0, 7, 8, 13, 7, 9, 2, 6, 10, 7]"
265,18,5,5,6540,0,1,4,"[1, 0, 0, 0, 1, 0, 0, 1, 1, 1, 0, 0, 1, 1, 1, 1, 0, 0, 1, 0, 1, 1, 1, 1, 1, 0, 1]"
266,18,79,62,6557,0,25,54,"[2, 11, 10, 2, 8, 17, 13, 8, 18, 17, 13, 8, 6, 10, 15, 8, 2, 0, 10, 18, 6, 18, 7, 17, 10, 14, 6]"
267,18,12,6,6563,0,8,4,"[0, 0, 0, 1, 0, 0, 0, 0, 0, 1, 1, 0, 0, 0, 0, 1, 0, 0, 0, 1, 0, 0, 1, 0, 0, 0, 1]"
268,18,65,49,6579,0,9,56,"[17, 9, 5, 17, 9, 14, 12, 3, 16, 18, 5, 5, 2, 4, 16, 3, 17, 0, 3, 16, 15, 6, 16, 12, 11, 12, 7]"
269,18,85,80,6584,0,84,1,"[0, 0, 0, 0, 0, 0, 0, 0, 0, 0, 0, 0, 0, 0, 0, 0, 0, 0, 0, 0, 0, 0, 0, 0, 0, 0, 0]"
270,18,32,2,6614,0,32,0,"[0, 0, 0, 0, 0, 0, 0, 0, 0, 0, 0, 0, 0, 0, 0, 0, 0, 0, 0, 0, 0, 0, 0, 0, 0, 0, 0]"
271,18,31,4,6641,0,27,4,"[1, 0, 0, 0, 0, 0, 1, 1, 1, 1, 0, 0, 1, 1, 0, 1, 0, 0, 0, 0, 1, 1, 0, 1, 1, 1, 1]"
272,18,23,0,6664,0,23,0,"[0, 0, 0, 0, 0, 0, 0, 0, 0, 0, 0, 0, 0, 0, 0, 0, 0, 0, 0, 0, 0, 0, 0, 0, 0, 0, 0]"
273,18,80,29,6715,0,33,47,"[0, 6, 0, 4, 9, 13, 7, 3, 6, 11, 7, 14, 3, 14, 0, 13, 14, 0, 0, 7, 5, 3, 7, 15, 2, 11, 12]"
274,18,2,0,6717,0,2,0,"[0, 0, 0, 0, 0, 0, 0, 0, 0, 0, 0, 0, 0, 0, 0, 0, 0, 0, 0, 0, 0, 0, 0, 0, 0, 0, 0]"
275,18,51,39,6729,0,24,27,"[4, 4, 8, 8, 7, 3, 9, 0, 0, 5, 1, 4, 6, 0, 4, 6, 8, 0, 1, 0, 6, 2, 8, 6, 7, 8, 2]"
276,18,21,15,6735,0,1,20,"[5, 0, 6, 1, 6, 1, 1, 2, 5, 6, 0, 3, 2, 3, 0, 0, 0, 0, 2, 0, 3, 0, 0, 6, 2, 0, 0]"
277,18,20,2,6753,0,16,4,"[0, 1, 0, 0, 1, 0, 0, 0, 0, 0, 1, 1, 1, 0, 1, 0, 0, 0, 0, 0, 0, 0, 1, 0, 0, 1, 1]"
278,18,28,22,6759,0,3,25,"[0, 0, 6, 4, 1, 8, 0, 8, 6, 3, 5, 1, 7, 4, 7, 5, 1, 0, 8, 4, 7, 2, 0, 5, 5, 3, 4]"
279,18,39,6,6792,0,32,7,"[0, 0, 0, 0, 1, 0, 0, 0, 1, 1, 2, 2, 2, 1, 1, 2, 1, 0, 1, 0, 0, 0, 1, 1, 0, 2, 1]"
280,18,67,59,6800,0,57,10,"[1, 3, 2, 1, 0, 2, 3, 2, 1, 1, 0, 1, 1, 0, 1, 2, 0, 0, 1, 1, 0, 1, 0, 0, 3, 2, 1]"
281,18,88,69,6819,0,63,25,"[2, 6, 7, 2, 4, 2, 3, 8, 7, 8, 5, 0, 3, 4, 6, 1, 5, 0, 1, 0, 6, 6, 1, 1, 3, 1, 4]"
282,18,37,36,6820,0,37,0,"[0, 0, 0, 0, 0, 0, 0, 0, 0, 0, 0, 0, 0, 0, 0, 0, 0, 0, 0, 0, 0, 0, 0, 0, 0, 0, 0]"
283,18,67,26,6861,0,66,1,"[0, 0, 0, 0, 0, 0, 0, 0, 0, 0, 0, 0, 0, 0, 0, 0, 0, 0, 0, 0, 0, 0, 0, 0, 0, 0, 0]"
284,18,74,60,6875,0,10,64,"[14, 19, 17, 11, 21, 12, 0, 7, 15, 5, 17, 20, 9, 7, 0, 7, 20, 0, 5, 12, 2, 17, 8, 3, 8, 5, 7]"
285,18,98,72,6901,0,19,79,"[23, 25, 13, 17, 14, 13, 14, 15, 21, 18, 11, 23, 20, 22, 21, 14, 19, 0, 1, 4, 5, 16, 21, 20, 22, 2, 25]"
286,18,8,6,6903,0,8,0,"[0, 0, 0, 0, 0, 0, 0, 0, 0, 0, 0, 0, 0, 0, 0, 0, 0, 0, 0, 0, 0, 0, 0, 0, 0, 0, 0]"
287,18,15,4,6914,0,8,7,"[1, 2, 1, 1, 2, 2, 2, 2, 1, 1, 0, 2, 0, 1, 2, 1, 2, 0, 1, 1, 1, 0, 1, 2, 2, 2, 2]"
288,18,80,62,6932,0,8,72,"[10, 0, 9, 3, 18, 1, 16, 24, 16, 2, 2, 11, 8, 22, 16, 7, 6, 0, 18, 17, 9, 5, 11, 11, 14, 5, 16]"
289,18,48,41,6939,0,44,4,"[0, 0, 0, 0, 0, 0, 1, 0, 1, 0, 1, 1, 1, 0, 1, 1, 0, 0, 1, 1, 1, 1, 0, 0, 1, 1, 0]"
290,18,17,8,6948,0,8,9,"[0, 2, 3, 0, 1, 3, 1, 1, 0, 3, 0, 3, 1, 1, 0, 2, 3, 0, 3, 2, 3, 0, 2, 2, 2, 0, 2]"
291,18,9,8,6949,0,0,9,"[1, 3, 2, 0, 3, 0, 2, 1, 1, 2, 0, 3, 1, 0, 0, 0, 3, 0, 0, 0, 2, 2, 0, 3, 1, 0, 0]"
292,18,67,29,6987,0,37,30,"[9, 2, 5, 6, 7, 9, 6, 6, 6, 5, 10, 10, 1, 7, 10, 9, 5, 0, 5, 3, 4, 0, 5, 8, 1, 9, 6]"
293,18,93,33,7047,0,35,58,"[0, 15, 8, 18, 0, 17, 18, 6, 11, 19, 0, 17, 1, 16, 13, 17, 17, 0, 13, 6, 18, 16, 19, 3, 5, 12, 9]"
294,18,48,2,7093,0,21,27,"[0, 9, 1, 9, 0, 7, 4, 4, 0, 4, 8, 1, 9, 1, 9, 3, 2, 0, 1, 2, 2, 4, 5, 0, 1, 5, 4]"
295,18,9,6,7096,0,5,4,"[1, 0, 0, 0, 1, 1, 0, 1, 0, 1, 0, 0, 1, 0, 0, 0, 0, 0, 0, 0, 1, 1, 1, 0, 1, 0, 1]"
296,18,22,6,7112,0,22,0,"[0, 0, 0, 0, 0, 0, 0, 0, 0, 0, 0, 0, 0, 0, 0, 0, 0, 0, 0, 0, 0, 0, 0, 0, 0, 0, 0]"
297,18,78,65,7125,0,54,24,"[4, 3, 6, 8, 1, 8, 4, 4, 1, 2, 7, 8, 2, 6, 4, 3, 6, 0, 1, 5, 8, 8, 8, 1, 2, 4, 1]"
298,18,5,5,7125,0,4,1,"[0, 0, 0, 0, 0, 0, 0, 0, 0, 0, 0, 0, 0, 0, 0, 0, 0, 0, 0, 0, 0, 0, 0, 0, 0, 0, 0]"
299,18,51,18,7158,0,4,47,"[9, 11, 1, 0, 10, 10, 11, 12, 0, 9, 13, 2, 15, 7, 5, 3, 9, 0, 11, 11, 9, 2, 0, 12, 15, 10, 1]"
0,19,4109,0,4109,0,3014,1095,"[180, 125, 127, 88, 313, 155, 293, 192, 107, 183, 18, 18, 40, 46, 72, 101, 266, 0, 264, 201, 240, 30, 163, 273, 2, 91, 134]"
1,19,4491,1457,7143,0,3378,1113,"[232, 34, 153, 154, 48, 108, 111, 248, 257, 89, 62, 238, 322, 29, 130, 116, 23, 0, 156, 84, 259, 217, 14, 165, 254, 274, 27]"
2,19,3784,1727,9200,0,2321,1463,"[138, 259, 469, 316, 125, 373, 113, 251, 320, 23, 214, 356, 305, 321, 166, 290, 487, 0, 438, 383, 325, 135, 187, 398, 128, 97, 52]"
3,19,4016,5227,7989,0,1388,2628,"[467, 840, 474, 453, 540, 258, 90, 129, 675, 462, 207, 240, 713, 445, 537, 496, 329, 0, 360, 481, 286, 203, 753, 755, 175, 519, 414]"
4,19,3740,6125,5604,0,3221,519,"[51, 34, 20, 163, 102, 56, 86, 64, 102, 96, 169, 153, 44, 153, 26, 118, 167, 0, 51, 25, 102, 29, 73, 39, 87, 120, 5]"
5,19,4207,3612,6199,0,137,4070,"[1337, 704, 384, 246, 559, 101, 78, 643, 657, 1234, 959, 395, 840, 1163, 913, 86, 1126, 0, 668, 651, 1001, 629, 880, 304, 179, 428, 310]"
6,19,3846,2261,7784,0,2557,1289,"[347, 233, 164, 347, 304, 182, 80, 354, 252, 383, 380, 258, 413, 420, 20, 167, 63, 0, 178, 71, 354, 314, 252, 160, 331, 361, 211]"
7,19,4480,5561,6703,0,3490,990,"[120, 295, 239, 157, 308, 173, 8, 184, 235, 208, 26, 318, 272, 243, 291, 316, 121, 0, 21, 301, 227, 195, 50, 141, 298, 53, 192]"
8,19,3488,2814,7377,0,598,2890,"[103, 502, 943, 939, 946, 314, 9, 887, 768, 287, 611, 344, 409, 27, 295, 463, 89, 0, 55, 784, 886, 826, 776, 396, 597, 137, 457]"
9,19,4797,5822,6352,0,4612,185,"[54, 17, 17, 43, 11, 14, 2, 29, 33, 3, 27, 32, 59, 22, 46, 3, 25, 0, 50, 1, 10, 28, 19, 11, 60, 41, 26]"
10,19,3879,261,9970,0,1873,2006,"[321, 285, 449, 219, 360, 165, 336, 361, 53, 163, 388, 658, 590, 389, 335, 631, 570, 0, 126, 552, 561, 614, 668, 496, 611, 323, 205]"
11,19,3751,5471,8250,0,256,3495,"[544, 632, 512, 333, 870, 390, 727, 1, 1009, 1030, 1157, 501, 387, 823, 903, 934, 471, 0, 567, 1128, 164, 553, 320, 1137, 1010, 1044, 489]"
12,19,3451,5843,5858,0,123,3328,"[224, 124, 916, 307, 311, 113, 375, 188, 69, 393, 86, 863, 602, 632, 259, 695, 184, 0, 672, 825, 440, 529, 78, 962, 412, 760, 34]"
13,19,4971,1821,9008,0,179,4792,"[1198, 143, 1569, 183, 1422, 974, 1594, 1405, 616, 994, 865, 158, 555, 820, 8, 847, 210, 0, 1059, 600, 1526, 273, 1397, 1019, 525, 994, 444]"
14,19,3733,6763,5978,0,849,2884,"[804, 151, 797, 505, 105, 336, 131, 523, 880, 558, 871, 779, 928, 303, 603, 384, 776, 0, 240, 520, 456, 505, 89, 562, 368, 401, 56]"
15,19,3462,2221,7219,0,1115,2347,"[3, 5, 62, 585, 310, 400, 244, 230, 568, 297, 696, 529, 112, 165, 505, 632, 400, 0, 18, 582, 741, 527, 306, 678, 320, 228, 252]"
16,19,3705,2695,8229,0,1954,1751,"[138, 481, 220, 126, 545, 482, 554, 11, 284, 213, 99, 273, 260, 535, 260, 582, 397, 0, 49, 36, 558, 364, 403, 509, 452, 272, 536]"
17,19,3177,5477,5929,0,1929,1248,"[183, 261, 235, 80, 307, 59, 186, 138, 302, 216, 293, 233, 300, 398, 50, 208, 363, 0, 321, 166, 72, 88, 18, 131, 204, 126, 369]"
18,19,3741,2083,7587,0,1246,2495,"[684, 284, 791, 513, 553, 718, 634, 146, 126, 27, 773, 195, 657, 22, 461, 495, 112, 0, 396, 584, 540, 222, 122, 814, 127, 159, 766]"
19,19,4976,7440,5123,0,2030,2946,"[68, 393, 765, 552, 935, 526, 888, 635, 527, 928, 562, 207, 123, 548, 841, 503, 759, 0, 551, 110, 261, 493, 11, 515, 864, 110, 554]"
20,19,3078,1701,6500,0,413,2665,"[552, 199, 867, 312, 669, 787, 33, 121, 126, 698, 458, 103, 275, 142, 686, 573, 99, 0, 664, 37, 447, 311, 125, 61, 108, 464, 629]"
21,19,4523,6405,4618,0,1095,3428,"[158, 859, 512, 1066, 475, 689, 116, 505, 480, 523, 993, 634, 12, 237, 1118, 896, 1131, 0, 255, 557, 522, 892, 324, 707, 501, 51, 793]"
22,19,4090,1031,7677,0,187,3903,"[1043, 980, 637, 238, 32, 533, 732, 314, 883, 1097, 243, 196, 872, 832, 727, 507, 77, 0, 1180, 1175, 666, 229, 1246, 1040, 373, 803, 904]"
23,19,3211,1178,9710,0,2683,528,"[52, 110, 53, 99, 33, 91, 149, 64, 157, 114, 91, 138, 41, 0, 123, 123, 137, 0, 53, 36, 86, 68, 168, 159, 77, 77, 69]"
24,19,4098,7381,6427,0,3483,615,"[4, 161, 198, 30, 59, 182, 70, 127, 200, 191, 136, 0, 75, 123, 113, 139, 146, 0, 68, 77, 186, 47, 130, 41, 127, 185, 163]"
25,19,4101,3394,7134,0,2796,1305,"[73, 211, 133, 109, 357, 33, 74, 346, 87, 288, 270, 45, 203, 28, 68, 184, 135, 0, 179, 1, 227, 7, 405, 275, 243, 61, 64]"
26,19,4874,7451,4557,0,1743,3131,"[187, 2, 323, 439, 605, 174, 957, 237, 269, 863, 741, 715, 922, 405, 604, 207, 973, 0, 485, 612, 625, 215, 17, 886, 155, 620, 429]"
27,19,3054,1425,6186,0,330,2724,"[107, 425, 301, 126, 6, 417, 874, 857, 840, 586, 778, 888, 548, 425, 545, 51, 801, 0, 564, 341, 758, 372, 347, 705, 644, 775, 849]"
28,19,3518,3358,6346,0,488,3030,"[543, 792, 567, 386, 712, 259, 46, 1009, 318, 909, 266, 282, 156, 411, 122, 125, 659, 0, 861, 123, 691, 603, 142, 115, 670, 756, 814]"
29,19,3851,1827,8370,0,3007,844,"[74, 278, 45, 103, 87, 94, 105, 19, 261, 70, 115, 174, 131, 183, 257, 100, 179, 0, 158, 120, 148, 226, 36, 26, 265, 277, 204]"
30,19,4117,6405,6082,0,3232,885,"[270, 196, 219, 294, 105, 154, 222, 155, 142, 97, 274, 294, 233, 59, 20, 16, 258, 0, 19, 152, 161, 26, 112, 165, 49, 201, 285]"
31,19,4539,1555,9066,0,2011,2528,"[291, 496, 118, 742, 572, 635, 39, 420, 164, 721, 453, 495, 608, 73, 185, 170, 654, 0, 418, 28, 554, 180, 162, 338, 657, 78, 706]"
32,19,4006,5154,7918,0,2035,1971,"[471, 224, 299, 564, 306, 103, 432, 580, 106, 296, 467, 298, 46, 567, 396, 320, 345, 0, 523, 486, 485, 221, 337, 413, 515, 108, 593]"
33,19,3397,7368,3947,0,2269,1128,"[236, 106, 33, 102, 155, 267, 246, 273, 30, 315, 107, 34, 139, 23, 181, 348, 299, 0, 317, 344, 349, 271, 314, 329, 220, 250, 347]"
34,19,4094,44,7997,0,3687,407,"[32, 109, 56, 67, 112, 73, 100, 122, 69, 125, 66, 34, 7, 131, 126, 64, 50, 0, 121, 94, 21, 54, 73, 6, 34, 84, 81]"
35,19,3833,6971,4859,0,2739,1094,"[342, 148, 253, 22, 180, 180, 226, 172, 242, 77, 232, 246, 314, 223, 43, 248, 317, 0, 23, 358, 74, 84, 170, 100, 121, 261, 121]"
36,19,4672,3868,5663,0,1837,2835,"[536, 158, 835, 908, 618, 827, 690, 503, 920, 663, 506, 306, 230, 164, 214, 201, 577, 0, 806, 293, 421, 578, 261, 185, 188, 127, 596]"
37,19,3901,2060,7504,0,2017,1884,"[455, 291, 529, 5, 54, 410, 104, 161, 76, 128, 453, 312, 484, 133, 94, 155, 260, 0, 289, 565, 19, 452, 151, 505, 100, 127, 13]"
38,19,3985,5039,6450,0,1003,2982,"[439, 378, 506, 852, 256, 41, 653, 355, 197, 596, 343, 425, 99, 840, 336, 902, 788, 0, 96, 692, 338, 3, 871, 842, 627, 504, 650]"
39,19,3099,2708,6841,0,1833,1266,"[28, 352, 396, 298, 361, 404, 74, 321, 350, 271, 366, 224, 246, 364, 50, 134, 100, 0, 214, 277, 80, 196, 153, 199, 25, 218, 63]"
40,19,3735,3534,7042,0,3073,662,"[88, 96, 56, 77, 163, 212, 216, 84, 201, 144, 68, 210, 78, 132, 176, 90, 219, 0, 22, 37, 79, 133, 212, 178, 183, 74, 56]"
41,19,4654,5387,6309,0,1996,2658,"[594, 474, 610, 865, 881, 624, 802, 158, 405, 91, 418, 97, 796, 135, 879, 517, 372, 0, 259, 801, 538, 723, 560, 530, 322, 70, 106]"
42,19,4642,1928,9023,0,2000,2642,"[18, 878, 231, 792, 608, 364, 327, 66, 3, 711, 259, 608, 229, 480, 429, 21, 765, 0, 564, 276, 523, 6, 494, 454, 360, 286, 189]"
43,19,4985,5920,8088,0,2491,2494,"[275, 358, 470, 629, 223, 791, 181, 8, 163, 752, 126, 433, 98, 745, 435, 645, 668, 0, 422, 631, 542, 108, 522, 593, 792, 780, 471]"
44,19,4017,7272,4833,0,3851,166,"[36, 20, 2, 29, 40, 15, 50, 33, 17, 47, 55, 13, 55, 35, 7, 25, 2, 0, 51, 55, 3, 39, 47, 32, 30, 38, 12]"
45,19,4253,1985,7101,0,2682,1571,"[357, 443, 461, 78, 2, 428, 436, 523, 518, 347, 44, 189, 294, 443, 344, 57, 429, 0, 266, 290, 109, 361, 464, 253, 191, 319, 41]"
46,19,4368,6830,4639,0,1484,2884,"[277, 719, 33, 705, 76, 895, 168, 855, 936, 131, 195, 938, 893, 374, 67, 391, 537, 0, 490, 61, 878, 133, 734, 845, 559, 491, 277]"
47,19,4647,1728,7558,0,287,4360,"[811, 1283, 1270, 1354, 675, 1306, 1194, 1393, 1218, 1087, 1001, 53, 801, 335, 1262, 1059, 1117, 0, 668, 102, 664, 519, 1316, 353, 1386, 1077, 469]"
48,19,3769,6368,4959,0,1828,1941,"[8, 252, 12, 508, 559, 306, 465, 20, 71, 534, 210, 85, 358, 334, 521, 53, 150, 0, 51, 292, 279, 646, 188, 6, 632, 393, 81]"
49,19,4646,3656,5949,0,1294,3352,"[604, 601, 181, 1027, 141, 330, 284, 898, 28, 302, 893, 834, 808, 642, 621, 893, 617, 0, 1092, 622, 709, 884, 914, 498, 949, 680, 845]"
50,19,4265,1634,8580,0,187,4078,"[1073, 836, 1059, 265, 392, 73, 174, 785, 983, 44, 410, 239, 1134, 470, 393, 370, 765, 0, 529, 489, 622, 201, 802, 987, 235, 105, 1220]"
51,19,3944,5634,6890,0,3150,794,"[241, 12, 248, 13, 0, 92, 62, 91, 2, 144, 221, 186, 85, 158, 199, 40, 66, 0, 36, 187, 170, 77, 246, 258, 8, 209, 63]"
52,19,3326,1299,8917,0,1464,1862,"[266, 58, 161, 545, 318, 134, 134, 184, 65, 168, 494, 27, 445, 443, 235, 55, 4, 0, 335, 253, 578, 8, 359, 518, 289, 545, 91]"
53,19,4749,5777,7889,0,2980,1769,"[327, 181, 567, 287, 245, 307, 438, 100, 451, 322, 261, 111, 23, 150, 81, 240, 409, 0, 410, 169, 118, 67, 84, 303, 152, 201, 408]"
54,19,4734,7258,5365,0,2502,2232,"[699, 491, 346, 652, 585, 623, 176, 500, 158, 637, 251, 422, 558, 281, 113, 356, 489, 0, 510, 86, 28, 411, 672, 436, 236, 613, 317]"
55,19,3713,1048,8030,0,732,2981,"[831, 509, 264, 7, 515, 181, 690, 638, 528, 880, 583, 151, 141, 444, 295, 14, 504, 0, 989, 322, 481, 63, 188, 583, 350, 753, 645]"
56,19,4910,6810,6130,0,1296,3614,"[30, 329, 1148, 321, 1160, 460, 528, 331, 29, 526, 129, 923, 329, 478, 1122, 880, 510, 0, 1059, 824, 668, 1026, 116, 1168, 836, 916, 1091]"
57,19,4556,3373,7313,0,618,3938,"[177, 346, 389, 622, 789, 629, 23, 1125, 831, 1049, 766, 47, 865, 999, 109, 1034, 168, 0, 600, 1061, 577, 1299, 857, 205, 182, 875, 789]"
58,19,4948,6323,5938,0,270,4678,"[1052, 554, 744, 287, 1466, 205, 1319, 1499, 1510, 877, 1269, 133, 396, 642, 826, 1068, 624, 0, 503, 494, 961, 394, 89, 1436, 682, 187, 897]"
59,19,3694,1763,7869,0,3187,507,"[37, 36, 96, 34, 49, 80, 113, 46, 8, 129, 60, 123, 159, 110, 16, 146, 99, 0, 107, 65, 135, 104, 30, 68, 7, 68, 8]"
60,19,3011,2977,7903,0,1479,1532,"[290, 406, 336, 164, 43, 185, 229, 300, 160, 493, 438, 361, 458, 487, 479, 298, 434, 0, 362, 317, 132, 102, 64, 243, 421, 31, 88]"
61,19,4326,5420,6809,0,4246,80,"[2, 17, 20, 12, 15, 26, 16, 9, 5, 19, 22, 15, 23, 15, 15, 22, 21, 0, 5, 12, 20, 9, 1, 20, 26, 0, 16]"
62,19,3546,2700,7655,0,2669,877,"[140, 78, 123, 106, 265, 238, 91, 107, 69, 269, 229, 73, 284, 37, 259, 49, 231, 0, 89, 129, 188, 85, 229, 79, 244, 36, 42]"
63,19,3631,6455,4831,0,3494,137,"[42, 23, 37, 15, 30, 29, 18, 26, 24, 12, 29, 34, 0, 39, 8, 43, 8, 0, 25, 30, 11, 27, 30, 23, 38, 34, 20]"
64,19,4001,3430,5402,0,440,3561,"[312, 67, 1144, 1187, 905, 691, 657, 287, 995, 370, 10, 959, 1050, 512, 506, 1085, 472, 0, 697, 98, 696, 1128, 1155, 168, 128, 699, 1023]"
65,19,3260,2200,6462,0,2507,753,"[27, 174, 127, 29, 195, 222, 26, 137, 47, 97, 250, 85, 218, 84, 215, 111, 244, 0, 12, 191, 23, 102, 38, 114, 92, 79, 141]"
66,19,3302,2490,7274,0,414,2888,"[956, 866, 537, 387, 83, 160, 719, 523, 577, 142, 393, 495, 115, 458, 34, 914, 229, 0, 361, 253, 337, 364, 835, 948, 486, 945, 372]"
67,19,4361,6635,5000,0,1688,2673,"[529, 857, 186, 175, 210, 327, 62, 310, 659, 740, 706, 588, 5, 445, 353, 413, 639, 0, 77, 534, 75, 448, 510, 511, 747, 36, 509]"
68,19,3964,3190,5774,0,3874,90,"[0, 17, 12, 13, 8, 21, 30, 3, 16, 0, 5, 6, 24, 28, 9, 5, 23, 0, 13, 30, 23, 29, 17, 15, 23, 8, 19]"
69,19,3888,3496,6166,0,1786,2102,"[369, 284, 674, 342, 487, 481, 590, 300, 631, 339, 411, 251, 204, 393, 76, 656, 307, 0, 37, 30, 232, 468, 20, 143, 416, 398, 627]"
70,19,4829,3405,7590,0,387,4442,"[1029, 1434, 788, 329, 275, 1374, 1262, 677, 890, 256, 1355, 1273, 913, 893, 482, 318, 1060, 0, 45, 1472, 1215, 1385, 898, 109, 971, 322, 897]"
71,19,3397,1084,9903,0,2787,610,"[11, 184, 105, 78, 69, 65, 196, 143, 139, 57, 106, 122, 107, 122, 44, 127, 196, 0, 26, 28, 58, 160, 130, 120, 172, 144, 186]"
72,19,4054,6163,7794,0,2817,1237,"[178, 323, 205, 411, 409, 315, 148, 299, 122, 262, 49, 156, 344, 148, 339, 330, 284, 0, 127, 49, 100, 172, 79, 314, 160, 122, 242]"
73,19,4251,6151,5894,0,3148,1103,"[122, 289, 354, 180, 151, 76, 97, 198, 171, 3, 152, 358, 143, 149, 312, 179, 169, 0, 70, 72, 326, 259, 151, 305, 81, 333, 314]"
74,19,4186,3686,6394,0,3541,645,"[121, 60, 79, 176, 147, 74, 163, 13, 168, 179, 7, 124, 85, 34, 194, 77, 167, 0, 70, 6, 19, 3, 97, 14, 32, 103, 133]"
75,19,3979,2221,8152,0,1099,2880,"[636, 428, 336, 475, 948, 190, 829, 477, 936, 265, 800, 199, 895, 345, 446, 350, 161, 0, 502, 728, 727, 346, 124, 542, 308, 955, 829]"
76,19,4290,5349,7093,0,880,3410,"[754, 388, 699, 805, 872, 549, 287, 982, 788, 666, 237, 296, 113, 640, 369, 581, 120, 0, 1023, 567, 918, 600, 768, 739, 632, 1077, 112]"
77,19,4794,6906,4981,0,4205,589,"[77, 79, 55, 133, 144, 8, 11, 40, 98, 41, 101, 30, 171, 22, 37, 76, 142, 0, 165, 120, 75, 81, 95, 120, 46, 79, 135]"
78,19,4470,4344,5107,0,12,4458,"[107, 1032, 1185, 414, 503, 1470, 79, 563, 216, 1483, 379, 1475, 774, 325, 1056, 254, 118, 0, 2, 1227, 464, 1350, 1381, 790, 448, 462, 126]"
79,19,3171,2760,5518,0,2880,291,"[75, 49, 45, 63, 25, 34, 76, 70, 51, 59, 42, 79, 1, 62, 59, 83, 38, 0, 12, 57, 24, 37, 42, 76, 33, 13, 38]"
80,19,4496,3613,6401,0,3702,794,"[132, 35, 33, 150, 108, 251, 230, 200, 47, 48, 154, 36, 228, 165, 55, 178, 94, 0, 227, 11, 119, 94, 146, 239, 215, 122, 148]"
81,19,4923,6719,4605,0,1574,3349,"[782, 80, 101, 118, 256, 337, 217, 967, 896, 459, 778, 701, 35, 383, 228, 107, 1029, 0, 1018, 816, 457, 913, 69, 324, 995, 903, 648]"
82,19,3223,2821,5007,0,1210,2013,"[388, 555, 475, 61, 474, 139, 242, 441, 579, 600, 342, 419, 653, 643, 503, 246, 221, 0, 265, 88, 249, 633, 38, 450, 451, 297, 137]"
83,19,3077,555,7529,0,660,2417,"[288, 728, 490, 295, 254, 729, 521, 102, 463, 154, 50, 253, 408, 641, 588, 405, 178, 0, 141, 280, 517, 374, 297, 211, 370, 626, 207]"
84,19,4435,6855,5109,0,1960,2475,"[700, 541, 695, 825, 745, 773, 158, 601, 703, 38, 434, 585, 454, 220, 83, 581, 465, 0, 757, 66, 244, 114, 549, 219, 740, 431, 23]"
85,19,3554,2145,6518,0,753,2801,"[183, 611, 813, 490, 656, 366, 432, 663, 845, 60, 644, 891, 350, 338, 238, 404, 11, 0, 878, 450, 539, 911, 126, 30, 418, 894, 84]"
86,19,4502,6348,4672,0,118,4384,"[175, 16, 468, 394, 77, 705, 633, 378, 1361, 244, 535, 884, 440, 1406, 200, 623, 1054, 0, 1192, 2, 749, 1433, 730, 72, 1316, 119, 370]"
87,19,3239,637,7274,0,1932,1307,"[278, 195, 294, 107, 85, 73, 203, 123, 186, 215, 428, 168, 54, 332, 246, 393, 247, 0, 24, 13, 129, 224, 356, 332, 98, 88, 20]"
88,19,4020,6912,4382,0,983,3037,"[527, 247, 839, 489, 154, 291, 215, 156, 270, 582, 717, 714, 783, 72, 722, 76, 55, 0, 502, 613, 489, 446, 429, 906, 421, 276, 801]"
89,19,3882,3428,4836,0,960,2922,"[935, 340, 617, 923, 212, 103, 599, 551, 130, 461, 591, 694, 558, 629, 808, 4, 255, 0, 271, 705, 765, 292, 793, 543, 32, 585, 860]"
90,19,3036,388,7484,0,500,2536,"[208, 146, 639, 331, 526, 291, 706, 187, 361, 295, 572, 286, 9, 651, 456, 443, 785, 0, 770, 466, 774, 151, 626, 448, 641, 24, 143]"
91,19,3800,5918,5366,0,2902,898,"[114, 282, 229, 202, 37, 48, 92, 33, 185, 70, 193, 90, 2, 230, 24, 86, 64, 0, 74, 5, 153, 124, 34, 16, 97, 243, 180]"
92,19,4237,1351,8252,0,3027,1210,"[208, 205, 341, 219, 54, 347, 240, 200, 271, 63, 8, 341, 39, 92, 220, 108, 389, 0, 369, 81, 343, 163, 214, 195, 139, 41, 188]"
93,19,4156,5596,6812,0,3428,728,"[88, 162, 191, 185, 55, 52, 146, 225, 185, 211, 185, 44, 110, 84, 3, 61, 89, 0, 145, 48, 163, 93, 120, 111, 185, 58, 4]"
94,19,3654,1888,8578,0,2359,1295,"[343, 42, 24, 17, 156, 340, 285, 102, 152, 378, 382, 109, 114, 282, 101, 36, 90, 0, 234, 339, 375, 45, 349, 209, 290, 334, 413]"
95,19,4122,6514,6186,0,2671,1451,"[79, 273, 459, 46, 389, 207, 383, 381, 48, 328, 53, 306, 266, 78, 130, 196, 19, 0, 78, 114, 345, 331, 138, 183, 419, 191, 411]"
96,19,4355,555,9986,0,1783,2572,"[58, 96, 7, 760, 613, 785, 344, 462, 821, 363, 626, 518, 37, 205, 343, 435, 336, 0, 725, 313, 226, 558, 5, 515, 210, 30, 457]"
97,19,3513,6451,7048,0,1067,2446,"[86, 366, 101, 657, 780, 566, 721, 575, 591, 707, 257, 660, 326, 680, 568, 700, 455, 0, 772, 287, 351, 733, 637, 686, 562, 724, 6]"
98,19,3657,2969,7736,0,2687,970,"[1, 74, 12, 322, 40, 243, 59, 286, 280, 124, 286, 58, 7, 77, 21, 105, 241, 0, 149, 18, 102, 314, 11, 110, 146, 61, 64]"
99,19,4178,5021,6893,0,3154,1024,"[29, 213, 249, 66, 303, 318, 100, 141, 47, 239, 237, 286, 288, 266, 235, 262, 301, 0, 290, 312, 134, 52, 328, 155, 252, 305, 81]"
100,19,3879,1948,8824,0,3287,592,"[41, 171, 17, 186, 114, 106, 60, 58, 197, 50, 174, 133, 112, 18, 84, 3, 134, 0, 70, 118, 69, 2, 182, 193, 178, 70, 129]"
101,19,4803,7060,6567,0,3758,1045,"[329, 214, 71, 175, 184, 60, 107, 15, 273, 160, 58, 190, 280, 329, 97, 259, 28, 0, 64, 141, 17, 345, 262, 122, 318, 129, 89]"
102,19,4766,6921,4412,0,371,4395,"[767, 135, 1247, 701, 1039, 13, 1230, 1210, 707, 1257, 484, 1330, 791, 91, 1328, 993, 201, 0, 1336, 220, 712, 890, 908, 162, 104, 891, 1411]"
103,19,3279,125,7566,0,2570,709,"[186, 33, 157, 126, 14, 166, 143, 18, 173, 152, 123, 117, 151, 56, 56, 181, 175, 0, 57, 35, 85, 45, 163, 32, 232, 92, 92]"
104,19,4279,7469,4376,0,2904,1375,"[291, 91, 230, 293, 131, 85, 185, 203, 43, 372, 61, 389, 72, 443, 340, 402, 130, 0, 320, 252, 110, 424, 137, 31, 52, 315, 179]"
105,19,3050,1154,6272,0,720,2330,"[445, 64, 81, 318, 192, 466, 678, 389, 492, 298, 233, 755, 409, 563, 66, 424, 730, 0, 478, 718, 528, 388, 512, 129, 449, 606, 108]"
106,19,3165,2931,6506,0,63,3102,"[495, 596, 137, 289, 762, 282, 966, 718, 508, 1000, 869, 795, 126, 551, 916, 645, 307, 0, 920, 695, 1011, 944, 900, 952, 594, 127, 304]"
107,19,4164,1146,9524,0,3442,722,"[186, 174, 169, 162, 180, 53, 97, 194, 62, 24, 212, 27, 153, 31, 44, 239, 111, 0, 72, 15, 176, 225, 125, 184, 125, 146, 104]"
108,19,3144,5884,6784,0,2337,807,"[26, 122, 58, 160, 56, 193, 173, 57, 116, 14, 73, 257, 147, 116, 48, 210, 258, 0, 212, 169, 204, 85, 103, 56, 32, 149, 181]"
109,19,3146,1722,8208,0,1350,1796,"[252, 147, 401, 66, 357, 544, 591, 139, 358, 462, 235, 95, 220, 547, 370, 576, 345, 0, 485, 107, 275, 270, 287, 138, 489, 406, 576]"
110,19,3363,6775,4796,0,784,2579,"[324, 403, 351, 69, 678, 819, 610, 588, 420, 610, 496, 665, 131, 752, 349, 234, 343, 0, 709, 103, 156, 495, 181, 490, 21, 390, 329]"
111,19,4801,1028,8569,0,4124,677,"[89, 139, 147, 194, 13, 24, 59, 63, 0, 220, 160, 113, 189, 171, 90, 115, 155, 0, 63, 58, 62, 44, 187, 118, 140, 9, 141]"
112,19,4122,6740,5951,0,3381,741,"[136, 39, 98, 57, 231, 59, 11, 86, 59, 247, 135, 10, 142, 170, 14, 214, 61, 0, 221, 2, 195, 90, 183, 62, 126, 40, 150]"
113,19,3433,2885,6499,0,3090,343,"[69, 93, 8, 25, 68, 85, 97, 14, 51, 73, 90, 14, 112, 16, 62, 86, 61, 0, 38, 63, 108, 66, 53, 86, 10, 32, 56]"
114,19,4551,5167,5883,0,3765,786,"[235, 51, 32, 43, 118, 98, 18, 217, 238, 44, 66, 109, 152, 188, 231, 249, 141, 0, 118, 147, 215, 174, 96, 2, 239, 198, 229]"
115,19,3140,2345,6678,0,1973,1167,"[364, 66, 248, 344, 133, 378, 299, 23, 304, 351, 377, 257, 253, 269, 290, 52, 124, 0, 377, 291, 288, 128, 328, 99, 34, 266, 13]"
116,19,4824,7044,4458,0,2921,1903,"[216, 178, 380, 573, 30, 574, 335, 556, 158, 571, 83, 42, 510, 306, 173, 27, 304, 0, 220, 113, 45, 108, 419, 40, 396, 16, 460]"
117,19,4537,3966,5029,0,2894,1643,"[433, 338, 268, 210, 196, 85, 507, 372, 365, 143, 244, 272, 240, 243, 205, 214, 24, 0, 40, 139, 141, 105, 346, 482, 240, 191, 391]"
118,19,3963,213,8779,0,3166,797,"[158, 65, 45, 120, 13, 174, 222, 99, 129, 48, 171, 202, 97, 195, 184, 127, 0, 0, 255, 99, 174, 140, 233, 29, 238, 253, 172]"
119,19,4128,6757,6150,0,26,4102,"[538, 715, 1139, 357, 381, 1068, 88, 1237, 297, 1067, 87, 1185, 648, 422, 886, 269, 1241, 0, 728, 402, 1331, 895, 1163, 1256, 26, 1007, 268]"
120,19,4845,848,10000,147,2771,2074,"[414, 131, 482, 281, 42, 655, 412, 485, 97, 188, 453, 576, 385, 571, 118, 373, 343, 0, 365, 556, 553, 509, 75, 658, 329, 432, 566]"
121,19,3970,7260,6710,0,3333,637,"[128, 95, 186, 82, 109, 55, 107, 95, 126, 30, 207, 178, 137, 203, 101, 141, 70, 0, 145, 111, 30, 5, 75, 166, 17, 128, 173]"
122,19,4496,5021,6185,0,1806,2690,"[594, 839, 669, 381, 332, 652, 150, 4, 496, 801, 512, 194, 292, 410, 744, 183, 247, 0, 347, 419, 89, 335, 61, 148, 640, 265, 81]"
123,19,3125,1492,7818,0,370,2755,"[458, 138, 299, 197, 292, 189, 273, 260, 586, 635, 837, 669, 685, 328, 424, 265, 442, 0, 836, 364, 273, 129, 510, 136, 273, 580, 432]"
124,19,3105,2541,8382,0,2855,250,"[46, 73, 41, 77, 68, 11, 59, 63, 46, 34, 39, 70, 15, 16, 10, 9, 42, 0, 75, 81, 23, 13, 52, 70, 9, 11, 8]"
125,19,3296,5851,5827,0,539,2757,"[610, 805, 625, 898, 723, 741, 659, 506, 202, 394, 772, 548, 84, 280, 474, 141, 578, 0, 625, 153, 345, 240, 535, 100, 884, 199, 721]"
126,19,4102,2181,7748,0,2421,1681,"[269, 411, 398, 368, 186, 255, 524, 179, 99, 59, 89, 45, 279, 315, 184, 480, 493, 0, 215, 46, 306, 551, 172, 195, 552, 103, 386]"
127,19,4994,6393,6349,0,326,4668,"[357, 468, 164, 663, 483, 1107, 1045, 261, 633, 632, 1257, 497, 18, 313, 692, 933, 911, 0, 114, 296, 594, 189, 412, 15, 187, 1105, 1149]"
128,19,4818,6100,5067,0,2067,2751,"[546, 634, 23, 641, 824, 636, 735, 362, 527, 354, 695, 326, 444, 190, 109, 874, 873, 0, 427, 466, 744, 447, 34, 749, 472, 344, 850]"
129,19,3098,2001,6164,0,2984,114,"[20, 7, 33, 12, 22, 35, 28, 6, 18, 17, 15, 30, 16, 28, 37, 3, 14, 0, 30, 16, 24, 30, 28, 10, 3, 15, 29]"
130,19,4735,622,10000,277,3977,758,"[130, 92, 100, 246, 3, 40, 153, 55, 47, 40, 163, 2, 223, 100, 240, 231, 118, 0, 35, 11, 124, 33, 215, 50, 192, 239, 72]"
131,19,3380,6223,7157,0,1736,1644,"[406, 118, 54, 312, 516, 321, 265, 309, 103, 62, 325, 427, 127, 166, 104, 492, 391, 0, 252, 156, 371, 412, 181, 294, 314, 400, 132]"
132,19,4967,6670,5454,0,3997,970,"[197, 138, 118, 153, 303, 268, 284, 167, 104, 181, 241, 211, 173, 189, 70, 82, 169, 0, 239, 47, 60, 307, 13, 323, 147, 272, 179]"
133,19,3946,1967,7433,0,103,3843,"[1030, 961, 586, 918, 176, 180, 1162, 705, 1119, 1073, 552, 560, 865, 553, 944, 793, 458, 0, 797, 486, 887, 207, 679, 167, 447, 80, 889]"
134,19,4440,6366,5507,0,3835,605,"[61, 72, 183, 180, 102, 170, 44, 69, 158, 12, 143, 132, 12, 9, 165, 18, 119, 0, 72, 32, 72, 187, 194, 174, 8, 16, 193]"
135,19,4618,2480,7645,0,3838,780,"[55, 1, 2, 79, 12, 194, 213, 85, 150, 161, 180, 111, 40, 252, 149, 117, 183, 0, 27, 47, 184, 215, 220, 231, 154, 0, 22]"
136,19,3380,5697,5328,0,955,2425,"[594, 210, 559, 551, 447, 472, 742, 170, 134, 482, 325, 803, 759, 608, 504, 364, 777, 0, 514, 197, 463, 392, 8, 9, 196, 70, 572]"
137,19,3096,1640,6784,0,852,2244,"[70, 718, 690, 88, 519, 99, 681, 502, 153, 551, 433, 449, 45, 520, 165, 205, 623, 0, 737, 280, 304, 707, 257, 507, 276, 497, 451]"
138,19,3440,3151,7073,0,2774,666,"[25, 30, 19, 0, 67, 11, 88, 104, 11, 173, 115, 110, 45, 112, 155, 144, 187, 0, 50, 154, 155, 81, 166, 212, 56, 97, 206]"
139,19,3246,2714,7605,0,915,2331,"[93, 195, 565, 270, 303, 303, 642, 528, 467, 315, 294, 689, 67, 607, 737, 681, 739, 0, 427, 50, 694, 160, 439, 622, 120, 570, 299]"
140,19,4331,6892,5044,0,2081,2250,"[482, 347, 144, 294, 341, 242, 237, 283, 208, 695, 1, 46, 370, 448, 468, 698, 396, 0, 223, 387, 582, 721, 64, 551, 724, 468, 115]"
141,19,4344,3648,5740,0,441,3903,"[791, 1055, 662, 472, 593, 281, 41, 740, 283, 1235, 841, 760, 451, 898, 348, 1269, 1271, 0, 327, 686, 677, 661, 1076, 1108, 446, 1148, 195]"
142,19,3153,2547,6346,0,348,2805,"[654, 46, 883, 39, 887, 62, 884, 890, 811, 104, 392, 408, 516, 905, 723, 417, 64, 0, 152, 684, 545, 98, 279, 667, 591, 876, 50]"
143,19,3321,3129,6538,0,341,2980,"[937, 208, 374, 958, 761, 618, 246, 316, 139, 552, 143, 442, 784, 236, 75, 433, 599, 0, 396, 776, 348, 202, 232, 261, 290, 153, 383]"
144,19,4198,4064,6672,0,2834,1364,"[442, 321, 133, 7, 230, 246, 365, 175, 73, 112, 168, 36, 318, 339, 311, 223, 311, 0, 411, 324, 314, 67, 235, 415, 134, 172, 383]"
145,19,4139,3621,7190,0,424,3715,"[752, 716, 737, 848, 788, 188, 234, 449, 873, 1218, 246, 6, 128, 270, 882, 189, 556, 0, 407, 392, 718, 604, 487, 447, 547, 826, 103]"
146,19,4388,7300,4278,0,1028,3360,"[377, 852, 219, 803, 449, 246, 877, 971, 887, 362, 23, 31, 573, 134, 229, 884, 956, 0, 580, 1073, 251, 228, 1106, 770, 202, 830, 985]"
147,19,3181,535,6924,0,159,3022,"[890, 253, 422, 683, 534, 37, 369, 88, 220, 155, 879, 914, 682, 196, 951, 625, 473, 0, 181, 383, 303, 309, 934, 353, 417, 877, 303]"
148,19,4458,6142,5240,0,3101,1357,"[13, 2, 279, 30, 336, 77, 427, 439, 191, 314, 398, 446, 51, 224, 203, 103, 277, 0, 231, 149, 201, 278, 142, 368, 214, 430, 32]"
149,19,4686,1032,8894,0,93,4593,"[1097, 286, 1273, 1431, 540, 1098, 1180, 1325, 257, 1208, 1466, 1081, 974, 1428, 1029, 1290, 665, 0, 1019, 312, 852, 110, 675, 730, 704, 1254, 941]"
150,19,4875,6046,7723,0,3686,1189,"[111, 185, 134, 264, 234, 313, 11, 351, 28, 237, 300, 167, 127, 151, 288, 42, 76, 0, 48, 155, 382, 114, 133, 189, 36, 389, 58]"
151,19,3968,5853,5838,0,2351,1617,"[436, 313, 238, 359, 187, 236, 40, 285, 90, 495, 138, 46, 300, 88, 26, 496, 481, 0, 452, 464, 274, 10, 230, 74, 57, 296, 307]"
152,19,4797,3704,6931,0,1148,3649,"[537, 325, 653, 742, 1145, 158, 608, 952, 166, 60, 400, 71, 194, 805, 575, 615, 580, 0, 928, 520, 1179, 534, 788, 836, 1016, 339, 1025]"
153,19,3111,859,9183,0,979,2132,"[46, 81, 83, 261, 214, 544, 92, 312, 186, 69, 704, 60, 192, 232, 696, 488, 292, 0, 556, 651, 499, 343, 242, 487, 645, 97, 336]"
154,19,3728,5554,7357,0,1693,2035,"[208, 175, 6, 330, 440, 206, 458, 71, 146, 146, 676, 479, 196, 228, 360, 297, 29, 0, 593, 29, 372, 79, 504, 229, 517, 360, 388]"
155,19,3045,1151,9251,0,706,2339,"[0, 258, 278, 168, 12, 490, 376, 314, 161, 185, 356, 118, 710, 174, 59, 664, 281, 0, 739, 264, 46, 111, 620, 545, 144, 502, 256]"
156,19,4379,6538,7092,0,1924,2455,"[581, 18, 600, 1, 704, 132, 546, 408, 55, 184, 616, 442, 473, 137, 492, 458, 84, 0, 754, 721, 444, 632, 774, 94, 117, 487, 198]"
157,19,4832,5346,6578,0,2750,2082,"[687, 594, 510, 579, 398, 84, 49, 315, 243, 11, 80, 488, 319, 649, 44, 475, 433, 0, 426, 514, 313, 199, 630, 508, 367, 266, 111]"
158,19,4326,1141,9763,0,2075,2251,"[720, 628, 418, 198, 262, 630, 291, 80, 491, 322, 56, 748, 9, 601, 56, 195, 484, 0, 433, 116, 271, 313, 394, 356, 723, 188, 691]"
159,19,3109,7410,5462,0,2061,1048,"[329, 75, 244, 175, 114, 256, 50, 167, 185, 154, 47, 75, 339, 301, 324, 311, 336, 0, 131, 71, 155, 349, 74, 222, 320, 103, 318]"
160,19,3027,1817,6672,0,1578,1449,"[431, 376, 153, 282, 461, 395, 237, 414, 419, 310, 224, 72, 143, 248, 404, 366, 155, 0, 23, 296, 201, 33, 115, 458, 442, 182, 153]"
161,19,3679,1625,8726,0,2214,1465,"[474, 214, 428, 319, 50, 150, 408, 333, 192, 9, 404, 5, 183, 12, 488, 153, 137, 0, 420, 104, 190, 239, 488, 449, 186, 437, 385]"
162,19,3722,6041,6407,0,531,3191,"[421, 994, 777, 873, 584, 977, 912, 875, 638, 1018, 732, 826, 347, 1046, 704, 93, 211, 0, 209, 501, 163, 323, 471, 625, 593, 375, 947]"
163,19,4962,5241,6128,0,818,4144,"[726, 622, 641, 783, 850, 1306, 941, 832, 451, 1015, 984, 371, 658, 865, 842, 945, 164, 0, 79, 483, 821, 1131, 46, 298, 680, 1311, 1154]"
164,19,3554,1403,8279,0,2358,1196,"[392, 334, 73, 61, 94, 355, 201, 184, 306, 97, 26, 78, 53, 66, 103, 86, 171, 0, 178, 321, 28, 69, 24, 299, 72, 390, 139]"
165,19,4168,6803,5644,0,2994,1174,"[120, 363, 274, 115, 284, 108, 306, 230, 106, 368, 26, 229, 311, 57, 103, 93, 234, 0, 108, 303, 173, 389, 137, 167, 55, 246, 362]"
166,19,3691,1917,7418,0,3410,281,"[47, 44, 72, 29, 36, 47, 73, 33, 20, 29, 91, 16, 83, 19, 73, 87, 3, 0, 80, 16, 91, 51, 4, 80, 34, 87, 61]"
167,19,4411,6155,5674,0,582,3829,"[745, 1021, 657, 95, 354, 828, 156, 64, 1239, 618, 951, 933, 989, 367, 406, 982, 1262, 0, 1134, 933, 794, 1176, 7, 1162, 469, 909, 841]"
168,19,3366,2239,6801,0,473,2893,"[494, 443, 186, 479, 691, 438, 778, 176, 499, 452, 107, 105, 1, 33, 175, 423, 215, 0, 417, 825, 299, 661, 699, 560, 501, 298, 661]"
169,19,3272,722,9351,0,384,2888,"[552, 96, 725, 792, 469, 947, 559, 827, 26, 805, 362, 62, 610, 5, 316, 464, 284, 0, 334, 644, 744, 943, 412, 840, 25, 667, 574]"
170,19,3906,5225,8032,0,1555,2351,"[676, 598, 442, 348, 450, 711, 540, 213, 753, 216, 429, 30, 775, 351, 612, 215, 552, 0, 128, 393, 235, 29, 315, 603, 108, 130, 541]"
171,19,3744,6275,5501,0,3553,191,"[5, 54, 50, 0, 11, 0, 34, 0, 12, 14, 2, 32, 36, 9, 3, 44, 1, 0, 57, 36, 18, 58, 16, 30, 48, 26, 23]"
172,19,4211,1317,8395,0,1275,2936,"[759, 641, 514, 611, 251, 643, 9, 207, 779, 688, 297, 967, 974, 617, 553, 197, 51, 0, 115, 362, 929, 44, 282, 500, 554, 79, 649]"
173,19,3880,6932,5343,0,473,3407,"[881, 917, 186, 539, 739, 929, 985, 225, 356, 367, 1132, 183, 1003, 1034, 358, 576, 647, 0, 310, 819, 44, 924, 225, 584, 750, 160, 923]"
174,19,3520,2025,6838,0,1068,2452,"[181, 322, 179, 309, 173, 420, 639, 543, 19, 735, 345, 420, 159, 110, 759, 292, 741, 0, 325, 335, 743, 604, 111, 775, 49, 777, 201]"
175,19,3773,3036,7575,0,1344,2429,"[206, 147, 700, 342, 253, 582, 254, 22, 609, 289, 618, 226, 441, 198, 137, 757, 415, 0, 578, 469, 289, 370, 428, 13, 50, 717, 256]"
176,19,3804,6680,4699,0,575,3229,"[245, 1018, 0, 855, 430, 687, 271, 722, 303, 421, 336, 986, 748, 77, 735, 315, 597, 0, 244, 140, 107, 50, 493, 959, 526, 232, 953]"
177,19,3716,3066,5349,0,88,3628,"[379, 116, 712, 781, 1131, 450, 873, 880, 1135, 190, 314, 573, 325, 693, 409, 967, 775, 0, 367, 771, 1117, 989, 772, 878, 512, 810, 1084]"
178,19,3592,1053,7888,0,998,2594,"[114, 629, 854, 518, 328, 557, 62, 608, 447, 610, 475, 215, 456, 335, 250, 225, 321, 0, 188, 596, 266, 580, 577, 11, 267, 558, 218]"
179,19,3835,6517,5206,0,3324,511,"[29, 57, 116, 116, 12, 139, 38, 159, 77, 159, 54, 58, 131, 135, 126, 80, 160, 0, 76, 163, 95, 33, 126, 123, 129, 45, 42]"
180,19,4496,2801,6901,0,2895,1601,"[225, 209, 38, 61, 138, 176, 254, 50, 341, 248, 345, 190, 103, 323, 420, 214, 297, 0, 375, 25, 300, 246, 380, 325, 143, 524, 230]"
181,19,4221,5550,5572,0,2895,1326,"[158, 34, 242, 344, 96, 380, 210, 394, 46, 373, 179, 441, 276, 250, 411, 204, 396, 0, 352, 141, 386, 263, 98, 293, 301, 252, 256]"
182,19,4264,2384,7452,0,2732,1532,"[471, 20, 398, 276, 339, 64, 286, 414, 15, 119, 328, 166, 68, 426, 294, 419, 253, 0, 389, 23, 394, 83, 308, 287, 73, 234, 425]"
183,19,4047,5609,5890,0,3988,59,"[7, 3, 9, 18, 1, 17, 2, 14, 9, 13, 19, 15, 11, 19, 15, 8, 4, 0, 4, 13, 5, 15, 19, 3, 19, 8, 19]"
184,19,4443,3330,7003,0,3300,1143,"[91, 57, 173, 258, 94, 349, 196, 373, 135, 26, 141, 96, 296, 7, 330, 345, 268, 0, 290, 13, 168, 201, 249, 15, 353, 220, 172]"
185,19,4496,6953,4546,0,2196,2300,"[109, 758, 461, 338, 731, 626, 0, 515, 306, 145, 248, 28, 542, 161, 185, 98, 714, 0, 672, 479, 589, 493, 534, 99, 32, 526, 629]"
186,19,4923,1414,8055,0,1679,3244,"[744, 691, 788, 566, 203, 866, 1039, 690, 267, 510, 573, 16, 314, 450, 56, 794, 528, 0, 228, 483, 912, 426, 444, 478, 96, 1068, 446]"
187,19,4450,5615,6890,0,593,3857,"[971, 549, 291, 914, 136, 116, 277, 564, 471, 512, 671, 1208, 945, 896, 82, 41, 1137, 0, 518, 1036, 335, 88, 33, 449, 659, 27, 472]"
188,19,4878,6651,5117,0,1011,3867,"[428, 902, 44, 964, 1144, 1061, 1077, 102, 918, 976, 1054, 250, 699, 720, 973, 564, 284, 0, 827, 171, 565, 221, 48, 516, 565, 230, 1217]"
189,19,4644,279,9482,0,4087,557,"[21, 36, 72, 22, 33, 4, 101, 80, 31, 50, 32, 26, 74, 65, 64, 124, 62, 0, 178, 168, 101, 160, 167, 72, 164, 115, 117]"
190,19,3057,6442,6097,0,31,3026,"[638, 332, 610, 114, 1008, 306, 656, 256, 43, 368, 47, 177, 734, 974, 288, 929, 589, 0, 526, 610, 275, 199, 66, 973, 471, 147, 775]"
191,19,4411,1198,9310,0,1427,2984,"[643, 463, 814, 632, 58, 877, 479, 425, 918, 398, 518, 680, 308, 702, 660, 384, 110, 0, 302, 742, 508, 374, 240, 744, 895, 326, 849]"
192,19,4537,6664,7183,0,1423,3114,"[952, 1002, 451, 361, 907, 582, 521, 336, 91, 919, 269, 680, 418, 501, 912, 895, 458, 0, 220, 682, 480, 15, 796, 334, 256, 746, 902]"
193,19,4744,7312,4615,0,511,4233,"[522, 26, 791, 185, 949, 351, 614, 370, 954, 257, 487, 625, 733, 1094, 1000, 1290, 391, 0, 393, 683, 249, 1371, 1138, 1120, 363, 609, 1123]"
194,19,4803,3516,5902,0,1983,2820,"[851, 629, 919, 467, 200, 230, 220, 407, 669, 801, 843, 863, 443, 610, 179, 149, 507, 0, 380, 729, 638, 818, 426, 694, 908, 228, 734]"
195,19,3542,2606,6838,0,1608,1934,"[601, 630, 327, 550, 256, 484, 473, 309, 227, 313, 85, 195, 48, 292, 378, 16, 148, 0, 356, 273, 0, 534, 230, 629, 26, 328, 108]"
196,19,4397,6661,4574,0,3953,444,"[41, 25, 1, 2, 44, 139, 133, 84, 16, 105, 129, 74, 136, 143, 61, 92, 94, 0, 110, 60, 87, 110, 7, 117, 144, 84, 48]"
197,19,4945,416,9103,0,1315,3630,"[831, 510, 306, 1095, 1040, 1143, 814, 273, 1110, 458, 813, 717, 241, 880, 352, 837, 765, 0, 1099, 204, 1158, 1178, 622, 482, 240, 352, 492]"
198,19,4348,6902,6549,0,2273,2075,"[137, 674, 73, 561, 423, 391, 251, 325, 203, 348, 267, 263, 329, 359, 443, 169, 8, 0, 81, 559, 565, 503, 174, 214, 596, 456, 294]"
199,19,4455,6044,4960,0,3518,937,"[284, 205, 181, 12, 199, 203, 290, 149, 250, 198, 170, 38, 115, 43, 173, 233, 19, 0, 206, 221, 255, 174, 105, 305, 37, 229, 19]"
200,19,3399,2166,6193,0,345,3054,"[789, 508, 433, 783, 195, 336, 770, 279, 328, 854, 440, 394, 638, 620, 698, 249, 1008, 0, 546, 995, 859, 356, 590, 502, 595, 30, 647]"
201,19,3920,1176,8937,0,3245,675,"[172, 32, 61, 60, 54, 221, 100, 32, 91, 223, 81, 159, 170, 125, 38, 145, 87, 0, 141, 162, 139, 116, 18, 207, 192, 166, 68]"
202,19,4575,6581,6931,0,2303,2272,"[637, 147, 721, 465, 753, 187, 404, 486, 496, 677, 130, 412, 384, 524, 597, 599, 155, 0, 382, 597, 116, 391, 543, 370, 75, 36, 576]"
203,19,4355,7404,3882,0,19,4336,"[1118, 27, 299, 845, 162, 269, 354, 882, 357, 351, 868, 116, 283, 1073, 1003, 962, 930, 0, 53, 1077, 680, 336, 102, 678, 871, 138, 1395]"
204,19,4165,3065,4982,0,3826,339,"[105, 77, 0, 80, 49, 68, 41, 103, 48, 74, 41, 0, 74, 76, 93, 38, 51, 0, 56, 3, 97, 73, 1, 50, 110, 84, 9]"
205,19,4875,2091,7766,0,3757,1118,"[274, 117, 169, 273, 28, 237, 319, 359, 146, 128, 309, 205, 214, 175, 16, 171, 160, 0, 7, 166, 78, 162, 113, 346, 360, 207, 54]"
206,19,3594,6859,4501,0,1105,2489,"[0, 339, 429, 481, 12, 95, 480, 155, 491, 584, 648, 628, 203, 175, 765, 147, 414, 0, 826, 448, 736, 251, 527, 571, 414, 213, 410]"
207,19,4295,200,8596,0,249,4046,"[650, 410, 525, 437, 610, 884, 1050, 629, 804, 1311, 512, 8, 253, 740, 547, 626, 1108, 0, 454, 474, 163, 1017, 904, 53, 67, 481, 1052]"
208,19,3401,6298,5699,0,2735,666,"[122, 166, 97, 48, 85, 152, 78, 85, 88, 84, 99, 76, 161, 199, 6, 130, 179, 0, 195, 32, 81, 79, 94, 68, 66, 125, 11]"
209,19,4747,2702,7744,0,3825,922,"[265, 125, 56, 107, 50, 252, 247, 37, 274, 266, 99, 212, 178, 290, 105, 146, 212, 0, 40, 69, 28, 188, 103, 98, 169, 8, 100]"
210,19,4665,6241,6168,0,812,3853,"[82, 99, 1026, 837, 229, 738, 499, 981, 799, 106, 818, 331, 137, 1248, 213, 1226, 167, 0, 1181, 842, 1262, 656, 1188, 33, 74, 315, 959]"
211,19,3741,1619,8290,0,2793,948,"[276, 96, 71, 222, 162, 40, 139, 84, 77, 242, 93, 226, 287, 3, 279, 114, 100, 0, 56, 145, 242, 271, 185, 132, 8, 163, 257]"
212,19,4221,5243,7268,0,1225,2996,"[809, 194, 176, 271, 759, 276, 591, 603, 343, 882, 258, 690, 151, 961, 289, 667, 263, 0, 834, 291, 422, 109, 689, 982, 184, 879, 441]"
213,19,4699,5013,6954,0,1039,3660,"[798, 1145, 609, 1204, 473, 247, 370, 61, 535, 116, 966, 478, 268, 591, 671, 40, 397, 0, 226, 1192, 1205, 1123, 940, 1015, 943, 781, 184]"
214,19,4182,6572,4564,0,1407,2775,"[303, 433, 650, 380, 336, 552, 323, 219, 439, 110, 544, 5, 8, 317, 71, 633, 892, 0, 390, 357, 116, 509, 136, 479, 886, 407, 332]"
215,19,3673,351,7886,0,3507,166,"[53, 37, 47, 47, 14, 43, 52, 33, 43, 55, 48, 22, 24, 25, 12, 34, 5, 0, 16, 50, 31, 3, 37, 39, 19, 20, 4]"
216,19,3882,5064,6704,0,3648,234,"[69, 0, 44, 18, 58, 65, 76, 44, 42, 72, 73, 9, 45, 69, 43, 28, 66, 0, 46, 60, 28, 71, 41, 36, 74, 30, 43]"
217,19,3602,1709,8597,0,1752,1850,"[287, 207, 559, 506, 455, 614, 562, 162, 369, 521, 82, 263, 130, 36, 339, 545, 371, 0, 26, 503, 392, 580, 268, 91, 212, 526, 579]"
218,19,3705,6246,6056,0,3473,232,"[26, 23, 11, 37, 26, 68, 19, 20, 71, 31, 36, 30, 40, 19, 29, 38, 74, 0, 50, 64, 4, 40, 68, 3, 1, 47, 6]"
219,19,4927,4545,6438,0,4496,431,"[22, 138, 123, 133, 129, 140, 143, 22, 91, 132, 87, 34, 9, 24, 15, 94, 24, 0, 25, 51, 27, 35, 32, 43, 11, 76, 81]"
220,19,4948,5830,5556,0,4763,185,"[23, 56, 23, 30, 31, 37, 51, 41, 9, 15, 30, 18, 19, 36, 23, 25, 7, 0, 34, 31, 21, 6, 7, 37, 9, 5, 42]"
221,19,3879,2269,7166,0,2093,1786,"[584, 526, 458, 46, 128, 352, 390, 434, 311, 59, 327, 575, 60, 195, 178, 113, 349, 0, 188, 442, 78, 573, 335, 489, 409, 202, 36]"
222,19,3897,5088,5975,0,2495,1402,"[349, 162, 132, 51, 205, 140, 434, 151, 401, 427, 233, 212, 355, 360, 358, 143, 285, 0, 38, 10, 317, 274, 18, 338, 355, 12, 285]"
223,19,3160,336,8799,0,1140,2020,"[476, 63, 624, 86, 422, 606, 230, 418, 83, 275, 172, 534, 8, 229, 223, 138, 454, 0, 160, 293, 128, 355, 393, 505, 621, 232, 414]"
224,19,4231,6507,6523,0,1047,3184,"[626, 936, 594, 893, 666, 1039, 10, 405, 566, 513, 287, 184, 448, 1031, 501, 333, 19, 0, 875, 791, 238, 580, 726, 691, 144, 906, 394]"
225,19,3303,2281,7545,0,2894,409,"[23, 8, 74, 130, 122, 19, 70, 7, 18, 107, 41, 31, 20, 2, 88, 117, 78, 0, 85, 4, 20, 70, 39, 88, 133, 71, 22]"
226,19,4134,5331,6348,0,1725,2409,"[682, 682, 790, 517, 336, 579, 628, 62, 192, 700, 349, 699, 613, 395, 798, 585, 419, 0, 775, 544, 580, 399, 319, 367, 623, 418, 239]"
227,19,3274,1760,7862,0,2029,1245,"[73, 360, 295, 84, 320, 310, 291, 304, 11, 4, 77, 159, 18, 239, 304, 210, 327, 0, 378, 133, 67, 76, 3, 95, 1, 386, 354]"
228,19,4728,6837,5753,0,3286,1442,"[73, 147, 29, 138, 41, 156, 37, 426, 455, 3, 36, 351, 116, 319, 285, 413, 357, 0, 42, 480, 410, 417, 418, 49, 432, 285, 378]"
229,19,3834,850,8737,0,706,3128,"[740, 624, 129, 613, 226, 988, 357, 689, 648, 162, 922, 568, 762, 786, 301, 926, 746, 0, 764, 726, 442, 659, 333, 786, 163, 314, 504]"
230,19,3903,7007,5633,0,399,3504,"[118, 670, 152, 114, 731, 303, 62, 205, 284, 573, 1062, 1021, 1002, 887, 805, 350, 767, 0, 404, 357, 16, 37, 92, 1078, 883, 1120, 720]"
231,19,3524,3210,5947,0,1380,2144,"[157, 402, 220, 343, 21, 516, 326, 215, 79, 11, 50, 150, 176, 563, 169, 189, 199, 0, 512, 20, 473, 6, 701, 480, 547, 398, 175]"
232,19,4721,3350,7318,0,460,4261,"[545, 1340, 1381, 1320, 1265, 919, 86, 267, 902, 431, 801, 1289, 1096, 245, 751, 1391, 469, 0, 448, 662, 251, 385, 875, 424, 1241, 895, 1010]"
233,19,3192,1866,8644,0,584,2608,"[231, 64, 52, 488, 615, 831, 389, 9, 151, 292, 181, 391, 296, 600, 21, 181, 693, 0, 401, 588, 17, 317, 38, 445, 199, 742, 226]"
234,19,4598,5468,7774,0,3420,1178,"[186, 225, 235, 42, 105, 236, 38, 34, 272, 288, 285, 248, 354, 70, 81, 136, 28, 0, 209, 218, 281, 289, 73, 17, 55, 229, 102]"
235,19,4843,5399,7218,0,821,4022,"[131, 444, 1203, 194, 176, 702, 829, 1290, 1256, 109, 481, 664, 431, 860, 1228, 520, 972, 0, 375, 1109, 239, 74, 251, 679, 270, 313, 149]"
236,19,4490,5134,6574,0,3862,628,"[15, 51, 187, 20, 78, 142, 123, 97, 83, 185, 141, 69, 81, 8, 19, 169, 48, 0, 67, 138, 5, 61, 37, 65, 75, 125, 138]"
237,19,4386,3796,7164,0,1915,2471,"[49, 272, 788, 767, 438, 814, 372, 722, 604, 594, 561, 218, 797, 738, 805, 592, 302, 0, 583, 372, 542, 790, 267, 291, 526, 76, 284]"
238,19,4193,5005,6352,0,3450,743,"[210, 59, 233, 169, 183, 78, 221, 32, 48, 189, 241, 47, 1, 106, 203, 215, 153, 0, 29, 217, 0, 50, 74, 60, 134, 175, 65]"
239,19,3496,220,9628,0,1717,1779,"[3, 521, 237, 500, 133, 125, 378, 62, 229, 75, 268, 467, 485, 441, 298, 388, 203, 0, 470, 29, 441, 106, 309, 430, 536, 155, 180]"
240,19,4166,6333,7461,0,3228,938,"[236, 12, 145, 205, 198, 197, 228, 180, 105, 137, 14, 203, 217, 193, 249, 236, 146, 0, 67, 246, 308, 198, 63, 160, 234, 211, 94]"
241,19,3848,6467,4842,0,3479,369,"[8, 38, 29, 0, 61, 64, 122, 14, 56, 72, 113, 72, 0, 22, 121, 34, 86, 0, 15, 73, 84, 54, 11, 12, 109, 76, 18]"
242,19,4196,2332,6706,0,4187,9,"[2, 0, 3, 1, 3, 0, 1, 3, 1, 2, 0, 0, 0, 2, 1, 1, 0, 0, 3, 0, 3, 0, 1, 1, 3, 1, 0]"
243,19,3222,1839,8089,0,2970,252,"[4, 81, 18, 73, 52, 59, 39, 33, 6, 83, 37, 58, 75, 75, 68, 41, 15, 0, 6, 55, 42, 16, 31, 26, 10, 84, 66]"
244,19,4446,6533,6002,0,3490,956,"[11, 139, 159, 272, 241, 252, 207, 237, 128, 97, 80, 95, 157, 228, 53, 131, 78, 0, 131, 66, 197, 75, 177, 54, 188, 310, 72]"
245,19,4964,1259,9707,0,1182,3782,"[860, 997, 1121, 1208, 811, 443, 635, 724, 110, 155, 359, 221, 770, 418, 34, 1143, 760, 0, 468, 790, 144, 1143, 762, 1140, 1036, 711, 366]"
246,19,3326,7221,5812,0,2082,1244,"[144, 217, 318, 161, 126, 212, 218, 55, 262, 156, 65, 187, 236, 242, 210, 352, 356, 0, 231, 201, 158, 296, 197, 230, 232, 312, 376]"
247,19,3474,1087,8199,0,2035,1439,"[276, 266, 394, 24, 402, 349, 300, 312, 85, 307, 12, 226, 188, 15, 116, 288, 25, 0, 55, 408, 411, 198, 337, 143, 382, 284, 424]"
248,19,4255,6246,6208,0,3832,423,"[2, 15, 53, 105, 110, 12, 25, 56, 137, 57, 37, 37, 64, 63, 64, 10, 110, 0, 123, 9, 118, 2, 97, 127, 73, 46, 3]"
249,19,3330,1556,7982,0,104,3226,"[455, 910, 579, 405, 936, 480, 331, 119, 244, 1018, 483, 547, 1000, 577, 1074, 704, 706, 0, 634, 659, 579, 506, 920, 308, 601, 130, 158]"
250,19,4847,6149,6680,0,3214,1633,"[59, 510, 473, 427, 506, 207, 217, 312, 187, 100, 62, 203, 113, 534, 196, 78, 362, 0, 87, 227, 256, 541, 71, 132, 51, 119, 435]"
251,19,3496,1759,8417,0,402,3094,"[893, 8, 422, 645, 404, 450, 967, 756, 628, 550, 480, 1003, 496, 359, 925, 71, 621, 0, 491, 257, 920, 890, 763, 41, 95, 79, 217]"
252,19,4205,5688,6934,0,3513,692,"[49, 143, 226, 92, 158, 131, 202, 56, 145, 193, 183, 174, 124, 121, 114, 2, 62, 0, 70, 64, 217, 156, 0, 17, 85, 145, 66]"
253,19,4695,6848,4781,0,3275,1420,"[463, 453, 272, 111, 347, 343, 288, 155, 133, 297, 407, 354, 354, 363, 361, 207, 427, 0, 161, 240, 273, 21, 64, 145, 11, 66, 372]"
254,19,3413,2439,5755,0,2065,1348,"[319, 246, 394, 103, 1, 59, 381, 403, 32, 384, 47, 1, 437, 157, 222, 407, 178, 0, 80, 187, 192, 61, 344, 355, 199, 149, 83]"
255,19,3795,1482,8068,0,3327,468,"[103, 73, 5, 80, 114, 153, 89, 83, 9, 110, 25, 42, 135, 115, 0, 14, 118, 0, 75, 80, 88, 50, 131, 31, 126, 77, 45]"
256,19,3149,6988,4229,0,2316,833,"[20, 272, 61, 98, 133, 234, 149, 127, 200, 271, 174, 30, 50, 161, 85, 21, 74, 0, 190, 164, 253, 180, 184, 191, 246, 265, 166]"
257,19,3134,2418,4945,0,2423,711,"[133, 212, 231, 196, 34, 34, 137, 32, 216, 39, 0, 235, 222, 41, 49, 61, 11, 0, 147, 101, 160, 237, 219, 86, 78, 47, 35]"
258,19,3608,1520,7033,0,928,2680,"[288, 418, 521, 781, 580, 403, 152, 249, 107, 287, 558, 530, 880, 405, 345, 481, 172, 0, 458, 201, 331, 781, 385, 354, 41, 151, 162]"
259,19,3938,2073,8898,0,2824,1114,"[358, 238, 41, 144, 42, 123, 216, 331, 204, 348, 114, 144, 355, 173, 137, 219, 240, 0, 259, 224, 97, 20, 181, 279, 127, 42, 332]"
260,19,4191,7076,6013,0,723,3468,"[397, 297, 162, 714, 785, 554, 855, 157, 216, 752, 1110, 527, 333, 736, 262, 280, 357, 0, 855, 946, 12, 888, 636, 367, 1121, 403, 975]"
261,19,4257,1788,8482,0,261,3996,"[732, 435, 1252, 548, 428, 1129, 196, 120, 1084, 85, 807, 508, 471, 1078, 1031, 400, 309, 0, 720, 936, 149, 681, 758, 1, 54, 1248, 1026]"
262,19,4290,6725,6047,0,4017,273,"[52, 19, 25, 12, 14, 26, 43, 74, 74, 18, 12, 82, 68, 21, 21, 30, 59, 0, 90, 38, 34, 33, 81, 58, 55, 33, 39]"
263,19,3573,194,9426,0,1739,1834,"[12, 203, 290, 265, 393, 93, 429, 55, 591, 322, 197, 572, 88, 20, 451, 582, 82, 0, 321, 575, 444, 500, 552, 271, 9, 548, 356]"
264,19,4054,6213,7267,0,417,3637,"[323, 1089, 563, 340, 686, 702, 252, 462, 500, 1145, 154, 12, 966, 949, 881, 1152, 880, 0, 689, 999, 813, 153, 1115, 287, 455, 273, 178]"
265,19,3271,1831,8707,0,2812,459,"[117, 140, 3, 109, 40, 129, 73, 130, 40, 66, 64, 10, 132, 86, 71, 66, 68, 0, 76, 126, 148, 11, 72, 71, 72, 74, 26]"
266,19,3969,5384,7292,0,2817,1152,"[364, 337, 38, 317, 285, 156, 73, 61, 282, 150, 281, 379, 235, 159, 243, 371, 11, 0, 236, 135, 364, 124, 327, 187, 96, 228, 131]"
267,19,3603,3384,7511,0,3369,234,"[7, 54, 18, 75, 23, 0, 24, 43, 59, 60, 30, 77, 55, 8, 75, 75, 66, 0, 50, 69, 8, 68, 47, 5, 48, 9, 12]"
268,19,3513,6930,4094,0,974,2539,"[85, 840, 693, 453, 471, 365, 81, 564, 227, 233, 489, 277, 221, 338, 636, 272, 209, 0, 289, 51, 168, 706, 702, 439, 643, 769, 349]"
269,19,3699,2366,5427,0,1893,1806,"[53, 475, 133, 542, 513, 96, 530, 229, 116, 348, 133, 63, 161, 475, 246, 241, 284, 0, 480, 283, 14, 201, 235, 542, 311, 34, 213]"
270,19,4004,3625,5806,0,1678,2326,"[177, 132, 577, 722, 31, 486, 506, 623, 95, 386, 182, 268, 434, 391, 767, 533, 305, 0, 444, 276, 260, 500, 320, 64, 450, 454, 256]"
271,19,4193,3706,6293,0,2680,1513,"[479, 245, 191, 312, 189, 284, 331, 105, 487, 51, 361, 364, 234, 379, 127, 41, 55, 0, 46, 279, 265, 277, 58, 144, 246, 333, 342]"
272,19,3115,1400,8008,0,3036,79,"[13, 6, 17, 13, 3, 19, 9, 13, 17, 8, 9, 13, 13, 4, 13, 18, 22, 0, 3, 0, 21, 12, 12, 18, 3, 13, 26]"
273,19,4096,6554,5550,0,2984,1112,"[123, 80, 178, 152, 14, 313, 247, 88, 17, 85, 33, 142, 276, 186, 280, 115, 172, 0, 283, 151, 316, 216, 287, 207, 120, 61, 175]"
274,19,4281,2053,7778,0,3931,350,"[37, 39, 43, 73, 2, 19, 99, 112, 104, 52, 65, 12, 50, 79, 5, 75, 62, 0, 42, 7, 39, 86, 3, 85, 24, 62, 9]"
275,19,3638,7375,4041,0,2099,1539,"[65, 301, 507, 330, 366, 451, 161, 361, 272, 280, 145, 414, 375, 275, 211, 121, 505, 0, 412, 144, 64, 383, 292, 482, 377, 432, 360]"
276,19,4845,3464,5422,0,3688,1157,"[100, 97, 104, 347, 147, 255, 254, 355, 138, 151, 109, 198, 149, 43, 80, 330, 105, 0, 200, 139, 130, 184, 354, 156, 336, 42, 191]"
277,19,3450,599,8273,0,2953,497,"[102, 2, 92, 10, 42, 136, 113, 37, 80, 140, 68, 113, 67, 18, 93, 68, 81, 0, 45, 121, 141, 134, 94, 36, 107, 41, 45]"
278,19,4253,7233,5293,0,2906,1347,"[184, 85, 101, 84, 208, 73, 446, 420, 159, 401, 278, 148, 64, 288, 237, 10, 335, 0, 239, 359, 173, 36, 129, 236, 379, 394, 376]"
279,19,3671,2470,6494,0,3212,459,"[46, 127, 74, 144, 43, 151, 124, 87, 114, 117, 151, 31, 7, 53, 93, 34, 16, 0, 25, 12, 25, 18, 130, 54, 92, 49, 149]"
280,19,4748,6864,4378,0,1487,3261,"[517, 978, 418, 545, 638, 1050, 387, 739, 61, 724, 459, 72, 471, 440, 63, 135, 1048, 0, 904, 426, 933, 376, 943, 892, 507, 813, 938]"
281,19,3346,2756,4968,0,3106,240,"[46, 36, 63, 7, 29, 73, 70, 41, 22, 49, 75, 36, 56, 2, 11, 29, 16, 0, 3, 50, 57, 28, 36, 52, 58, 15, 39]"
282,19,4011,2227,6752,0,2089,1922,"[541, 190, 243, 316, 612, 585, 377, 599, 101, 453, 93, 102, 548, 349, 32, 383, 332, 0, 179, 606, 476, 583, 37, 206, 529, 101, 610]"
283,19,3362,1836,8278,0,791,2571,"[770, 573, 230, 809, 182, 15, 565, 646, 665, 24, 511, 395, 23, 275, 41, 178, 542, 0, 654, 275, 612, 25, 841, 383, 593, 588, 90]"
284,19,4828,6786,6320,0,2027,2801,"[759, 488, 596, 917, 308, 284, 124, 801, 78, 709, 49, 28, 900, 394, 259, 342, 37, 0, 119, 704, 871, 461, 129, 575, 177, 384, 765]"
285,19,4877,5671,5526,0,2155,2722,"[186, 731, 378, 792, 180, 550, 534, 259, 742, 217, 450, 341, 573, 630, 367, 290, 459, 0, 530, 704, 432, 401, 825, 521, 578, 131, 606]"
286,19,4506,3825,6207,0,314,4192,"[1273, 483, 724, 121, 38, 629, 1374, 484, 619, 380, 1291, 1075, 390, 574, 1324, 1166, 438, 0, 1185, 1007, 547, 185, 1341, 279, 295, 649, 504]"
287,19,4168,300,10000,75,1979,2189,"[661, 453, 219, 144, 42, 622, 76, 589, 172, 500, 3, 119, 396, 553, 500, 246, 532, 0, 198, 484, 276, 667, 503, 271, 140, 679, 203]"
288,19,4438,5137,9301,0,3984,454,"[70, 61, 104, 46, 104, 57, 89, 38, 23, 1, 123, 18, 55, 120, 94, 137, 5, 0, 37, 71, 96, 136, 137, 12, 21, 96, 57]"
289,19,3018,6096,6223,0,257,2761,"[795, 785, 131, 99, 886, 165, 437, 808, 853, 890, 902, 420, 68, 583, 762, 576, 24, 0, 433, 383, 504, 742, 340, 910, 765, 439, 159]"
290,19,3929,2471,7681,0,2051,1878,"[127, 140, 77, 110, 114, 258, 566, 302, 283, 97, 381, 206, 277, 581, 615, 568, 448, 0, 415, 117, 229, 304, 466, 549, 429, 455, 138]"
291,19,4395,6904,5172,0,1269,3126,"[921, 741, 133, 630, 741, 229, 651, 565, 950, 998, 554, 342, 711, 362, 941, 507, 1016, 0, 1035, 111, 402, 139, 584, 254, 128, 119, 781]"
292,19,4543,3863,5852,0,2783,1760,"[513, 449, 13, 442, 553, 519, 276, 385, 520, 230, 394, 102, 389, 219, 482, 408, 139, 0, 390, 474, 351, 465, 472, 210, 415, 183, 193]"
293,19,4518,820,9550,0,43,4475,"[11, 1204, 1294, 137, 1330, 176, 1062, 371, 778, 40, 335, 512, 773, 388, 782, 999, 311, 0, 989, 1315, 1078, 679, 752, 1265, 1491, 275, 440]"
294,19,3896,7078,6368,0,604,3292,"[839, 120, 506, 795, 240, 255, 275, 432, 289, 28, 926, 164, 853, 238, 1091, 618, 54, 0, 652, 283, 474, 1073, 215, 233, 374, 882, 685]"
295,19,4320,83,10000,605,4091,229,"[75, 23, 52, 75, 49, 65, 26, 30, 30, 66, 61, 71, 7, 17, 59, 71, 21, 0, 75, 56, 74, 68, 30, 68, 72, 11, 67]"
296,19,3347,5363,7984,0,2608,739,"[64, 7, 81, 212, 133, 231, 204, 124, 242, 195, 86, 62, 10, 188, 125, 133, 97, 0, 194, 194, 228, 134, 145, 75, 9, 208, 130]"
297,19,4874,5300,7558,0,1496,3378,"[462, 952, 593, 482, 1025, 1124, 435, 559, 632, 62, 89, 189, 679, 727, 481, 344, 758, 0, 622, 799, 90, 380, 139, 540, 127, 904, 869]"
298,19,3509,6944,4123,0,2021,1488,"[304, 179, 65, 452, 120, 324, 186, 8, 495, 464, 387, 124, 452, 117, 398, 101, 125, 0, 240, 386, 32, 92, 332, 104, 126, 57, 169]"
299,19,4991,3450,5664,0,2044,2947,"[584, 305, 322, 897, 915, 337, 128, 460, 515, 338, 651, 132, 692, 174, 819, 536, 703, 0, 346, 677, 750, 361, 35, 864, 337, 973, 768]"
0,20,4286,0,4286,0,4202,84,"[23, 27, 8, 18, 15, 5, 4, 13, 28, 0, 4, 24, 7, 25, 25, 16, 10, 0, 0, 18, 4, 5, 1, 5, 3, 22, 23]"
1,20,4424,873,7837,0,1074,3350,"[190, 389, 258, 611, 416, 346, 782, 78, 730, 345, 92, 719, 684, 182, 965, 73, 883, 752, 0, 298, 461, 412, 13, 1087, 656, 783, 259]"
2,20,4626,7085,5378,0,3049,1577,"[476, 457, 164, 497, 486, 203, 432, 317, 439, 79, 511, 233, 464, 22, 494, 497, 357, 110, 0, 251, 120, 288, 419, 309, 158, 104, 416]"
3,20,4054,2119,7313,0,3898,156,"[37, 30, 25, 34, 34, 36, 6, 17, 47, 31, 41, 15, 6, 34, 21, 0, 23, 18, 0, 45, 50, 36, 47, 38, 5, 22, 39]"
4,20,4833,5867,6279,0,3168,1665,"[234, 178, 94, 117, 447, 270, 350, 433, 302, 367, 129, 364, 315, 244, 112, 375, 527, 454, 0, 418, 107, 137, 333, 314, 287, 497, 547]"
5,20,3732,131,9880,0,3471,261,"[31, 19, 61, 7, 2, 8, 63, 63, 16, 40, 86, 7, 7, 70, 62, 65, 15, 39, 0, 87, 37, 9, 65, 2, 76, 33, 36]"
6,20,4935,5671,9144,0,3923,1012,"[96, 100, 252, 207, 32, 62, 48, 12, 275, 199, 111, 333, 208, 180, 248, 193, 261, 159, 0, 11, 89, 169, 99, 328, 40, 91, 175]"
7,20,4043,5857,7330,0,2911,1132,"[245, 284, 265, 246, 108, 260, 87, 21, 156, 32, 239, 91, 50, 197, 133, 308, 88, 316, 0, 42, 146, 321, 10, 311, 149, 375, 152]"
8,20,4240,5279,6291,0,84,4156,"[1339, 1123, 1302, 449, 1234, 255, 164, 65, 231, 278, 648, 855, 1104, 1026, 279, 810, 284, 648, 0, 844, 184, 385, 471, 576, 1342, 38, 90]"
9,20,4836,7243,3884,0,2507,2329,"[191, 244, 345, 270, 286, 213, 23, 211, 243, 127, 255, 378, 613, 168, 333, 260, 307, 749, 0, 507, 647, 770, 141, 540, 97, 661, 95]"
10,20,4595,2556,5923,0,1177,3418,"[1128, 154, 505, 423, 127, 579, 681, 1098, 240, 1037, 764, 111, 252, 901, 597, 811, 389, 1035, 0, 1092, 418, 345, 1015, 477, 1108, 738, 506]"
11,20,3977,2980,6920,0,3198,779,"[162, 1, 157, 64, 67, 143, 228, 87, 1, 157, 241, 101, 99, 58, 40, 95, 143, 164, 0, 253, 198, 26, 131, 80, 204, 252, 9]"
12,20,3292,2803,7409,0,2061,1231,"[34, 294, 289, 307, 202, 318, 294, 356, 205, 245, 97, 99, 111, 266, 130, 100, 373, 390, 0, 355, 288, 125, 83, 6, 163, 69, 373]"
13,20,4718,7321,4806,0,2683,2035,"[199, 291, 29, 465, 28, 406, 431, 372, 369, 465, 16, 427, 138, 120, 108, 565, 628, 559, 0, 378, 454, 565, 566, 484, 595, 9, 550]"
14,20,4100,3858,5048,0,3695,405,"[75, 60, 9, 102, 57, 90, 31, 56, 53, 127, 24, 23, 132, 82, 42, 36, 56, 12, 0, 45, 7, 123, 67, 14, 15, 38, 28]"
15,20,3128,216,7960,0,2068,1060,"[60, 158, 254, 133, 13, 283, 265, 316, 75, 267, 263, 273, 154, 187, 89, 239, 76, 141, 0, 213, 42, 164, 255, 20, 84, 208, 9]"
16,20,4895,7480,5375,0,570,4325,"[363, 1145, 1339, 644, 47, 965, 1341, 690, 809, 316, 1381, 94, 429, 375, 513, 1436, 1411, 47, 0, 375, 401, 257, 1104, 887, 990, 880, 1353]"
17,20,3685,1881,7179,0,3473,212,"[56, 24, 68, 43, 37, 66, 4, 47, 51, 64, 47, 53, 53, 28, 29, 51, 2, 18, 0, 66, 29, 53, 20, 28, 53, 4, 0]"
18,20,3379,1706,8852,0,1497,1882,"[181, 228, 424, 167, 369, 14, 447, 173, 162, 211, 564, 608, 428, 208, 16, 358, 514, 384, 0, 135, 204, 573, 251, 473, 65, 385, 425]"
19,20,4594,5392,8054,0,1458,3136,"[137, 846, 1023, 915, 998, 1037, 779, 829, 250, 373, 479, 464, 179, 67, 490, 356, 433, 469, 0, 533, 945, 169, 703, 639, 352, 211, 584]"
20,20,4229,5022,7261,0,2008,2221,"[614, 428, 126, 268, 702, 429, 195, 410, 549, 250, 475, 280, 598, 126, 355, 701, 403, 485, 0, 483, 667, 369, 620, 537, 497, 634, 204]"
21,20,3660,2468,8453,0,3436,224,"[48, 19, 54, 19, 11, 62, 68, 61, 13, 16, 48, 43, 11, 68, 39, 63, 73, 57, 0, 74, 70, 63, 10, 29, 62, 61, 47]"
22,20,3908,5253,7108,0,2357,1551,"[428, 486, 432, 15, 67, 508, 151, 479, 32, 120, 393, 458, 134, 482, 417, 401, 94, 212, 0, 490, 414, 163, 182, 187, 150, 299, 265]"
23,20,4282,6010,5380,0,1066,3216,"[552, 86, 299, 637, 1006, 530, 606, 875, 742, 451, 988, 862, 701, 472, 287, 661, 754, 55, 0, 49, 334, 677, 363, 825, 518, 218, 982]"
24,20,4344,2575,7149,0,2781,1563,"[27, 405, 161, 377, 165, 218, 416, 300, 320, 293, 374, 213, 110, 406, 22, 252, 376, 4, 0, 497, 345, 100, 33, 328, 29, 71, 503]"
25,20,4113,6058,5204,0,4094,19,"[4, 1, 6, 6, 5, 0, 4, 5, 3, 0, 4, 1, 6, 2, 2, 5, 4, 5, 0, 5, 3, 5, 4, 3, 4, 5, 0]"
26,20,3876,3625,5455,0,3009,867,"[24, 179, 168, 283, 139, 67, 248, 111, 78, 143, 206, 98, 231, 280, 161, 167, 87, 184, 0, 158, 203, 126, 202, 204, 106, 183, 167]"
27,20,3036,1625,6866,0,2249,787,"[244, 102, 165, 259, 181, 250, 188, 214, 171, 29, 215, 100, 184, 31, 12, 64, 256, 6, 0, 178, 92, 59, 9, 183, 133, 155, 183]"
28,20,4271,6962,4175,0,2128,2143,"[644, 298, 487, 237, 635, 9, 83, 385, 179, 114, 91, 255, 137, 283, 434, 385, 197, 678, 0, 564, 549, 130, 526, 682, 502, 410, 40]"
29,20,3280,2046,5409,0,758,2522,"[285, 53, 141, 335, 366, 521, 590, 660, 136, 635, 373, 336, 130, 520, 765, 167, 335, 104, 0, 664, 388, 297, 423, 426, 274, 379, 106]"
30,20,3534,2820,6123,0,752,2782,"[719, 724, 578, 275, 496, 584, 179, 863, 843, 746, 56, 484, 125, 797, 370, 94, 211, 451, 0, 573, 894, 516, 29, 753, 774, 390, 392]"
31,20,3735,3463,6395,0,1035,2700,"[17, 709, 608, 467, 715, 298, 409, 685, 876, 863, 754, 853, 29, 678, 383, 558, 97, 34, 0, 891, 878, 362, 150, 374, 136, 766, 169]"
32,20,4299,3088,7606,0,2283,2016,"[220, 380, 38, 512, 478, 66, 270, 315, 399, 473, 257, 232, 346, 280, 166, 398, 159, 547, 0, 56, 617, 640, 338, 147, 19, 614, 367]"
33,20,3066,2883,7789,0,1066,2000,"[62, 530, 324, 223, 554, 497, 572, 569, 492, 371, 497, 306, 350, 152, 208, 611, 370, 530, 0, 321, 580, 262, 360, 223, 656, 27, 291]"
34,20,4512,5698,6603,0,1193,3319,"[798, 304, 419, 844, 463, 750, 917, 476, 1020, 708, 557, 159, 1058, 955, 411, 873, 814, 797, 0, 946, 418, 949, 940, 261, 880, 670, 919]"
35,20,4444,7486,3561,0,260,4184,"[105, 285, 981, 227, 1119, 222, 485, 117, 425, 602, 54, 851, 1322, 304, 688, 481, 1207, 847, 0, 707, 878, 688, 1127, 967, 1185, 872, 744]"
36,20,3404,345,6620,0,793,2611,"[694, 410, 521, 663, 99, 703, 547, 641, 81, 811, 756, 148, 366, 708, 12, 420, 196, 221, 0, 5, 563, 583, 220, 491, 557, 417, 512]"
37,20,4864,6963,4521,0,1219,3645,"[292, 822, 743, 1039, 66, 529, 819, 373, 575, 804, 826, 296, 374, 659, 288, 762, 463, 810, 0, 464, 945, 369, 494, 527, 878, 10, 985]"
38,20,4270,149,8642,0,1934,2336,"[382, 186, 14, 749, 490, 736, 170, 433, 507, 663, 99, 209, 757, 182, 712, 143, 218, 473, 0, 250, 528, 39, 73, 565, 91, 268, 288]"
39,20,3411,7498,4555,0,2317,1094,"[103, 354, 305, 363, 297, 40, 318, 110, 17, 132, 332, 100, 313, 160, 348, 75, 155, 309, 0, 73, 198, 136, 152, 170, 37, 313, 313]"
40,20,4885,1203,8237,0,1448,3437,"[176, 938, 755, 111, 358, 306, 1065, 1054, 58, 995, 493, 863, 221, 967, 593, 287, 1009, 1012, 0, 398, 890, 605, 161, 165, 913, 774, 244]"
41,20,3369,6037,5569,0,1020,2349,"[160, 373, 624, 390, 332, 269, 714, 691, 680, 35, 341, 764, 656, 351, 492, 172, 303, 309, 0, 775, 274, 339, 258, 655, 196, 676, 279]"
42,20,3785,1789,7565,0,8,3777,"[214, 542, 18, 647, 447, 300, 1235, 212, 885, 1211, 388, 1153, 1082, 560, 146, 503, 805, 896, 0, 10, 401, 233, 235, 422, 958, 1034, 558]"
43,20,4832,5076,7321,0,1027,3805,"[1084, 1193, 478, 217, 991, 250, 350, 279, 278, 713, 733, 884, 208, 860, 143, 531, 827, 513, 0, 884, 787, 1202, 990, 1179, 978, 1221, 899]"
44,20,3023,2406,7938,0,2519,504,"[98, 41, 40, 70, 94, 97, 121, 150, 21, 81, 31, 112, 1, 107, 9, 120, 90, 162, 0, 145, 66, 17, 89, 80, 144, 88, 153]"
45,20,3746,5111,6573,0,237,3509,"[202, 862, 175, 1094, 71, 437, 636, 398, 304, 75, 556, 762, 855, 489, 531, 1169, 901, 510, 0, 740, 863, 892, 308, 284, 1022, 687, 158]"
46,20,3004,2192,7385,0,1761,1243,"[294, 197, 137, 281, 215, 381, 240, 236, 103, 106, 97, 143, 168, 394, 185, 265, 362, 287, 0, 67, 112, 82, 199, 351, 413, 234, 153]"
47,20,3912,7458,3839,0,2827,1085,"[83, 16, 350, 63, 206, 1, 71, 202, 111, 324, 154, 335, 308, 91, 300, 16, 0, 95, 0, 120, 225, 243, 262, 173, 160, 182, 318]"
48,20,3249,2598,4490,0,2516,733,"[147, 61, 44, 103, 31, 191, 180, 194, 170, 107, 209, 149, 128, 244, 60, 155, 13, 59, 0, 86, 220, 121, 141, 65, 14, 69, 45]"
49,20,4664,1229,7925,0,4318,346,"[6, 35, 113, 18, 13, 78, 42, 88, 67, 113, 15, 70, 67, 80, 113, 88, 57, 7, 0, 92, 109, 87, 10, 112, 73, 48, 40]"
50,20,4504,6421,6008,0,358,4146,"[1179, 690, 1047, 403, 651, 180, 209, 459, 1048, 290, 1037, 1136, 944, 469, 913, 773, 926, 247, 0, 475, 1300, 176, 328, 1276, 328, 396, 997]"
51,20,4480,2206,8282,0,287,4193,"[13, 878, 230, 820, 254, 738, 1223, 944, 599, 383, 836, 509, 576, 1373, 215, 367, 1036, 651, 0, 941, 46, 66, 205, 1222, 909, 1119, 512]"
52,20,4719,6378,6623,0,3661,1058,"[44, 228, 260, 254, 228, 262, 254, 8, 259, 25, 246, 71, 316, 78, 45, 163, 32, 155, 0, 6, 49, 90, 238, 200, 219, 35, 142]"
53,20,4936,6321,5238,0,3457,1479,"[62, 463, 322, 473, 161, 250, 445, 252, 218, 52, 434, 359, 324, 87, 138, 453, 242, 374, 0, 268, 345, 82, 90, 339, 450, 322, 409]"
54,20,3543,103,8678,0,2317,1226,"[207, 395, 162, 29, 293, 225, 274, 363, 41, 206, 82, 85, 296, 130, 263, 35, 386, 267, 0, 339, 308, 162, 60, 310, 193, 132, 48]"
55,20,4333,5930,7081,0,2170,2163,"[407, 538, 447, 319, 374, 505, 505, 421, 358, 310, 511, 129, 373, 244, 412, 234, 364, 586, 0, 332, 433, 59, 398, 162, 40, 271, 718]"
56,20,3054,626,9509,0,1599,1455,"[465, 176, 166, 384, 399, 381, 389, 183, 458, 9, 243, 118, 318, 86, 145, 274, 461, 69, 0, 382, 121, 363, 250, 401, 194, 64, 26]"
57,20,3063,6799,5773,0,440,2623,"[842, 529, 850, 762, 818, 424, 214, 635, 80, 224, 417, 828, 336, 514, 596, 857, 731, 497, 0, 165, 132, 497, 763, 279, 160, 566, 389]"
58,20,4209,722,9260,0,2859,1350,"[429, 166, 419, 21, 170, 101, 426, 16, 239, 344, 202, 8, 122, 207, 158, 286, 198, 128, 0, 331, 59, 324, 74, 46, 85, 438, 140]"
59,20,3083,5674,6669,0,2489,594,"[182, 40, 16, 187, 91, 159, 140, 161, 193, 191, 46, 17, 86, 89, 6, 143, 147, 16, 0, 101, 42, 118, 63, 27, 45, 62, 173]"
60,20,4712,6460,4921,0,538,4174,"[837, 65, 780, 1057, 1219, 1234, 557, 391, 425, 336, 409, 704, 556, 978, 1303, 1016, 1147, 61, 0, 988, 1001, 178, 589, 1061, 902, 576, 1079]"
61,20,4104,3720,5305,0,3229,875,"[254, 271, 159, 188, 131, 217, 200, 130, 137, 55, 52, 222, 13, 201, 151, 271, 123, 265, 0, 136, 79, 180, 76, 139, 90, 273, 109]"
62,20,4778,833,9250,0,2830,1948,"[367, 377, 313, 202, 471, 149, 58, 354, 97, 647, 5, 612, 20, 222, 18, 550, 292, 136, 0, 397, 173, 10, 608, 41, 594, 209, 165]"
63,20,4369,5975,7644,0,2635,1734,"[56, 163, 208, 52, 12, 404, 295, 118, 242, 9, 273, 101, 175, 505, 414, 257, 290, 183, 0, 171, 181, 147, 550, 156, 531, 145, 554]"
64,20,4038,6785,4897,0,1710,2328,"[134, 615, 222, 522, 666, 583, 635, 222, 751, 712, 124, 521, 79, 596, 463, 204, 451, 396, 0, 390, 46, 521, 291, 575, 446, 594, 546]"
65,20,3664,71,8490,0,179,3485,"[1080, 639, 1158, 374, 829, 84, 1062, 136, 265, 156, 181, 1028, 1010, 695, 786, 137, 433, 848, 0, 239, 621, 853, 1151, 97, 756, 332, 532]"
66,20,3999,6225,6264,0,452,3547,"[1101, 776, 358, 998, 496, 378, 1137, 1108, 4, 375, 79, 1013, 496, 132, 847, 209, 887, 301, 0, 476, 1141, 996, 405, 829, 650, 722, 916]"
67,20,3716,3190,6790,0,262,3454,"[1007, 200, 514, 283, 844, 472, 648, 1006, 793, 739, 275, 1112, 240, 476, 920, 369, 301, 943, 0, 600, 48, 861, 697, 399, 209, 238, 309]"
68,20,3810,1817,8783,0,2207,1603,"[353, 172, 199, 534, 494, 299, 128, 160, 487, 504, 425, 220, 533, 125, 271, 372, 446, 470, 0, 56, 33, 110, 532, 36, 363, 357, 167]"
69,20,4891,5104,8570,0,4842,49,"[6, 4, 6, 11, 15, 7, 1, 12, 9, 0, 6, 13, 4, 16, 12, 6, 12, 15, 0, 15, 13, 16, 7, 3, 16, 11, 8]"
70,20,4858,7078,6350,0,3916,942,"[309, 43, 117, 233, 265, 83, 132, 312, 251, 162, 99, 65, 134, 58, 10, 184, 12, 60, 0, 125, 173, 291, 211, 67, 145, 160, 271]"
71,20,3361,948,8763,0,3256,105,"[7, 14, 0, 0, 19, 17, 6, 33, 17, 35, 23, 1, 11, 6, 16, 4, 34, 35, 0, 7, 21, 34, 2, 30, 1, 24, 4]"
72,20,3522,5144,7141,0,155,3367,"[1067, 320, 304, 325, 1065, 558, 1084, 357, 1031, 3, 325, 223, 100, 446, 505, 273, 544, 203, 0, 625, 841, 972, 982, 1109, 1060, 245, 310]"
73,20,4152,5729,5564,0,1254,2898,"[869, 791, 420, 818, 48, 852, 669, 215, 518, 916, 91, 432, 537, 875, 652, 494, 215, 699, 0, 220, 947, 291, 709, 238, 31, 236, 495]"
74,20,4697,741,9520,0,2822,1875,"[128, 53, 484, 316, 274, 551, 557, 354, 186, 290, 231, 105, 293, 411, 215, 295, 204, 143, 0, 457, 352, 261, 312, 285, 373, 566, 142]"
75,20,3020,5750,6790,0,419,2601,"[224, 517, 715, 336, 4, 632, 653, 600, 424, 555, 298, 673, 674, 714, 67, 16, 779, 684, 0, 777, 463, 807, 574, 549, 107, 68, 809]"
76,20,3453,1106,9137,0,2133,1320,"[261, 205, 206, 397, 342, 92, 343, 365, 231, 414, 274, 76, 162, 125, 79, 379, 332, 103, 0, 13, 354, 80, 62, 77, 13, 185, 2]"
77,20,4040,6699,6478,0,1966,2074,"[663, 487, 280, 352, 594, 144, 180, 450, 23, 128, 230, 272, 467, 376, 361, 281, 291, 262, 0, 112, 226, 452, 196, 658, 239, 412, 167]"
78,20,3819,2701,7596,0,1920,1899,"[166, 530, 321, 447, 315, 34, 262, 53, 358, 457, 571, 86, 390, 284, 307, 544, 69, 321, 0, 403, 28, 569, 201, 609, 581, 183, 356]"
79,20,4482,7091,4987,0,2113,2369,"[91, 16, 40, 732, 477, 129, 244, 554, 593, 421, 639, 724, 738, 541, 561, 420, 244, 229, 0, 545, 350, 649, 752, 551, 787, 493, 505]"
80,20,4245,1774,7458,0,3231,1014,"[307, 138, 38, 89, 4, 320, 156, 328, 240, 312, 17, 209, 240, 217, 0, 17, 39, 119, 0, 140, 317, 304, 29, 11, 275, 142, 226]"
81,20,3711,6281,4888,0,1448,2263,"[502, 276, 18, 182, 381, 172, 625, 201, 103, 275, 424, 67, 541, 208, 559, 356, 750, 393, 0, 398, 142, 9, 42, 204, 754, 463, 96]"
82,20,4526,2454,6960,0,3767,759,"[242, 236, 92, 18, 196, 232, 33, 66, 216, 152, 106, 23, 64, 66, 241, 92, 177, 43, 0, 220, 123, 132, 210, 126, 109, 233, 23]"
83,20,4160,6186,4934,0,2524,1636,"[370, 223, 327, 445, 62, 139, 106, 502, 268, 72, 506, 260, 455, 41, 129, 357, 107, 237, 0, 250, 192, 493, 232, 484, 283, 144, 337]"
84,20,4173,2674,6433,0,2927,1246,"[161, 379, 284, 33, 34, 410, 123, 171, 297, 137, 332, 155, 251, 326, 331, 178, 96, 94, 0, 135, 265, 264, 207, 2, 212, 184, 332]"
85,20,4187,2943,7677,0,659,3528,"[1145, 443, 1119, 793, 1061, 400, 450, 873, 245, 732, 271, 776, 741, 286, 1010, 1045, 73, 663, 0, 600, 866, 342, 1012, 792, 788, 602, 823]"
86,20,4996,7362,5311,0,4823,173,"[55, 8, 47, 52, 54, 45, 9, 28, 29, 13, 7, 31, 29, 7, 5, 16, 4, 6, 0, 6, 56, 8, 13, 10, 37, 13, 2]"
87,20,3482,1690,7103,0,542,2940,"[294, 659, 126, 517, 897, 548, 640, 902, 947, 211, 428, 692, 361, 793, 78, 210, 551, 332, 0, 55, 208, 12, 971, 619, 642, 535, 798]"
88,20,3126,2902,7327,0,2919,207,"[30, 0, 58, 15, 35, 32, 62, 48, 66, 62, 6, 19, 59, 33, 52, 24, 38, 9, 0, 42, 41, 18, 53, 64, 10, 16, 69]"
89,20,3115,119,10000,323,1891,1224,"[110, 223, 323, 216, 22, 249, 113, 139, 141, 145, 112, 377, 84, 116, 172, 255, 306, 378, 0, 232, 3, 96, 302, 277, 179, 3, 32]"
90,20,3080,6461,6619,0,584,2496,"[620, 354, 244, 159, 579, 760, 1, 699, 363, 586, 110, 285, 686, 290, 289, 397, 80, 569, 0, 646, 379, 239, 484, 218, 344, 256, 683]"
91,20,4923,7032,4510,0,512,4411,"[207, 1321, 281, 844, 342, 571, 237, 18, 752, 29, 1094, 760, 445, 209, 730, 1237, 832, 103, 0, 1080, 440, 1077, 530, 568, 1202, 200, 12]"
92,20,4208,4065,4653,0,4200,8,"[0, 2, 1, 2, 2, 2, 0, 2, 0, 1, 1, 0, 2, 2, 2, 0, 0, 1, 0, 2, 2, 2, 1, 1, 1, 0, 0]"
93,20,4900,1482,8071,0,4480,420,"[122, 55, 121, 23, 130, 49, 80, 46, 22, 52, 50, 8, 139, 102, 6, 105, 4, 96, 0, 132, 117, 90, 27, 74, 132, 65, 120]"
94,20,4211,5321,6961,0,3258,953,"[89, 313, 154, 245, 142, 269, 137, 175, 66, 49, 144, 176, 78, 235, 41, 57, 26, 223, 0, 17, 190, 69, 261, 233, 115, 109, 144]"
95,20,4441,7191,4211,0,1975,2466,"[143, 439, 477, 460, 212, 659, 566, 801, 444, 369, 260, 696, 796, 602, 684, 208, 451, 33, 0, 770, 101, 132, 370, 509, 682, 100, 646]"
96,20,3735,1854,6092,0,1382,2353,"[612, 775, 140, 657, 439, 10, 111, 694, 551, 280, 653, 440, 320, 480, 220, 579, 453, 376, 0, 763, 636, 82, 727, 556, 395, 517, 574]"
97,20,3748,1717,8123,0,1923,1825,"[583, 568, 580, 447, 13, 46, 333, 264, 374, 88, 429, 323, 91, 147, 291, 497, 481, 505, 0, 98, 487, 339, 583, 36, 259, 380, 353]"
98,20,3165,6564,4724,0,2676,489,"[134, 146, 37, 141, 33, 106, 45, 99, 131, 52, 16, 27, 98, 108, 43, 115, 49, 15, 0, 161, 3, 3, 46, 131, 74, 23, 10]"
99,20,3814,1317,7221,0,1727,2087,"[209, 630, 15, 404, 91, 543, 461, 593, 553, 83, 127, 475, 598, 241, 497, 71, 318, 188, 0, 62, 178, 149, 553, 535, 555, 644, 174]"
100,20,3664,3172,7713,0,342,3322,"[22, 989, 230, 875, 775, 49, 348, 152, 709, 1032, 430, 652, 844, 473, 719, 46, 731, 549, 0, 835, 695, 280, 720, 747, 125, 1062, 264]"
101,20,4390,5224,6879,0,1514,2876,"[409, 435, 145, 158, 417, 746, 889, 24, 585, 249, 937, 540, 355, 402, 765, 400, 724, 570, 0, 372, 748, 75, 359, 260, 241, 193, 500]"
102,20,3311,1757,8433,0,521,2790,"[231, 910, 417, 923, 370, 94, 40, 373, 497, 912, 355, 718, 700, 500, 583, 805, 569, 754, 0, 628, 185, 447, 108, 692, 625, 893, 503]"
103,20,5000,6247,7186,0,504,4496,"[1321, 318, 969, 1347, 1466, 1195, 1147, 287, 194, 752, 1162, 441, 867, 419, 648, 1193, 831, 295, 0, 917, 1212, 640, 1050, 815, 1336, 1252, 1383]"
104,20,4354,6707,4833,0,2692,1662,"[15, 218, 88, 114, 225, 169, 497, 534, 121, 349, 90, 315, 348, 294, 103, 106, 436, 275, 0, 450, 31, 287, 309, 352, 512, 16, 260]"
105,20,3614,1697,6750,0,3373,241,"[23, 66, 30, 52, 74, 77, 1, 13, 1, 37, 72, 53, 54, 33, 29, 29, 38, 80, 0, 25, 4, 34, 17, 22, 52, 8, 38]"
106,20,3938,2978,7710,0,1325,2613,"[757, 848, 296, 83, 721, 518, 148, 246, 821, 535, 84, 489, 128, 596, 666, 577, 423, 803, 0, 163, 46, 761, 771, 204, 259, 181, 224]"
107,20,4375,6576,5509,0,1140,3235,"[252, 372, 581, 529, 541, 920, 231, 37, 251, 156, 964, 205, 542, 1031, 57, 839, 609, 99, 0, 994, 106, 148, 772, 867, 1044, 399, 990]"
108,20,4891,3645,6755,0,3519,1372,"[401, 53, 273, 358, 28, 158, 24, 192, 408, 125, 325, 44, 296, 130, 405, 406, 285, 211, 0, 202, 359, 156, 59, 161, 357, 283, 285]"
109,20,4364,5228,5891,0,2895,1469,"[335, 152, 85, 103, 360, 441, 455, 467, 222, 171, 313, 5, 72, 346, 480, 123, 344, 27, 0, 12, 271, 56, 405, 244, 334, 77, 461]"
110,20,3994,2523,7362,0,2599,1395,"[229, 97, 79, 307, 288, 451, 345, 4, 290, 190, 452, 105, 453, 28, 132, 63, 318, 278, 0, 457, 456, 10, 337, 146, 135, 235, 61]"
111,20,4198,5965,5595,0,1447,2751,"[729, 752, 716, 626, 281, 273, 739, 321, 340, 753, 700, 434, 726, 559, 652, 325, 847, 729, 0, 808, 569, 373, 830, 907, 772, 79, 594]"
112,20,3709,1803,7501,0,2730,979,"[133, 237, 182, 206, 79, 37, 186, 88, 143, 289, 278, 261, 252, 58, 322, 158, 59, 114, 0, 299, 158, 305, 122, 143, 108, 283, 13]"
113,20,4411,5892,6020,0,4156,255,"[34, 45, 5, 44, 10, 17, 28, 45, 1, 29, 25, 54, 3, 49, 54, 46, 9, 22, 0, 44, 5, 11, 78, 25, 1, 42, 82]"
114,20,3957,2860,7117,0,1509,2448,"[257, 684, 68, 399, 721, 739, 557, 708, 225, 401, 351, 178, 133, 521, 708, 462, 606, 126, 0, 750, 569, 398, 255, 728, 615, 335, 617]"
115,20,3357,1216,9258,0,537,2820,"[503, 155, 397, 355, 140, 117, 120, 119, 278, 503, 614, 613, 861, 518, 851, 576, 419, 257, 0, 466, 505, 672, 173, 318, 211, 315, 224]"
116,20,4907,6502,7663,0,1482,3425,"[815, 189, 602, 203, 504, 402, 379, 333, 1108, 220, 726, 1018, 911, 69, 934, 463, 137, 1080, 0, 735, 336, 749, 38, 642, 1115, 754, 367]"
117,20,3182,2553,8292,0,2229,953,"[146, 7, 138, 262, 62, 122, 11, 69, 284, 315, 185, 10, 207, 312, 213, 289, 192, 244, 0, 143, 76, 22, 284, 142, 130, 64, 11]"
118,20,4527,5244,7575,0,2031,2496,"[745, 116, 158, 480, 819, 346, 305, 653, 388, 203, 408, 87, 568, 673, 581, 1, 348, 508, 0, 702, 799, 93, 618, 135, 698, 93, 109]"
119,20,4952,7138,5389,0,1797,3155,"[516, 444, 474, 839, 477, 302, 214, 1050, 274, 228, 534, 957, 995, 13, 94, 390, 73, 964, 0, 267, 795, 618, 211, 931, 929, 181, 97]"
120,20,3388,334,8443,0,420,2968,"[693, 171, 237, 529, 937, 793, 704, 622, 769, 174, 277, 597, 775, 358, 754, 331, 581, 18, 0, 698, 661, 101, 758, 107, 141, 669, 640]"
121,20,3378,7043,4778,0,1248,2130,"[597, 706, 355, 678, 286, 10, 523, 565, 178, 696, 64, 231, 332, 236, 33, 216, 636, 110, 0, 147, 448, 384, 467, 350, 659, 278, 556]"
122,20,3101,1551,6328,0,1849,1252,"[127, 241, 87, 98, 227, 285, 407, 14, 147, 382, 395, 21, 65, 358, 297, 57, 1, 402, 0, 78, 88, 76, 73, 85, 411, 292, 64]"
123,20,4410,1057,9681,0,1226,3184,"[292, 239, 1017, 99, 7, 631, 726, 112, 528, 192, 670, 1001, 478, 57, 530, 53, 715, 682, 0, 526, 988, 421, 44, 835, 523, 478, 125]"
124,20,4003,6573,7111,0,2877,1126,"[356, 224, 106, 116, 148, 62, 0, 70, 42, 31, 73, 58, 136, 252, 262, 268, 286, 111, 0, 364, 129, 145, 330, 103, 279, 361, 323]"
125,20,4350,6550,4911,0,3105,1245,"[392, 66, 129, 229, 402, 286, 30, 64, 335, 351, 331, 360, 44, 366, 51, 130, 105, 18, 0, 410, 243, 13, 237, 306, 24, 303, 119]"
126,20,3415,669,7657,0,2888,527,"[55, 84, 30, 78, 131, 23, 112, 123, 128, 97, 16, 26, 62, 106, 50, 140, 160, 19, 0, 92, 88, 28, 89, 74, 65, 65, 8]"
127,20,4227,7320,4564,0,3901,326,"[41, 16, 31, 9, 42, 92, 80, 75, 8, 13, 14, 38, 26, 80, 11, 45, 79, 77, 0, 71, 49, 93, 12, 1, 42, 57, 26]"
128,20,3564,124,8004,0,3149,415,"[134, 122, 65, 27, 66, 49, 69, 38, 108, 131, 53, 39, 5, 102, 34, 24, 114, 40, 0, 131, 49, 97, 35, 3, 27, 80, 22]"
129,20,3370,6937,4437,0,2848,522,"[114, 135, 29, 68, 19, 52, 51, 3, 100, 90, 150, 30, 111, 145, 54, 19, 33, 23, 0, 34, 34, 125, 29, 106, 16, 49, 25]"
130,20,4401,5,8833,0,3137,1264,"[189, 96, 198, 324, 421, 54, 220, 281, 406, 134, 264, 356, 15, 352, 100, 145, 360, 109, 0, 152, 175, 56, 197, 340, 270, 287, 63]"
131,20,3450,6078,6205,0,833,2617,"[663, 247, 834, 89, 29, 193, 786, 402, 744, 409, 188, 249, 526, 443, 653, 317, 869, 808, 0, 510, 343, 703, 745, 837, 769, 546, 746]"
132,20,4930,7134,4001,0,1137,3793,"[943, 1141, 268, 442, 775, 1208, 886, 826, 1252, 1075, 1038, 820, 368, 812, 524, 894, 235, 626, 0, 163, 1122, 637, 873, 1232, 679, 1086, 1110]"
133,20,4389,1415,6975,0,3049,1340,"[405, 261, 128, 83, 272, 296, 14, 185, 25, 101, 26, 213, 296, 153, 282, 46, 273, 242, 0, 304, 98, 189, 212, 103, 348, 268, 77]"
134,20,3523,3293,7205,0,2713,810,"[163, 238, 130, 200, 188, 134, 263, 84, 141, 145, 13, 194, 49, 205, 157, 214, 260, 66, 0, 0, 223, 176, 17, 59, 125, 235, 198]"
135,20,4597,7368,4434,0,1002,3595,"[418, 523, 899, 134, 941, 683, 964, 69, 441, 1021, 326, 981, 843, 295, 616, 554, 1030, 1, 0, 937, 311, 1147, 865, 722, 39, 1137, 360]"
136,20,3402,145,7691,0,775,2627,"[735, 815, 139, 121, 284, 855, 790, 716, 647, 98, 602, 159, 810, 839, 241, 281, 217, 19, 0, 836, 139, 146, 230, 513, 186, 458, 194]"
137,20,3577,7329,3939,0,2932,645,"[186, 169, 141, 101, 196, 181, 5, 167, 143, 138, 197, 194, 18, 19, 181, 2, 49, 151, 0, 192, 161, 185, 80, 29, 141, 67, 154]"
138,20,3530,729,6740,0,3159,371,"[107, 109, 90, 118, 118, 68, 37, 28, 46, 19, 41, 105, 110, 31, 63, 15, 70, 110, 0, 33, 64, 89, 121, 86, 22, 22, 108]"
139,20,4938,6067,5611,0,4300,638,"[112, 116, 40, 18, 192, 208, 58, 109, 9, 129, 79, 156, 74, 121, 158, 72, 86, 60, 0, 12, 49, 83, 58, 43, 99, 79, 36]"
140,20,3594,338,8867,0,46,3548,"[239, 43, 939, 206, 112, 581, 985, 599, 280, 286, 1148, 459, 1075, 635, 344, 11, 499, 457, 0, 980, 468, 1015, 458, 782, 353, 1173, 857]"
141,20,3660,6839,5688,0,102,3558,"[675, 941, 704, 1148, 739, 225, 655, 495, 666, 3, 1011, 131, 497, 273, 586, 868, 261, 364, 0, 181, 885, 544, 137, 915, 828, 925, 1073]"
142,20,3077,1833,6932,0,2380,697,"[183, 105, 49, 90, 208, 178, 208, 168, 143, 10, 208, 149, 40, 68, 214, 73, 148, 92, 0, 176, 216, 31, 46, 98, 119, 66, 132]"
143,20,4816,6824,4924,0,4093,723,"[23, 12, 23, 109, 221, 101, 19, 16, 214, 25, 34, 161, 28, 217, 103, 103, 187, 12, 0, 125, 224, 116, 239, 32, 75, 116, 145]"
144,20,3542,1660,6806,0,827,2715,"[134, 328, 333, 396, 348, 686, 32, 10, 708, 775, 582, 858, 337, 765, 770, 484, 741, 702, 0, 291, 610, 622, 892, 9, 743, 562, 286]"
145,20,4986,7065,4727,0,1099,3887,"[511, 593, 1036, 255, 676, 718, 876, 1035, 530, 924, 162, 327, 976, 274, 1238, 845, 1175, 814, 0, 1286, 490, 185, 1165, 997, 857, 0, 744]"
146,20,4156,1667,7216,0,4146,10,"[3, 0, 1, 3, 0, 0, 1, 0, 2, 1, 1, 3, 1, 3, 0, 0, 1, 0, 0, 0, 2, 3, 3, 3, 1, 2, 0]"
147,20,3479,1555,9140,0,2154,1325,"[377, 199, 112, 428, 185, 19, 245, 54, 244, 28, 22, 268, 109, 178, 55, 361, 337, 295, 0, 148, 127, 27, 301, 119, 109, 258, 336]"
148,20,3159,7108,5191,0,835,2324,"[103, 145, 405, 281, 353, 154, 297, 165, 710, 185, 84, 588, 503, 71, 84, 18, 581, 700, 0, 437, 459, 569, 579, 64, 446, 720, 636]"
149,20,3858,574,8475,0,144,3714,"[196, 72, 479, 865, 1173, 468, 437, 9, 153, 690, 474, 581, 440, 27, 603, 739, 3, 51, 0, 545, 212, 637, 766, 1079, 467, 959, 860]"
150,20,4462,6366,6571,0,4358,104,"[8, 6, 17, 19, 12, 31, 32, 31, 15, 28, 9, 13, 21, 9, 12, 27, 11, 8, 0, 34, 7, 11, 27, 18, 30, 31, 10]"
151,20,4012,2038,8545,0,2543,1469,"[38, 45, 449, 418, 83, 173, 81, 374, 462, 14, 137, 378, 477, 410, 202, 160, 51, 306, 0, 463, 337, 222, 157, 15, 103, 412, 121]"
152,20,3139,7359,4325,0,642,2497,"[253, 411, 380, 229, 547, 574, 706, 296, 629, 491, 368, 132, 171, 511, 38, 811, 257, 687, 0, 506, 608, 42, 764, 486, 58, 565, 405]"
153,20,3936,2489,5772,0,158,3778,"[320, 642, 382, 10, 758, 156, 235, 749, 1235, 1062, 139, 993, 952, 902, 871, 595, 1255, 1210, 0, 22, 1190, 175, 1069, 1188, 67, 1169, 910]"
154,20,3828,2447,7153,0,272,3556,"[969, 925, 985, 1138, 90, 916, 1172, 305, 634, 349, 372, 975, 877, 989, 970, 171, 1111, 212, 0, 602, 1073, 932, 472, 371, 428, 563, 153]"
155,20,4844,6342,5655,0,728,4116,"[579, 1001, 677, 462, 263, 525, 480, 1136, 146, 237, 804, 413, 1127, 1085, 126, 832, 1017, 654, 0, 1138, 579, 1086, 1118, 160, 929, 381, 135]"
156,20,3254,1899,7010,0,1618,1636,"[477, 323, 5, 14, 134, 105, 111, 214, 214, 236, 466, 514, 474, 376, 41, 60, 377, 514, 0, 21, 398, 105, 373, 345, 237, 461, 133]"
157,20,4001,6669,4342,0,3416,585,"[35, 153, 17, 138, 128, 14, 145, 34, 158, 64, 28, 194, 24, 90, 26, 2, 118, 174, 0, 172, 38, 191, 169, 85, 97, 140, 75]"
158,20,3231,3014,4559,0,1687,1544,"[138, 424, 469, 430, 128, 375, 149, 249, 317, 180, 147, 156, 489, 359, 498, 351, 371, 262, 0, 352, 39, 234, 318, 27, 83, 134, 31]"
159,20,3222,1524,6257,0,3107,115,"[29, 18, 31, 4, 7, 21, 9, 6, 34, 12, 7, 30, 27, 29, 8, 38, 33, 14, 0, 28, 19, 19, 15, 23, 1, 4, 22]"
160,20,3604,1373,8488,0,2581,1023,"[274, 138, 333, 24, 330, 98, 73, 302, 300, 227, 294, 110, 62, 239, 337, 124, 56, 33, 0, 141, 292, 54, 150, 248, 322, 317, 316]"
161,20,4187,5722,6953,0,1765,2422,"[685, 89, 336, 449, 78, 1, 17, 43, 346, 514, 761, 767, 800, 34, 504, 306, 137, 337, 0, 176, 807, 343, 747, 320, 143, 706, 463]"
162,20,3441,731,9663,0,893,2548,"[846, 452, 333, 712, 847, 131, 772, 214, 220, 519, 92, 519, 211, 68, 302, 295, 604, 576, 0, 758, 389, 87, 105, 414, 232, 8, 443]"
163,20,3023,6963,5723,0,2646,377,"[23, 37, 94, 85, 47, 58, 83, 2, 123, 88, 51, 4, 104, 41, 66, 119, 88, 38, 0, 25, 29, 118, 44, 89, 96, 5, 37]"
164,20,3708,911,8520,0,741,2967,"[246, 15, 83, 325, 362, 654, 143, 478, 950, 398, 964, 15, 486, 429, 36, 514, 140, 745, 0, 0, 309, 882, 481, 911, 748, 802, 549]"
165,20,3079,6537,5062,0,2540,539,"[127, 59, 82, 78, 2, 146, 86, 25, 56, 130, 137, 7, 11, 148, 59, 94, 107, 114, 0, 26, 22, 64, 34, 41, 85, 18, 56]"
166,20,4289,2295,7056,0,1858,2431,"[808, 538, 157, 191, 256, 84, 366, 732, 359, 527, 345, 205, 300, 510, 547, 114, 486, 1, 0, 549, 201, 372, 700, 370, 362, 255, 775]"
167,20,4388,6160,5284,0,2072,2316,"[513, 521, 136, 508, 761, 204, 677, 565, 733, 3, 438, 738, 654, 589, 72, 595, 61, 3, 0, 261, 143, 520, 477, 601, 448, 162, 666]"
168,20,3425,1154,7555,0,241,3184,"[923, 613, 766, 18, 162, 441, 617, 98, 36, 718, 534, 689, 186, 250, 218, 887, 911, 863, 0, 712, 1012, 452, 237, 305, 413, 179, 1054]"
169,20,4331,7361,4525,0,1767,2564,"[288, 535, 398, 829, 687, 456, 307, 97, 731, 328, 575, 736, 811, 205, 166, 661, 723, 83, 0, 530, 801, 414, 683, 406, 136, 89, 818]"
170,20,3561,2459,5627,0,1676,1885,"[128, 207, 514, 226, 102, 471, 536, 256, 254, 159, 105, 16, 276, 326, 621, 484, 110, 411, 0, 408, 154, 516, 304, 262, 189, 169, 528]"
171,20,3571,1870,7328,0,1197,2374,"[168, 579, 620, 770, 709, 306, 134, 613, 12, 37, 178, 682, 451, 116, 579, 356, 20, 97, 0, 521, 47, 330, 674, 163, 50, 544, 367]"
172,20,4022,5140,6210,0,1847,2175,"[303, 149, 8, 382, 550, 93, 196, 135, 620, 40, 386, 561, 488, 58, 663, 8, 58, 578, 0, 618, 350, 621, 76, 169, 553, 716, 720]"
173,20,3461,610,9061,0,471,2990,"[781, 909, 0, 269, 656, 572, 685, 414, 865, 43, 358, 875, 928, 528, 918, 784, 103, 110, 0, 253, 950, 79, 755, 334, 194, 359, 986]"
174,20,4480,5147,8394,0,354,4126,"[945, 849, 145, 31, 918, 719, 1261, 845, 323, 1262, 106, 161, 404, 1140, 542, 1293, 1095, 411, 0, 407, 906, 77, 865, 48, 528, 413, 1270]"
175,20,4828,6345,6877,0,876,3952,"[335, 131, 1044, 184, 1125, 869, 1013, 1012, 1273, 871, 308, 667, 919, 243, 150, 876, 404, 13, 0, 539, 883, 203, 1238, 43, 186, 1245, 702]"
176,20,3513,720,9670,0,599,2914,"[719, 113, 113, 533, 491, 758, 563, 908, 720, 877, 455, 200, 174, 646, 685, 348, 918, 255, 0, 221, 731, 184, 113, 323, 787, 797, 206]"
177,20,4046,6125,7591,0,2836,1210,"[77, 335, 65, 301, 44, 34, 115, 141, 284, 46, 239, 323, 178, 249, 336, 280, 208, 89, 0, 231, 356, 111, 107, 207, 367, 83, 149]"
178,20,4860,6743,5708,0,1916,2944,"[33, 266, 273, 782, 730, 307, 463, 767, 484, 156, 280, 966, 913, 637, 480, 349, 939, 103, 0, 641, 503, 415, 663, 103, 762, 722, 457]"
179,20,3330,921,8117,0,938,2392,"[481, 632, 294, 326, 141, 403, 46, 408, 538, 117, 571, 354, 527, 688, 93, 629, 610, 213, 0, 708, 313, 701, 252, 667, 419, 380, 759]"
180,20,4862,5318,7661,0,811,4051,"[1158, 284, 1186, 1281, 787, 492, 77, 1194, 1342, 49, 1318, 417, 781, 183, 1185, 1082, 917, 385, 0, 850, 106, 590, 91, 980, 868, 325, 344]"
181,20,3383,5211,5833,0,260,3123,"[9, 875, 619, 288, 808, 707, 50, 433, 606, 125, 260, 261, 672, 842, 527, 565, 654, 100, 0, 844, 147, 493, 524, 118, 778, 608, 904]"
182,20,3990,416,9407,0,911,3079,"[601, 112, 313, 707, 34, 895, 136, 102, 406, 206, 103, 751, 948, 936, 680, 339, 49, 569, 0, 731, 213, 586, 454, 122, 325, 1025, 331]"
183,20,4808,6134,8081,0,968,3840,"[1225, 108, 97, 112, 4, 888, 941, 1014, 626, 784, 671, 730, 369, 1250, 1077, 989, 1239, 609, 0, 200, 1161, 737, 771, 1068, 912, 1098, 271]"
184,20,4522,6518,6085,0,4356,166,"[48, 46, 35, 52, 55, 28, 47, 28, 25, 16, 31, 12, 18, 52, 24, 45, 29, 27, 0, 52, 40, 51, 1, 15, 13, 40, 22]"
185,20,4266,4032,6319,0,3012,1254,"[262, 196, 182, 58, 130, 54, 115, 235, 44, 87, 73, 222, 201, 369, 7, 403, 342, 140, 0, 92, 85, 51, 388, 167, 25, 14, 8]"
186,20,3766,2318,7767,0,3744,22,"[1, 4, 0, 1, 7, 4, 7, 4, 3, 5, 2, 0, 4, 2, 5, 5, 2, 3, 0, 7, 4, 1, 1, 1, 6, 4, 5]"
187,20,3711,7207,4271,0,2920,791,"[146, 10, 7, 58, 244, 151, 11, 124, 27, 225, 188, 67, 207, 239, 121, 103, 82, 255, 0, 65, 214, 164, 5, 40, 66, 256, 69]"
188,20,4905,3944,5232,0,3778,1127,"[124, 160, 288, 320, 237, 97, 67, 193, 345, 188, 230, 131, 204, 361, 109, 217, 297, 17, 0, 116, 172, 137, 100, 140, 335, 123, 217]"
189,20,4233,1170,8295,0,958,3275,"[87, 69, 662, 849, 874, 868, 489, 813, 519, 6, 54, 254, 508, 132, 614, 506, 377, 387, 0, 55, 1060, 206, 516, 427, 33, 487, 967]"
190,20,4396,6447,6244,0,267,4129,"[1050, 114, 712, 312, 950, 59, 140, 857, 859, 603, 1082, 713, 37, 796, 1144, 1005, 536, 1316, 0, 894, 339, 928, 643, 545, 99, 1265, 1120]"
191,20,4422,3410,7256,0,4034,388,"[101, 76, 85, 99, 10, 69, 55, 118, 19, 107, 56, 128, 119, 93, 72, 17, 113, 99, 0, 15, 80, 78, 119, 52, 67, 87, 86]"
192,20,4029,6026,5259,0,2259,1770,"[425, 239, 499, 286, 236, 135, 347, 585, 298, 482, 275, 112, 162, 511, 351, 227, 356, 285, 0, 61, 123, 119, 31, 426, 178, 286, 120]"
193,20,4679,202,9736,0,935,3744,"[325, 690, 988, 29, 775, 363, 981, 14, 311, 14, 411, 503, 569, 772, 964, 174, 223, 1115, 0, 242, 964, 823, 433, 841, 860, 993, 340]"
194,20,4557,5126,9167,0,2962,1595,"[95, 305, 506, 247, 408, 109, 503, 134, 163, 164, 128, 132, 176, 61, 87, 391, 299, 118, 0, 510, 294, 89, 251, 356, 398, 269, 87]"
195,20,4860,6472,7555,0,2160,2700,"[53, 717, 435, 338, 279, 82, 462, 480, 208, 521, 687, 459, 633, 690, 600, 160, 274, 389, 0, 252, 337, 403, 390, 264, 733, 279, 892]"
196,20,3641,6695,4501,0,2896,745,"[7, 30, 89, 124, 185, 17, 245, 181, 6, 142, 6, 179, 98, 190, 28, 95, 71, 41, 0, 29, 194, 174, 220, 191, 144, 110, 77]"
197,20,4342,2467,6376,0,761,3581,"[629, 938, 929, 41, 147, 688, 798, 580, 118, 756, 218, 1118, 210, 450, 788, 1126, 509, 859, 0, 359, 103, 1134, 770, 279, 557, 311, 1149]"
198,20,4010,1979,8407,0,1856,2154,"[569, 617, 22, 384, 491, 400, 245, 98, 633, 468, 643, 81, 40, 336, 475, 163, 273, 528, 0, 29, 407, 3, 568, 700, 688, 534, 399]"
199,20,3950,5150,7207,0,2787,1163,"[30, 131, 170, 49, 4, 73, 334, 351, 279, 46, 320, 55, 37, 331, 229, 238, 209, 12, 0, 238, 208, 3, 285, 238, 221, 205, 108]"
200,20,4971,5299,6879,0,2042,2929,"[721, 194, 657, 448, 894, 799, 845, 328, 49, 884, 144, 370, 871, 79, 361, 106, 777, 392, 0, 337, 208, 145, 64, 89, 527, 512, 951]"
201,20,4041,2545,8375,0,2143,1898,"[1, 555, 274, 616, 19, 325, 31, 10, 55, 388, 395, 496, 280, 307, 570, 11, 2, 567, 0, 78, 115, 132, 353, 237, 603, 138, 197]"
202,20,4928,7255,6048,0,1185,3743,"[811, 1170, 793, 702, 137, 998, 1193, 542, 965, 827, 152, 1067, 500, 327, 821, 702, 646, 197, 0, 624, 1001, 695, 1065, 631, 849, 571, 469]"
203,20,3447,2097,7398,0,159,3288,"[906, 95, 959, 862, 697, 156, 935, 445, 577, 847, 763, 574, 277, 1007, 843, 17, 494, 606, 0, 393, 156, 137, 16, 630, 342, 598, 839]"
204,20,4429,5864,5963,0,3588,841,"[65, 253, 262, 40, 199, 48, 165, 3, 233, 84, 180, 206, 52, 105, 83, 247, 210, 213, 0, 53, 141, 110, 0, 10, 167, 147, 40]"
205,20,3513,2773,6703,0,109,3404,"[1024, 1014, 498, 167, 815, 1072, 11, 537, 483, 1096, 511, 1013, 626, 1005, 986, 668, 141, 1033, 0, 2, 606, 889, 1109, 355, 72, 772, 951]"
206,20,4275,454,10000,524,1430,2845,"[212, 937, 581, 821, 278, 506, 400, 439, 107, 48, 415, 202, 783, 937, 448, 34, 87, 368, 0, 865, 568, 704, 405, 155, 304, 604, 273]"
207,20,4673,6015,8658,0,2132,2541,"[136, 435, 33, 257, 486, 479, 599, 385, 386, 373, 759, 145, 538, 707, 30, 584, 338, 308, 0, 302, 582, 828, 768, 809, 115, 785, 591]"
208,20,4132,5949,6841,0,1696,2436,"[807, 220, 97, 23, 808, 242, 611, 169, 273, 242, 523, 700, 562, 9, 176, 297, 499, 305, 0, 614, 805, 290, 688, 346, 736, 479, 806]"
209,20,3189,1593,8437,0,218,2971,"[849, 771, 457, 913, 780, 742, 315, 850, 187, 652, 316, 626, 272, 146, 274, 112, 95, 87, 0, 278, 427, 728, 746, 583, 857, 715, 971]"
210,20,3577,7420,4594,0,3520,57,"[0, 15, 14, 7, 12, 9, 6, 10, 14, 7, 0, 15, 17, 15, 19, 18, 3, 1, 0, 19, 15, 11, 5, 18, 0, 8, 19]"
211,20,4321,963,7952,0,1982,2339,"[439, 410, 197, 25, 71, 518, 447, 748, 392, 288, 254, 247, 623, 50, 302, 120, 490, 395, 0, 396, 462, 607, 198, 226, 567, 431, 441]"
212,20,4849,6357,6444,0,1304,3545,"[777, 251, 606, 429, 57, 105, 890, 520, 432, 488, 527, 161, 354, 145, 1116, 496, 631, 478, 0, 1094, 389, 1107, 964, 248, 415, 545, 1113]"
213,20,4050,3856,6638,0,185,3865,"[736, 13, 504, 278, 181, 16, 285, 703, 130, 1220, 611, 841, 1224, 43, 35, 1121, 222, 323, 0, 1163, 618, 308, 806, 848, 611, 355, 1027]"
214,20,3647,3115,7170,0,2545,1102,"[38, 356, 126, 257, 267, 23, 3, 259, 222, 6, 169, 253, 178, 302, 151, 165, 90, 304, 0, 104, 150, 188, 291, 333, 352, 178, 118]"
215,20,4764,5721,6213,0,540,4224,"[491, 571, 610, 1263, 798, 1228, 1013, 867, 773, 244, 320, 573, 1054, 389, 128, 1391, 929, 21, 0, 861, 1163, 564, 282, 399, 1235, 1106, 609]"
216,20,4333,3135,7411,0,1879,2454,"[677, 297, 794, 727, 368, 638, 370, 697, 639, 640, 769, 256, 247, 643, 406, 20, 149, 97, 0, 238, 536, 48, 533, 691, 787, 88, 523]"
217,20,3091,265,10000,237,2962,129,"[36, 5, 41, 37, 34, 10, 11, 26, 6, 11, 29, 12, 43, 21, 2, 20, 3, 28, 0, 39, 32, 14, 30, 23, 20, 27, 22]"
218,20,3860,5650,8210,0,2701,1159,"[291, 358, 246, 35, 314, 264, 8, 333, 31, 185, 238, 257, 130, 48, 336, 244, 27, 384, 0, 252, 215, 99, 151, 256, 275, 172, 209]"
219,20,3253,6431,5032,0,2168,1085,"[201, 163, 112, 214, 346, 80, 165, 81, 210, 309, 145, 195, 359, 297, 71, 47, 131, 300, 0, 277, 14, 198, 190, 176, 349, 176, 30]"
220,20,3283,422,7893,0,2496,787,"[20, 130, 238, 20, 33, 50, 27, 259, 184, 199, 204, 159, 34, 29, 248, 163, 158, 72, 0, 239, 234, 223, 137, 42, 126, 139, 92]"
221,20,3955,6789,5059,0,185,3770,"[323, 405, 1028, 1201, 265, 34, 1064, 894, 1193, 463, 21, 960, 750, 65, 421, 231, 239, 1206, 0, 1051, 518, 428, 853, 837, 769, 462, 999]"
222,20,4084,3108,6035,0,3221,863,"[266, 129, 136, 263, 62, 93, 101, 213, 10, 192, 84, 235, 117, 264, 153, 183, 34, 259, 0, 77, 172, 13, 100, 186, 5, 103, 135]"
223,20,4609,1327,9317,0,371,4238,"[37, 665, 887, 448, 418, 36, 413, 1019, 908, 1303, 1145, 223, 688, 1308, 403, 295, 824, 599, 0, 329, 893, 472, 1306, 205, 1006, 942, 477]"
224,20,3193,6283,6227,0,3041,152,"[8, 26, 9, 35, 45, 39, 47, 33, 40, 28, 39, 4, 33, 17, 32, 0, 38, 9, 0, 31, 17, 8, 39, 22, 0, 21, 2]"
225,20,3611,795,9043,0,2132,1479,"[467, 424, 354, 152, 360, 331, 59, 190, 466, 20, 241, 65, 484, 99, 121, 344, 158, 235, 0, 333, 342, 58, 435, 55, 182, 379, 144]"
226,20,3870,7043,5870,0,2019,1851,"[344, 252, 372, 520, 451, 517, 59, 592, 163, 132, 187, 380, 82, 593, 215, 142, 244, 441, 0, 515, 593, 271, 161, 210, 34, 443, 33]"
227,20,4291,2803,7358,0,3716,575,"[33, 182, 6, 45, 46, 161, 36, 119, 26, 42, 54, 85, 54, 106, 181, 43, 5, 77, 0, 125, 119, 164, 133, 153, 149, 124, 103]"
228,20,4471,5029,6800,0,1843,2628,"[642, 45, 152, 109, 100, 78, 577, 223, 487, 550, 76, 428, 811, 474, 104, 528, 456, 596, 0, 374, 780, 354, 109, 20, 148, 779, 851]"
229,20,3181,2663,7318,0,3093,88,"[11, 14, 29, 24, 11, 13, 8, 23, 18, 19, 4, 24, 26, 18, 17, 11, 9, 17, 0, 27, 7, 25, 7, 7, 1, 18, 26]"
230,20,4530,5018,6830,0,4438,92,"[29, 22, 21, 2, 29, 30, 18, 6, 17, 26, 29, 26, 9, 10, 3, 9, 30, 12, 0, 22, 0, 1, 8, 29, 7, 17, 27]"
231,20,4859,5922,5767,0,243,4616,"[594, 1099, 706, 754, 1148, 1294, 13, 953, 690, 427, 1534, 443, 551, 947, 1167, 1416, 216, 506, 0, 924, 1320, 650, 652, 111, 1494, 789, 324]"
232,20,3021,2273,6515,0,2031,990,"[317, 297, 25, 79, 276, 317, 174, 25, 103, 307, 116, 199, 6, 300, 319, 215, 13, 290, 0, 122, 147, 54, 264, 283, 246, 210, 209]"
233,20,4496,5183,5828,0,2633,1863,"[15, 298, 129, 251, 344, 139, 228, 71, 581, 588, 606, 117, 442, 7, 184, 406, 469, 585, 0, 307, 317, 609, 381, 142, 45, 180, 526]"
234,20,3225,1009,8044,0,1295,1930,"[563, 26, 258, 180, 538, 628, 367, 231, 415, 285, 164, 382, 59, 212, 32, 128, 633, 425, 0, 47, 123, 174, 365, 465, 622, 88, 198]"
235,20,3528,5942,5630,0,2451,1077,"[94, 314, 200, 331, 263, 40, 236, 221, 290, 205, 341, 249, 149, 61, 310, 188, 20, 359, 0, 223, 184, 354, 289, 331, 218, 235, 271]"
236,20,3758,2955,6433,0,1358,2400,"[222, 342, 28, 214, 183, 270, 603, 478, 70, 153, 84, 257, 188, 636, 484, 385, 613, 626, 0, 443, 567, 587, 637, 223, 761, 485, 425]"
237,20,4997,6448,4982,0,3779,1218,"[350, 68, 108, 62, 173, 307, 262, 363, 271, 43, 276, 41, 240, 318, 274, 390, 156, 7, 0, 396, 69, 196, 56, 34, 335, 15, 131]"
238,20,4534,2112,7404,0,1661,2873,"[631, 865, 133, 854, 157, 312, 147, 620, 909, 337, 618, 477, 204, 337, 685, 57, 648, 70, 0, 321, 912, 528, 858, 705, 455, 533, 583]"
239,20,4354,6269,5489,0,3446,908,"[212, 253, 142, 265, 37, 175, 240, 291, 113, 11, 208, 257, 182, 229, 111, 88, 124, 3, 0, 54, 63, 175, 3, 247, 260, 284, 51]"
240,20,4168,3813,5844,0,610,3558,"[494, 57, 1163, 1105, 831, 203, 32, 482, 160, 24, 662, 679, 199, 466, 680, 1090, 725, 928, 0, 272, 616, 504, 83, 446, 287, 83, 1016]"
241,20,4469,2044,8269,0,798,3671,"[722, 992, 647, 562, 411, 509, 1088, 121, 56, 285, 70, 88, 419, 493, 689, 343, 948, 917, 0, 1044, 525, 442, 213, 899, 617, 390, 7]"
242,20,4896,7229,5936,0,1495,3401,"[185, 809, 137, 927, 678, 337, 116, 613, 250, 586, 645, 801, 984, 844, 17, 418, 717, 698, 0, 408, 765, 809, 776, 694, 263, 1084, 1097]"
243,20,4161,2146,7951,0,3148,1013,"[104, 214, 36, 138, 315, 5, 40, 139, 178, 80, 136, 17, 175, 207, 82, 316, 30, 85, 0, 106, 317, 264, 252, 22, 105, 327, 100]"
244,20,3180,5728,5403,0,1737,1443,"[40, 355, 220, 425, 324, 30, 273, 222, 369, 366, 85, 131, 434, 347, 50, 468, 380, 139, 0, 252, 153, 110, 140, 454, 151, 347, 240]"
245,20,3263,1652,7014,0,2982,281,"[49, 1, 63, 21, 63, 92, 37, 93, 0, 53, 24, 27, 25, 75, 68, 22, 32, 77, 0, 84, 59, 12, 23, 49, 46, 61, 59]"
246,20,4887,5656,6245,0,2788,2099,"[575, 615, 390, 94, 630, 48, 698, 115, 260, 682, 31, 159, 255, 69, 420, 39, 146, 513, 0, 143, 533, 510, 124, 643, 76, 266, 413]"
247,20,4468,1813,8900,0,223,4245,"[1282, 749, 616, 419, 80, 1195, 511, 694, 429, 1336, 397, 213, 1379, 246, 136, 1312, 1263, 286, 0, 91, 375, 88, 515, 628, 576, 859, 1295]"
248,20,3108,6494,5514,0,239,2869,"[896, 811, 530, 462, 220, 596, 733, 702, 738, 638, 181, 95, 804, 940, 341, 357, 664, 326, 0, 859, 553, 804, 117, 551, 183, 883, 860]"
249,20,4317,4075,5756,0,913,3404,"[771, 258, 406, 540, 989, 129, 79, 167, 965, 551, 1028, 265, 648, 374, 40, 874, 549, 220, 0, 830, 242, 43, 55, 802, 476, 1111, 1095]"
250,20,4091,2267,7580,0,2741,1350,"[319, 99, 25, 95, 447, 149, 296, 434, 145, 35, 37, 91, 58, 180, 312, 407, 199, 152, 0, 145, 288, 336, 395, 85, 263, 420, 281]"
251,20,4653,6382,5851,0,84,4569,"[419, 524, 1371, 600, 644, 1384, 1248, 17, 325, 1332, 818, 1100, 108, 1404, 1235, 34, 1160, 1356, 0, 105, 931, 1391, 1115, 508, 1391, 144, 722]"
252,20,4923,880,9894,0,4265,658,"[201, 162, 28, 178, 170, 76, 96, 154, 190, 155, 156, 212, 151, 204, 158, 32, 128, 28, 0, 24, 60, 105, 1, 180, 79, 17, 150]"
253,20,4774,5782,8886,0,4771,3,"[0, 0, 0, 0, 0, 1, 1, 1, 1, 0, 0, 1, 1, 0, 0, 0, 0, 0, 0, 0, 0, 0, 0, 1, 0, 0, 0]"
254,20,4905,5794,7997,0,2608,2297,"[739, 256, 293, 579, 627, 405, 658, 334, 477, 179, 573, 351, 437, 291, 171, 282, 510, 144, 0, 735, 699, 440, 80, 238, 666, 376, 266]"
255,20,4221,6690,5528,0,2083,2138,"[520, 356, 272, 587, 198, 680, 35, 36, 681, 557, 145, 388, 343, 155, 558, 592, 281, 208, 0, 209, 45, 456, 233, 224, 629, 93, 632]"
256,20,4201,3990,5739,0,1811,2390,"[309, 552, 577, 607, 577, 250, 766, 115, 574, 58, 127, 361, 454, 411, 276, 685, 418, 681, 0, 58, 400, 5, 577, 550, 287, 177, 344]"
257,20,4486,3639,6586,0,1414,3072,"[426, 728, 888, 726, 198, 486, 775, 163, 932, 13, 873, 261, 522, 438, 363, 696, 667, 656, 0, 792, 389, 56, 345, 777, 885, 657, 733]"
258,20,4380,270,10000,696,2991,1389,"[142, 151, 342, 13, 132, 210, 34, 271, 164, 94, 439, 421, 155, 6, 357, 263, 184, 180, 0, 359, 34, 436, 359, 30, 239, 140, 220]"
259,20,4524,5882,8642,0,3698,826,"[43, 148, 22, 140, 164, 228, 37, 134, 198, 259, 272, 250, 3, 208, 252, 204, 152, 147, 0, 255, 51, 221, 11, 264, 67, 131, 133]"
260,20,4092,5983,6751,0,2579,1513,"[151, 456, 241, 75, 162, 236, 491, 162, 338, 274, 338, 249, 453, 408, 125, 28, 369, 255, 0, 462, 179, 243, 137, 117, 400, 225, 33]"
261,20,3641,914,9478,0,2101,1540,"[280, 91, 377, 450, 484, 359, 319, 205, 99, 206, 392, 52, 21, 385, 385, 14, 230, 460, 0, 414, 170, 190, 280, 259, 500, 72, 407]"
262,20,4234,6086,7626,0,3227,1007,"[213, 52, 43, 256, 278, 73, 226, 145, 79, 113, 290, 248, 18, 74, 24, 121, 245, 62, 0, 15, 292, 76, 47, 287, 187, 23, 161]"
263,20,3977,7240,4363,0,666,3311,"[768, 86, 906, 1068, 396, 52, 908, 515, 727, 927, 418, 471, 630, 504, 997, 704, 696, 266, 0, 177, 424, 442, 548, 767, 427, 614, 360]"
264,20,4578,172,8769,0,2171,2407,"[625, 589, 580, 642, 250, 737, 203, 707, 178, 66, 249, 370, 27, 368, 199, 77, 577, 518, 0, 781, 487, 312, 609, 664, 473, 203, 774]"
265,20,3272,6548,5493,0,1921,1351,"[261, 128, 45, 233, 307, 15, 341, 449, 277, 284, 300, 114, 267, 221, 399, 249, 183, 191, 0, 141, 401, 47, 332, 130, 161, 427, 59]"
266,20,4438,612,9319,0,3037,1401,"[270, 420, 248, 20, 33, 7, 13, 125, 52, 350, 265, 453, 101, 388, 48, 439, 202, 98, 0, 360, 0, 212, 236, 366, 145, 30, 35]"
267,20,4040,5106,8253,0,1811,2229,"[475, 264, 321, 82, 24, 547, 181, 354, 678, 437, 265, 193, 70, 327, 726, 3, 172, 462, 0, 632, 83, 66, 167, 352, 327, 617, 253]"
268,20,4235,6815,5673,0,2764,1471,"[234, 147, 98, 251, 45, 147, 188, 6, 297, 417, 186, 116, 99, 145, 37, 389, 297, 197, 0, 119, 430, 401, 478, 9, 184, 96, 266]"
269,20,4083,689,9067,0,1316,2767,"[598, 58, 602, 760, 661, 323, 315, 379, 467, 820, 510, 806, 912, 302, 373, 611, 41, 543, 0, 610, 669, 799, 783, 211, 758, 415, 921]"
270,20,3749,7022,5794,0,2130,1619,"[231, 336, 80, 246, 77, 512, 9, 122, 267, 373, 325, 474, 386, 100, 211, 408, 492, 96, 0, 506, 494, 89, 268, 270, 34, 63, 219]"
271,20,4617,2665,7746,0,1779,2838,"[845, 79, 80, 130, 800, 229, 235, 245, 107, 419, 280, 381, 41, 474, 431, 311, 793, 182, 0, 96, 550, 538, 244, 728, 132, 261, 862]"
272,20,4994,6434,6306,0,228,4766,"[782, 991, 305, 428, 424, 515, 975, 1567, 41, 474, 898, 1479, 737, 1254, 115, 400, 540, 256, 0, 1519, 677, 1073, 1156, 468, 1337, 6, 865]"
273,20,3129,3017,6418,0,963,2166,"[255, 486, 701, 108, 501, 524, 221, 192, 43, 654, 138, 544, 124, 198, 557, 217, 454, 651, 0, 382, 497, 168, 104, 612, 330, 654, 454]"
274,20,3355,938,8835,0,2506,849,"[157, 130, 281, 27, 227, 257, 88, 178, 110, 32, 65, 115, 145, 34, 214, 173, 251, 29, 0, 193, 181, 89, 124, 18, 67, 100, 58]"
275,20,3002,5483,6354,0,1878,1124,"[371, 166, 261, 125, 262, 206, 149, 343, 16, 195, 49, 230, 346, 226, 218, 312, 330, 344, 0, 125, 73, 79, 187, 49, 283, 361, 108]"
276,20,3373,805,8922,0,2532,841,"[18, 144, 90, 99, 3, 270, 280, 275, 164, 255, 278, 143, 80, 101, 24, 22, 265, 143, 0, 191, 88, 1, 253, 36, 163, 157, 15]"
277,20,4284,6698,6508,0,932,3352,"[96, 366, 658, 24, 1056, 1057, 118, 356, 134, 210, 463, 961, 851, 1032, 254, 477, 535, 819, 0, 151, 84, 609, 301, 759, 275, 863, 593]"
278,20,4919,6861,4566,0,3380,1539,"[43, 229, 166, 363, 5, 75, 179, 460, 476, 512, 508, 244, 113, 446, 242, 460, 421, 14, 0, 183, 327, 259, 57, 157, 462, 169, 466]"
279,20,4097,3501,5162,0,1624,2473,"[521, 668, 638, 51, 476, 49, 322, 464, 765, 212, 226, 171, 680, 547, 490, 87, 289, 121, 0, 405, 661, 103, 553, 673, 744, 715, 404]"
280,20,3998,2967,6193,0,3727,271,"[29, 5, 64, 4, 45, 37, 40, 88, 31, 4, 85, 86, 38, 60, 87, 45, 40, 51, 0, 12, 20, 20, 33, 79, 12, 43, 88]"
281,20,3515,552,9156,0,1396,2119,"[485, 50, 517, 576, 248, 19, 375, 65, 280, 48, 334, 595, 438, 435, 488, 99, 168, 429, 0, 177, 114, 33, 351, 379, 56, 127, 194]"
282,20,4159,7199,6116,0,2384,1775,"[514, 342, 4, 418, 443, 414, 301, 3, 384, 397, 36, 580, 430, 274, 200, 218, 421, 413, 0, 232, 446, 502, 21, 23, 458, 182, 210]"
283,20,3625,862,8879,0,1159,2466,"[700, 650, 388, 204, 410, 310, 380, 545, 208, 745, 481, 468, 72, 438, 627, 399, 89, 744, 0, 193, 39, 293, 211, 375, 263, 251, 609]"
284,20,3902,5373,7408,0,3700,202,"[41, 36, 27, 64, 42, 5, 44, 67, 36, 10, 27, 65, 45, 67, 61, 35, 62, 44, 0, 1, 23, 50, 14, 64, 41, 38, 32]"
285,20,3811,5034,6185,0,3080,731,"[73, 14, 59, 36, 216, 44, 100, 21, 98, 8, 228, 146, 117, 11, 50, 225, 12, 52, 0, 237, 94, 139, 184, 120, 15, 231, 209]"
286,20,3667,642,9210,0,569,3098,"[767, 513, 718, 380, 415, 509, 308, 761, 545, 830, 313, 261, 381, 324, 37, 406, 959, 57, 0, 942, 540, 433, 308, 595, 882, 113, 541]"
287,20,4211,6099,7322,0,3795,416,"[1, 16, 118, 107, 91, 67, 28, 36, 68, 83, 130, 92, 35, 127, 21, 96, 54, 20, 0, 13, 87, 74, 106, 10, 135, 90, 1]"
288,20,3736,5170,5888,0,2474,1262,"[73, 174, 318, 340, 164, 299, 139, 379, 361, 95, 179, 397, 180, 311, 26, 296, 2, 146, 0, 200, 327, 251, 174, 145, 111, 18, 221]"
289,20,4025,904,9009,0,46,3979,"[349, 780, 194, 172, 923, 325, 643, 115, 106, 1124, 360, 774, 1233, 1237, 15, 674, 1251, 121, 0, 1, 244, 978, 1051, 1027, 681, 1035, 234]"
290,20,3436,5636,6809,0,2797,639,"[197, 110, 23, 166, 25, 160, 185, 88, 110, 62, 147, 79, 57, 194, 14, 7, 70, 172, 0, 173, 193, 21, 104, 172, 76, 191, 15]"
291,20,3790,3315,7284,0,2176,1614,"[384, 318, 44, 467, 348, 135, 430, 91, 144, 107, 168, 491, 385, 42, 58, 104, 116, 492, 0, 337, 319, 282, 374, 73, 74, 57, 455]"
292,20,4839,5530,6593,0,4018,821,"[151, 1, 9, 171, 39, 264, 211, 25, 27, 23, 234, 146, 122, 189, 99, 49, 20, 6, 0, 189, 143, 188, 187, 271, 271, 22, 65]"
293,20,3223,142,9674,0,1430,1793,"[518, 545, 309, 304, 54, 208, 305, 322, 79, 101, 1, 197, 197, 150, 382, 490, 214, 348, 0, 330, 105, 67, 400, 445, 414, 364, 87]"
294,20,3895,7031,6538,0,633,3262,"[315, 351, 275, 214, 891, 450, 410, 0, 400, 246, 1027, 980, 374, 1056, 908, 460, 885, 340, 0, 562, 622, 1000, 1031, 37, 1043, 331, 1]"
295,20,4602,6562,4578,0,2998,1604,"[335, 236, 501, 445, 146, 176, 121, 496, 64, 286, 285, 530, 307, 100, 63, 22, 520, 101, 0, 207, 121, 421, 452, 287, 172, 423, 366]"
296,20,3614,2626,5566,0,1445,2169,"[592, 167, 603, 632, 39, 215, 377, 403, 89, 143, 497, 211, 474, 253, 604, 184, 602, 370, 0, 272, 711, 98, 181, 433, 585, 126, 177]"
297,20,4950,4605,5911,0,2251,2699,"[332, 553, 543, 848, 843, 627, 234, 84, 232, 168, 66, 742, 331, 415, 648, 345, 104, 106, 0, 625, 287, 617, 413, 738, 135, 413, 899]"
298,20,3847,3793,5965,0,1867,1980,"[28, 329, 454, 494, 190, 104, 553, 477, 441, 415, 370, 235, 127, 17, 362, 525, 38, 259, 0, 102, 224, 452, 515, 110, 581, 409, 583]"
299,20,4293,2652,7606,0,1622,2671,"[857, 594, 625, 94, 260, 165, 27, 315, 1, 782, 324, 231, 72, 152, 247, 584, 73, 636, 0, 752, 871, 759, 812, 123, 10, 687, 868]"
0,21,67,0,67,0,52,15,"[5, 1, 2, 4, 5, 3, 2, 0, 2, 3, 3, 1, 3, 4, 5, 3, 2, 2, 1, 0, 2, 0, 3, 1, 2, 4, 0]"
1,21,75,66,76,0,42,33,"[10, 4, 6, 9, 2, 5, 7, 0, 1, 9, 11, 0, 7, 5, 2, 11, 5, 9, 3, 0, 10, 7, 1, 1, 5, 2, 10]"
2,21,47,12,111,0,2,45,"[6, 4, 12, 15, 12, 15, 14, 14, 15, 4, 3, 9, 14, 3, 1, 11, 5, 4, 1, 0, 14, 7, 11, 9, 9, 5, 11]"
3,21,48,12,147,0,43,5,"[0, 0, 1, 0, 1, 0, 0, 0, 0, 1, 1, 0, 1, 0, 0, 0, 0, 1, 1, 0, 0, 0, 0, 0, 0, 0, 1]"
4,21,62,57,152,0,48,14,"[4, 0, 2, 2, 2, 4, 0, 3, 4, 3, 2, 2, 4, 0, 1, 1, 2, 4, 1, 0, 4, 2, 0, 1, 3, 2, 2]"
5,21,90,77,165,0,51,39,"[10, 7, 6, 4, 13, 5, 10, 5, 3, 4, 9, 8, 1, 6, 2, 2, 8, 6, 5, 0, 3, 10, 11, 2, 7, 8, 0]"
6,21,18,1,182,0,13,5,"[1, 0, 0, 1, 0, 0, 0, 0, 0, 1, 0, 1, 0, 0, 0, 1, 0, 0, 1, 0, 1, 0, 1, 0, 0, 0, 0]"
7,21,14,8,188,0,8,6,"[0, 0, 1, 2, 2, 0, 0, 0, 2, 0, 0, 1, 1, 1, 1, 2, 2, 1, 0, 0, 2, 1, 2, 2, 1, 2, 2]"
8,21,42,19,211,0,0,42,"[11, 14, 2, 7, 3, 13, 7, 12, 12, 3, 1, 3, 9, 3, 0, 6, 10, 8, 5, 0, 3, 0, 7, 8, 12, 12, 7]"
9,21,18,8,221,0,11,7,"[0, 2, 0, 1, 1, 2, 0, 1, 1, 1, 0, 1, 1, 2, 2, 2, 2, 0, 2, 0, 1, 2, 2, 1, 2, 1, 0]"
10,21,58,51,228,0,9,49,"[14, 16, 6, 9, 3, 0, 4, 11, 9, 4, 12, 3, 10, 1, 11, 0, 3, 2, 10, 0, 9, 7, 3, 15, 0, 12, 16]"
11,21,58,40,246,0,46,12,"[1, 4, 2, 2, 2, 1, 1, 1, 4, 2, 1, 2, 2, 1, 3, 3, 3, 4, 1, 0, 0, 4, 2, 0, 4, 1, 4]"
12,21,45,13,278,0,3,42,"[11, 6, 10, 14, 4, 10, 1, 14, 13, 10, 7, 5, 9, 14, 4, 14, 10, 0, 5, 0, 9, 14, 1, 14, 9, 6, 5]"
13,21,61,37,302,0,0,61,"[0, 15, 4, 8, 10, 1, 4, 7, 10, 15, 0, 13, 14, 18, 4, 13, 15, 19, 18, 0, 4, 6, 3, 0, 20, 19, 6]"
14,21,81,14,369,0,79,2,"[0, 0, 0, 0, 0, 0, 0, 0, 0, 0, 0, 0, 0, 0, 0, 0, 0, 0, 0, 0, 0, 0, 0, 0, 0, 0, 0]"
15,21,14,13,370,0,7,7,"[1, 0, 0, 1, 0, 1, 1, 1, 1, 1, 1, 2, 0, 1, 0, 1, 1, 2, 2, 0, 2, 2, 2, 1, 1, 2, 1]"
16,21,36,27,379,0,19,17,"[5, 0, 1, 3, 3, 5, 2, 1, 3, 4, 3, 4, 0, 4, 3, 3, 1, 0, 4, 0, 3, 2, 1, 1, 2, 5, 4]"
17,21,57,21,415,0,30,27,"[2, 9, 3, 6, 7, 9, 9, 5, 3, 8, 2, 6, 4, 5, 7, 0, 9, 2, 4, 0, 5, 7, 9, 3, 3, 6, 9]"
18,21,40,17,438,0,31,9,"[1, 2, 1, 0, 1, 0, 2, 0, 2, 2, 2, 1, 2, 3, 3, 3, 1, 3, 1, 0, 3, 2, 1, 0, 0, 2, 3]"
19,21,47,35,450,0,25,22,"[1, 5, 5, 0, 3, 5, 7, 1, 5, 3, 2, 7, 1, 5, 4, 5, 4, 3, 6, 0, 5, 1, 6, 3, 3, 3, 7]"
20,21,37,31,456,0,23,14,"[4, 2, 2, 4, 4, 1, 4, 3, 2, 3, 0, 4, 1, 4, 2, 3, 4, 0, 3, 0, 1, 0, 0, 0, 3, 1, 4]"
21,21,42,23,475,0,5,37,"[3, 12, 6, 7, 0, 8, 11, 7, 12, 10, 2, 2, 0, 12, 2, 12, 3, 1, 2, 0, 11, 4, 9, 6, 11, 7, 4]"
22,21,61,51,485,0,1,60,"[11, 19, 3, 16, 17, 10, 20, 20, 7, 14, 12, 2, 17, 4, 4, 4, 1, 19, 7, 0, 19, 15, 16, 0, 15, 16, 10]"
23,21,24,14,495,0,9,15,"[1, 1, 0, 4, 0, 3, 1, 2, 0, 5, 5, 5, 4, 5, 0, 3, 1, 0, 3, 0, 5, 0, 0, 5, 2, 5, 3]"
24,21,82,66,511,0,77,5,"[0, 1, 1, 1, 1, 0, 0, 0, 1, 1, 1, 0, 0, 1, 1, 0, 0, 1, 1, 0, 0, 0, 1, 0, 0, 0, 1]"
25,21,43,14,540,0,20,23,"[5, 1, 0, 5, 1, 7, 6, 6, 3, 5, 5, 1, 7, 3, 4, 7, 3, 7, 3, 0, 6, 0, 6, 4, 5, 5, 6]"
26,21,10,5,545,0,8,2,"[0, 0, 0, 0, 0, 0, 0, 0, 0, 0, 0, 0, 0, 0, 0, 0, 0, 0, 0, 0, 0, 0, 0, 0, 0, 0, 0]"
27,21,95,38,602,0,8,87,"[25, 24, 3, 11, 7, 0, 2, 27, 7, 25, 26, 16, 8, 14, 2, 26, 13, 21, 17, 0, 13, 27, 21, 13, 2, 15, 5]"
28,21,78,42,638,0,61,17,"[4, 1, 5, 2, 4, 3, 1, 3, 5, 2, 3, 2, 3, 3, 0, 2, 3, 5, 3, 0, 5, 3, 2, 2, 0, 3, 0]"
29,21,91,11,718,0,50,41,"[6, 12, 5, 12, 6, 3, 7, 11, 5, 10, 11, 0, 3, 2, 13, 4, 2, 6, 4, 0, 3, 4, 1, 11, 6, 7, 1]"
30,21,46,14,750,0,43,3,"[0, 1, 1, 1, 0, 0, 1, 0, 1, 0, 1, 1, 1, 0, 1, 0, 1, 0, 0, 0, 0, 1, 0, 0, 1, 1, 0]"
31,21,30,16,764,0,6,24,"[3, 7, 3, 7, 0, 5, 8, 2, 2, 5, 8, 3, 7, 4, 2, 5, 7, 8, 4, 0, 3, 1, 2, 0, 7, 4, 7]"
32,21,91,80,775,0,71,20,"[3, 0, 3, 1, 3, 6, 1, 5, 6, 4, 3, 2, 5, 3, 2, 3, 2, 2, 2, 0, 1, 2, 2, 5, 0, 6, 0]"
33,21,94,20,849,0,32,62,"[5, 20, 11, 5, 8, 16, 17, 2, 12, 3, 18, 18, 13, 14, 10, 0, 7, 15, 5, 0, 17, 5, 8, 5, 16, 15, 17]"
34,21,48,37,860,0,35,13,"[1, 3, 3, 0, 0, 1, 4, 4, 2, 1, 1, 3, 0, 3, 2, 4, 2, 2, 0, 0, 3, 0, 2, 1, 3, 1, 2]"
35,21,36,0,896,0,36,0,"[0, 0, 0, 0, 0, 0, 0, 0, 0, 0, 0, 0, 0, 0, 0, 0, 0, 0, 0, 0, 0, 0, 0, 0, 0, 0, 0]"
36,21,29,24,901,0,6,23,"[1, 4, 0, 2, 5, 2, 4, 2, 7, 2, 7, 5, 5, 4, 2, 4, 7, 6, 3, 0, 4, 6, 0, 0, 1, 6, 3]"
37,21,42,4,939,0,28,14,"[0, 3, 3, 0, 4, 4, 0, 4, 0, 2, 3, 3, 2, 2, 0, 3, 3, 3, 1, 0, 1, 1, 2, 0, 3, 2, 2]"
38,21,12,3,948,0,2,10,"[2, 1, 1, 3, 0, 2, 0, 1, 2, 3, 0, 2, 0, 2, 2, 2, 0, 2, 2, 0, 2, 2, 2, 0, 3, 3, 3]"
39,21,23,9,962,0,4,19,"[6, 0, 0, 6, 1, 0, 2, 2, 1, 1, 2, 0, 3, 2, 1, 4, 6, 6, 6, 0, 1, 0, 1, 3, 0, 3, 6]"
40,21,93,3,1052,0,56,37,"[4, 0, 11, 5, 4, 2, 9, 3, 2, 3, 4, 1, 0, 0, 9, 10, 0, 9, 2, 0, 7, 8, 4, 7, 8, 10, 5]"
41,21,56,37,1071,0,34,22,"[2, 2, 5, 7, 7, 0, 2, 1, 2, 3, 6, 6, 7, 4, 5, 4, 2, 2, 0, 0, 4, 3, 1, 5, 3, 0, 4]"
42,21,5,4,1072,0,5,0,"[0, 0, 0, 0, 0, 0, 0, 0, 0, 0, 0, 0, 0, 0, 0, 0, 0, 0, 0, 0, 0, 0, 0, 0, 0, 0, 0]"
43,21,44,34,1082,0,34,10,"[0, 1, 3, 3, 0, 2, 3, 3, 1, 1, 3, 2, 0, 2, 1, 2, 3, 3, 1, 0, 1, 1, 1, 0, 2, 2, 2]"
44,21,83,33,1132,0,73,10,"[1, 1, 3, 2, 3, 3, 3, 3, 1, 2, 1, 0, 3, 0, 2, 3, 2, 2, 2, 0, 2, 3, 0, 3, 2, 0, 2]"
45,21,64,36,1160,0,39,25,"[2, 6, 2, 2, 1, 8, 1, 4, 1, 1, 4, 8, 2, 8, 1, 0, 0, 4, 8, 0, 0, 6, 4, 2, 8, 2, 1]"
46,21,94,12,1242,0,4,90,"[26, 4, 13, 25, 16, 4, 1, 3, 8, 24, 29, 29, 19, 14, 29, 3, 2, 25, 17, 0, 24, 3, 11, 1, 1, 21, 14]"
47,21,54,35,1261,0,52,2,"[0, 0, 0, 0, 0, 0, 0, 0, 0, 0, 0, 0, 0, 0, 0, 0, 0, 0, 0, 0, 0, 0, 0, 0, 0, 0, 0]"
48,21,32,25,1268,0,4,28,"[6, 9, 4, 0, 5, 8, 4, 6, 7, 1, 6, 4, 6, 8, 2, 1, 6, 6, 9, 0, 9, 0, 9, 4, 9, 5, 8]"
49,21,41,19,1290,0,21,20,"[1, 3, 1, 0, 6, 5, 4, 4, 0, 2, 2, 3, 5, 4, 3, 1, 5, 2, 1, 0, 0, 2, 4, 1, 1, 2, 3]"
50,21,46,11,1325,0,26,20,"[0, 3, 0, 4, 4, 6, 3, 0, 4, 6, 5, 5, 2, 0, 0, 6, 3, 4, 1, 0, 1, 6, 5, 0, 4, 5, 2]"
51,21,15,12,1328,0,10,5,"[0, 1, 0, 1, 0, 0, 0, 1, 1, 1, 1, 0, 0, 1, 1, 1, 0, 0, 0, 0, 0, 0, 1, 0, 1, 1, 1]"
52,21,68,67,1329,0,68,0,"[0, 0, 0, 0, 0, 0, 0, 0, 0, 0, 0, 0, 0, 0, 0, 0, 0, 0, 0, 0, 0, 0, 0, 0, 0, 0, 0]"
53,21,66,16,1379,0,6,60,"[20, 2, 2, 13, 2, 6, 18, 16, 1, 5, 2, 14, 20, 3, 13, 2, 11, 11, 17, 0, 0, 4, 2, 2, 13, 2, 15]"
54,21,52,23,1408,0,4,48,"[3, 12, 5, 14, 9, 3, 11, 6, 3, 16, 8, 2, 10, 4, 11, 9, 6, 5, 0, 0, 3, 4, 15, 3, 11, 8, 10]"
55,21,28,8,1428,0,1,27,"[8, 1, 8, 0, 3, 2, 1, 2, 9, 4, 4, 8, 9, 9, 0, 3, 2, 8, 6, 0, 6, 8, 0, 6, 3, 8, 8]"
56,21,62,3,1487,0,33,29,"[3, 9, 7, 5, 2, 5, 0, 2, 7, 2, 9, 7, 2, 0, 5, 8, 7, 6, 9, 0, 1, 5, 1, 7, 0, 8, 2]"
57,21,8,0,1495,0,8,0,"[0, 0, 0, 0, 0, 0, 0, 0, 0, 0, 0, 0, 0, 0, 0, 0, 0, 0, 0, 0, 0, 0, 0, 0, 0, 0, 0]"
58,21,63,36,1522,0,59,4,"[0, 1, 0, 0, 0, 1, 0, 1, 0, 1, 0, 0, 0, 0, 0, 1, 0, 1, 1, 0, 0, 1, 0, 0, 1, 1, 0]"
59,21,17,17,1522,0,6,11,"[0, 2, 1, 2, 0, 3, 3, 0, 2, 3, 2, 3, 2, 0, 0, 3, 0, 0, 0, 0, 1, 3, 3, 1, 0, 1, 1]"
60,21,10,0,1532,0,0,10,"[1, 2, 1, 2, 3, 2, 3, 1, 0, 0, 2, 2, 3, 0, 3, 1, 0, 0, 0, 0, 1, 0, 0, 0, 0, 1, 2]"
61,21,31,7,1556,0,20,11,"[1, 2, 1, 2, 1, 3, 1, 0, 1, 2, 3, 3, 2, 3, 0, 3, 1, 1, 0, 0, 2, 1, 3, 1, 2, 3, 1]"
62,21,36,23,1569,0,24,12,"[1, 0, 1, 2, 2, 4, 2, 0, 4, 2, 0, 4, 1, 2, 4, 3, 2, 2, 4, 0, 1, 2, 4, 1, 4, 2, 0]"
63,21,97,62,1604,0,40,57,"[3, 6, 17, 2, 1, 13, 15, 16, 14, 16, 5, 16, 14, 10, 1, 0, 0, 6, 5, 0, 2, 0, 1, 4, 5, 5, 14]"
64,21,21,8,1617,0,1,20,"[4, 1, 1, 4, 4, 0, 6, 4, 5, 0, 5, 2, 4, 5, 2, 2, 5, 3, 0, 0, 0, 3, 5, 6, 1, 3, 0]"
65,21,68,0,1685,0,20,48,"[5, 7, 2, 11, 3, 8, 12, 10, 7, 2, 5, 9, 10, 12, 10, 10, 8, 3, 2, 0, 7, 4, 9, 13, 10, 16, 14]"
66,21,47,27,1705,0,28,19,"[6, 0, 4, 2, 6, 6, 0, 0, 5, 2, 3, 6, 6, 2, 1, 3, 5, 0, 0, 0, 4, 2, 6, 4, 2, 3, 3]"
67,21,3,1,1707,0,1,2,"[0, 0, 0, 0, 0, 0, 0, 0, 0, 0, 0, 0, 0, 0, 0, 0, 0, 0, 0, 0, 0, 0, 0, 0, 0, 0, 0]"
68,21,22,15,1714,0,2,20,"[2, 6, 3, 6, 4, 1, 6, 2, 4, 2, 0, 1, 6, 6, 0, 5, 6, 4, 1, 0, 2, 4, 2, 6, 2, 5, 1]"
69,21,52,4,1762,0,10,42,"[4, 14, 9, 9, 14, 9, 10, 4, 13, 0, 9, 5, 9, 4, 8, 0, 3, 14, 12, 0, 7, 0, 3, 8, 0, 8, 9]"
70,21,40,10,1792,0,27,13,"[1, 1, 4, 4, 3, 3, 3, 0, 3, 0, 1, 4, 4, 2, 3, 1, 1, 0, 1, 0, 3, 3, 2, 3, 4, 3, 2]"
71,21,88,30,1850,0,29,59,"[18, 16, 17, 11, 4, 6, 8, 15, 0, 2, 17, 7, 13, 11, 13, 6, 4, 4, 2, 0, 4, 0, 15, 17, 4, 19, 5]"
72,21,23,23,1850,0,17,6,"[2, 1, 0, 1, 2, 1, 1, 0, 1, 2, 2, 0, 0, 2, 0, 0, 0, 2, 2, 0, 0, 1, 0, 0, 2, 1, 2]"
73,21,15,6,1859,0,2,13,"[2, 1, 0, 3, 0, 2, 3, 1, 3, 0, 4, 1, 1, 3, 0, 1, 4, 1, 0, 0, 3, 2, 3, 3, 2, 4, 3]"
74,21,64,33,1890,0,56,8,"[1, 2, 2, 2, 2, 2, 2, 0, 0, 0, 0, 0, 2, 1, 0, 1, 1, 2, 1, 0, 0, 2, 2, 0, 1, 2, 0]"
75,21,60,42,1908,0,43,17,"[1, 0, 5, 4, 2, 0, 0, 5, 2, 3, 1, 3, 0, 4, 0, 4, 0, 4, 2, 0, 3, 1, 3, 4, 2, 5, 0]"
76,21,49,12,1945,0,26,23,"[1, 4, 5, 1, 5, 2, 5, 1, 1, 7, 6, 7, 5, 6, 0, 7, 1, 2, 0, 0, 0, 3, 0, 3, 3, 1, 7]"
77,21,51,20,1976,0,41,10,"[1, 3, 1, 2, 3, 2, 2, 2, 1, 1, 1, 3, 3, 3, 0, 1, 1, 1, 0, 0, 3, 2, 0, 0, 1, 2, 2]"
78,21,69,24,2021,0,60,9,"[1, 3, 0, 2, 0, 2, 3, 0, 3, 3, 0, 2, 3, 3, 0, 0, 3, 3, 2, 0, 1, 1, 3, 1, 0, 0, 3]"
79,21,56,18,2059,0,44,12,"[0, 0, 4, 0, 0, 4, 4, 2, 0, 1, 2, 4, 1, 1, 3, 0, 2, 4, 0, 0, 0, 4, 3, 3, 0, 0, 3]"
80,21,96,86,2069,0,75,21,"[6, 4, 4, 1, 0, 6, 7, 2, 0, 1, 6, 1, 6, 2, 3, 6, 6, 0, 4, 0, 5, 0, 7, 3, 6, 1, 5]"
81,21,12,12,2069,0,4,8,"[0, 0, 1, 2, 1, 2, 1, 0, 2, 2, 0, 2, 0, 2, 0, 2, 1, 2, 0, 0, 0, 1, 1, 2, 0, 2, 1]"
82,21,70,20,2119,0,23,47,"[15, 10, 13, 7, 8, 10, 5, 3, 0, 10, 12, 1, 13, 0, 8, 7, 2, 5, 4, 0, 11, 7, 14, 10, 13, 12, 2]"
83,21,14,0,2133,0,14,0,"[0, 0, 0, 0, 0, 0, 0, 0, 0, 0, 0, 0, 0, 0, 0, 0, 0, 0, 0, 0, 0, 0, 0, 0, 0, 0, 0]"
84,21,57,37,2153,0,3,54,"[1, 7, 8, 0, 10, 2, 4, 7, 9, 6, 6, 7, 9, 7, 18, 8, 15, 16, 17, 0, 18, 2, 8, 12, 18, 0, 4]"
85,21,6,4,2155,0,6,0,"[0, 0, 0, 0, 0, 0, 0, 0, 0, 0, 0, 0, 0, 0, 0, 0, 0, 0, 0, 0, 0, 0, 0, 0, 0, 0, 0]"
86,21,13,4,2164,0,4,9,"[0, 1, 1, 2, 0, 3, 3, 0, 1, 1, 2, 2, 2, 1, 0, 3, 0, 2, 0, 0, 3, 1, 2, 2, 3, 3, 0]"
87,21,90,74,2180,0,60,30,"[0, 8, 7, 6, 8, 7, 7, 10, 10, 10, 7, 10, 2, 7, 5, 6, 2, 7, 0, 0, 7, 0, 3, 9, 3, 3, 6]"
88,21,14,0,2194,0,11,3,"[1, 0, 0, 0, 1, 1, 1, 1, 0, 0, 0, 0, 0, 0, 0, 1, 0, 1, 0, 0, 0, 1, 1, 1, 1, 0, 0]"
89,21,59,32,2221,0,11,48,"[3, 9, 8, 7, 8, 3, 14, 13, 13, 2, 15, 14, 8, 2, 2, 9, 11, 6, 2, 0, 14, 13, 2, 4, 2, 5, 5]"
90,21,50,9,2262,0,3,47,"[5, 7, 4, 13, 11, 5, 12, 13, 11, 6, 1, 7, 1, 14, 2, 14, 3, 7, 1, 0, 1, 10, 13, 4, 8, 7, 10]"
91,21,58,10,2310,0,38,20,"[0, 3, 0, 4, 5, 6, 1, 3, 1, 1, 3, 6, 4, 1, 4, 1, 2, 4, 6, 0, 6, 2, 2, 6, 3, 2, 1]"
92,21,88,74,2324,0,6,82,"[20, 13, 20, 1, 26, 7, 16, 0, 26, 10, 19, 19, 1, 18, 12, 24, 22, 13, 8, 0, 26, 9, 2, 0, 24, 12, 5]"
93,21,37,4,2357,0,2,35,"[4, 3, 8, 9, 5, 2, 5, 1, 9, 0, 0, 10, 4, 7, 0, 10, 3, 0, 7, 0, 8, 4, 6, 10, 5, 0, 8]"
94,21,90,87,2360,0,6,84,"[7, 7, 1, 12, 21, 24, 20, 13, 11, 5, 8, 23, 24, 28, 26, 5, 25, 4, 16, 0, 7, 17, 13, 25, 20, 17, 28]"
95,21,85,43,2402,0,64,21,"[3, 1, 7, 3, 1, 4, 2, 7, 5, 6, 4, 6, 4, 4, 0, 5, 4, 5, 6, 0, 1, 6, 2, 5, 5, 7, 0]"
96,21,46,29,2419,0,22,24,"[8, 1, 2, 1, 2, 0, 1, 4, 6, 1, 7, 0, 6, 3, 8, 1, 4, 3, 4, 0, 5, 4, 4, 4, 1, 6, 3]"
97,21,24,1,2442,0,1,23,"[3, 7, 3, 6, 2, 4, 4, 6, 0, 4, 6, 2, 7, 4, 2, 1, 5, 2, 2, 0, 3, 6, 1, 0, 7, 0, 0]"
98,21,87,41,2488,0,33,54,"[10, 15, 4, 17, 9, 0, 9, 0, 18, 18, 7, 15, 16, 3, 6, 6, 1, 8, 14, 0, 0, 16, 8, 6, 9, 0, 5]"
99,21,78,26,2540,0,16,62,"[2, 16, 14, 12, 18, 10, 10, 5, 17, 7, 5, 7, 3, 13, 16, 1, 20, 6, 13, 0, 13, 7, 15, 2, 2, 20, 18]"
100,21,81,45,2576,0,5,76,"[2, 6, 22, 11, 16, 0, 3, 9, 7, 23, 14, 18, 2, 21, 9, 24, 16, 15, 17, 0, 8, 20, 21, 6, 14, 18, 5]"
101,21,91,31,2636,0,79,12,"[3, 2, 2, 3, 0, 0, 1, 1, 4, 3, 4, 4, 1, 4, 4, 1, 0, 1, 1, 0, 1, 0, 2, 2, 3, 2, 4]"
102,21,29,4,2661,0,7,22,"[6, 3, 1, 2, 0, 4, 7, 7, 0, 7, 6, 0, 5, 7, 2, 5, 3, 0, 4, 0, 0, 2, 5, 2, 0, 4, 1]"
103,21,43,0,2704,0,19,24,"[8, 6, 6, 6, 3, 0, 7, 8, 3, 3, 3, 2, 4, 3, 7, 6, 8, 3, 7, 0, 0, 8, 7, 4, 8, 2, 1]"
104,21,5,0,2709,0,0,5,"[0, 1, 1, 0, 1, 0, 1, 0, 1, 1, 1, 1, 1, 0, 1, 0, 0, 0, 0, 0, 0, 0, 1, 0, 1, 1, 1]"
105,21,51,28,2732,0,34,17,"[4, 5, 1, 0, 5, 4, 4, 2, 5, 2, 0, 3, 2, 0, 2, 4, 1, 3, 5, 0, 5, 2, 2, 3, 0, 1, 4]"
106,21,98,18,2812,0,24,74,"[13, 7, 8, 7, 15, 20, 17, 20, 2, 6, 14, 11, 2, 5, 12, 8, 1, 2, 12, 0, 0, 11, 5, 5, 9, 11, 23]"
107,21,12,11,2813,0,7,5,"[1, 1, 0, 0, 0, 1, 0, 0, 1, 1, 0, 0, 1, 0, 1, 0, 0, 0, 0, 0, 0, 0, 1, 1, 0, 1, 0]"
108,21,78,1,2890,0,37,41,"[3, 3, 12, 5, 2, 6, 0, 0, 13, 12, 1, 8, 0, 2, 8, 13, 13, 13, 11, 0, 4, 11, 7, 6, 1, 11, 8]"
109,21,77,20,2947,0,72,5,"[0, 0, 1, 1, 1, 1, 0, 0, 0, 0, 1, 1, 0, 1, 1, 0, 0, 1, 0, 0, 0, 0, 0, 1, 0, 0, 0]"
110,21,38,32,2953,0,5,33,"[10, 8, 5, 0, 2, 6, 9, 3, 5, 2, 7, 11, 8, 9, 11, 10, 0, 8, 9, 0, 10, 6, 7, 10, 0, 2, 2]"
111,21,87,5,3035,0,19,68,"[17, 6, 0, 8, 18, 13, 8, 2, 19, 8, 16, 7, 2, 6, 15, 4, 0, 0, 3, 0, 13, 6, 17, 9, 16, 2, 1]"
112,21,38,13,3060,0,0,38,"[4, 4, 0, 8, 7, 0, 2, 2, 4, 8, 9, 6, 1, 12, 0, 6, 9, 10, 5, 0, 2, 9, 7, 0, 12, 12, 10]"
113,21,55,46,3069,0,9,46,"[13, 14, 4, 7, 3, 8, 10, 13, 4, 11, 14, 1, 1, 15, 14, 11, 9, 13, 9, 0, 8, 2, 15, 0, 2, 15, 6]"
114,21,68,68,3069,0,43,25,"[5, 3, 7, 6, 6, 3, 0, 2, 8, 5, 6, 2, 8, 0, 6, 6, 6, 2, 4, 0, 6, 7, 7, 6, 5, 7, 0]"
115,21,37,8,3098,0,15,22,"[7, 7, 2, 4, 4, 6, 2, 7, 7, 7, 7, 0, 4, 7, 1, 3, 6, 5, 7, 0, 7, 6, 0, 4, 1, 5, 3]"
116,21,71,23,3146,0,38,33,"[11, 3, 8, 4, 8, 10, 2, 7, 6, 5, 6, 9, 0, 7, 4, 10, 0, 11, 11, 0, 3, 3, 3, 11, 5, 10, 4]"
117,21,74,56,3164,0,4,70,"[12, 0, 11, 12, 21, 11, 7, 19, 13, 21, 4, 19, 4, 17, 8, 3, 16, 12, 0, 0, 4, 19, 11, 3, 20, 11, 1]"
118,21,78,20,3222,0,63,15,"[2, 5, 4, 0, 1, 0, 5, 1, 1, 3, 3, 3, 0, 5, 0, 3, 0, 1, 5, 0, 0, 5, 3, 4, 4, 2, 3]"
119,21,24,1,3245,0,15,9,"[3, 1, 3, 0, 1, 3, 1, 3, 1, 0, 0, 0, 1, 1, 0, 2, 3, 2, 1, 0, 0, 2, 1, 0, 0, 3, 3]"
120,21,28,7,3266,0,3,25,"[5, 4, 4, 2, 0, 0, 4, 2, 1, 4, 1, 8, 1, 0, 2, 1, 6, 5, 5, 0, 3, 1, 5, 3, 3, 4, 1]"
121,21,49,7,3308,0,27,22,"[0, 6, 3, 1, 0, 0, 4, 4, 2, 6, 1, 4, 4, 2, 4, 5, 7, 7, 1, 0, 5, 0, 7, 2, 3, 3, 2]"
122,21,10,1,3317,0,2,8,"[2, 2, 0, 2, 1, 1, 1, 1, 1, 0, 1, 1, 0, 0, 1, 1, 1, 1, 2, 0, 2, 2, 1, 1, 0, 1, 0]"
123,21,10,8,3319,0,9,1,"[0, 0, 0, 0, 0, 0, 0, 0, 0, 0, 0, 0, 0, 0, 0, 0, 0, 0, 0, 0, 0, 0, 0, 0, 0, 0, 0]"
124,21,51,44,3326,0,49,2,"[0, 0, 0, 0, 0, 0, 0, 0, 0, 0, 0, 0, 0, 0, 0, 0, 0, 0, 0, 0, 0, 0, 0, 0, 0, 0, 0]"
125,21,96,21,3401,0,30,66,"[13, 22, 9, 15, 22, 16, 1, 19, 11, 14, 0, 22, 12, 17, 8, 9, 5, 0, 16, 0, 1, 4, 22, 10, 11, 21, 2]"
126,21,52,37,3416,0,50,2,"[0, 0, 0, 0, 0, 0, 0, 0, 0, 0, 0, 0, 0, 0, 0, 0, 0, 0, 0, 0, 0, 0, 0, 0, 0, 0, 0]"
127,21,76,57,3435,0,74,2,"[0, 0, 0, 0, 0, 0, 0, 0, 0, 0, 0, 0, 0, 0, 0, 0, 0, 0, 0, 0, 0, 0, 0, 0, 0, 0, 0]"
128,21,83,73,3445,0,75,8,"[1, 0, 2, 0, 2, 2, 0, 2, 1, 0, 1, 2, 0, 0, 0, 2, 0, 1, 1, 0, 0, 1, 1, 1, 2, 0, 1]"
129,21,88,33,3500,0,30,58,"[18, 19, 16, 18, 14, 17, 13, 2, 11, 1, 12, 12, 9, 0, 17, 10, 2, 11, 14, 0, 9, 6, 11, 18, 4, 19, 0]"
130,21,35,11,3524,0,13,22,"[5, 1, 7, 0, 4, 4, 4, 1, 3, 7, 6, 2, 7, 1, 1, 1, 1, 7, 6, 0, 0, 6, 5, 0, 3, 0, 0]"
131,21,96,85,3535,0,80,16,"[1, 4, 2, 3, 4, 3, 1, 1, 4, 2, 3, 0, 0, 3, 2, 1, 5, 3, 0, 0, 5, 5, 2, 1, 5, 3, 3]"
132,21,70,31,3574,0,20,50,"[15, 5, 5, 8, 8, 9, 9, 2, 7, 6, 7, 14, 2, 10, 11, 13, 12, 10, 2, 0, 10, 2, 5, 15, 3, 5, 6]"
133,21,16,10,3580,0,14,2,"[0, 0, 0, 0, 0, 0, 0, 0, 0, 0, 0, 0, 0, 0, 0, 0, 0, 0, 0, 0, 0, 0, 0, 0, 0, 0, 0]"
134,21,66,52,3594,0,17,49,"[0, 8, 8, 1, 0, 13, 15, 15, 0, 9, 14, 12, 5, 15, 13, 12, 13, 7, 10, 0, 15, 2, 15, 8, 9, 13, 13]"
135,21,69,6,3657,0,5,64,"[11, 4, 3, 11, 14, 15, 18, 14, 1, 21, 8, 12, 15, 0, 9, 18, 19, 7, 8, 0, 15, 13, 0, 19, 4, 19, 15]"
136,21,96,3,3750,0,8,88,"[6, 1, 0, 8, 25, 24, 11, 15, 0, 13, 20, 6, 2, 22, 0, 3, 24, 4, 2, 0, 6, 14, 19, 15, 4, 18, 0]"
137,21,0,0,3750,0,0,0,"[0, 0, 0, 0, 0, 0, 0, 0, 0, 0, 0, 0, 0, 0, 0, 0, 0, 0, 0, 0, 0, 0, 0, 0, 0, 0, 0]"
138,21,15,12,3753,0,1,14,"[0, 0, 3, 1, 0, 1, 3, 0, 4, 4, 4, 1, 4, 4, 3, 1, 3, 0, 1, 0, 1, 2, 1, 4, 1, 2, 1]"
139,21,41,28,3766,0,19,22,"[0, 0, 7, 0, 2, 1, 6, 2, 2, 3, 5, 5, 5, 7, 0, 5, 0, 7, 7, 0, 1, 5, 4, 2, 1, 1, 6]"
140,21,92,86,3772,0,57,35,"[2, 6, 2, 0, 8, 5, 9, 8, 2, 10, 2, 8, 0, 1, 1, 8, 1, 6, 10, 0, 10, 9, 1, 10, 1, 8, 1]"
141,21,24,15,3781,0,16,8,"[2, 0, 2, 0, 1, 2, 0, 0, 1, 2, 1, 0, 2, 2, 0, 1, 2, 0, 0, 0, 0, 1, 1, 1, 0, 0, 0]"
142,21,98,19,3860,0,78,20,"[1, 3, 3, 2, 0, 3, 5, 3, 3, 0, 5, 6, 0, 3, 1, 6, 2, 4, 0, 0, 4, 1, 4, 0, 5, 3, 3]"
143,21,40,8,3892,0,11,29,"[5, 0, 5, 3, 7, 8, 1, 7, 6, 1, 0, 6, 8, 4, 9, 9, 5, 5, 8, 0, 7, 8, 3, 0, 3, 9, 5]"
144,21,12,7,3897,0,10,2,"[0, 0, 0, 0, 0, 0, 0, 0, 0, 0, 0, 0, 0, 0, 0, 0, 0, 0, 0, 0, 0, 0, 0, 0, 0, 0, 0]"
145,21,77,72,3902,0,14,63,"[4, 18, 19, 5, 9, 7, 7, 13, 2, 13, 12, 13, 15, 17, 13, 6, 11, 21, 3, 0, 16, 4, 0, 3, 18, 20, 19]"
146,21,23,10,3915,0,18,5,"[1, 0, 1, 0, 1, 0, 0, 0, 1, 0, 0, 0, 1, 0, 0, 1, 0, 1, 1, 0, 1, 0, 0, 1, 0, 0, 0]"
147,21,95,57,3953,0,25,70,"[1, 22, 20, 1, 9, 12, 7, 15, 9, 0, 22, 12, 4, 17, 17, 17, 14, 15, 12, 0, 0, 14, 12, 10, 2, 16, 5]"
148,21,13,6,3960,0,10,3,"[0, 0, 0, 0, 0, 0, 0, 1, 0, 0, 1, 1, 1, 0, 0, 0, 0, 1, 0, 0, 0, 1, 0, 1, 1, 0, 1]"
149,21,17,16,3961,0,14,3,"[1, 1, 0, 1, 0, 0, 0, 1, 1, 0, 1, 0, 1, 0, 0, 0, 1, 0, 1, 0, 0, 0, 1, 1, 1, 1, 0]"
150,21,21,18,3964,0,4,17,"[3, 3, 0, 5, 0, 5, 4, 0, 0, 0, 3, 4, 2, 4, 4, 0, 2, 0, 2, 0, 4, 3, 4, 1, 0, 2, 4]"
151,21,7,5,3966,0,2,5,"[1, 0, 0, 1, 1, 1, 1, 1, 0, 1, 1, 1, 0, 1, 0, 1, 1, 0, 1, 0, 0, 0, 0, 0, 1, 0, 1]"
152,21,21,15,3972,0,12,9,"[3, 0, 0, 3, 2, 2, 1, 3, 2, 0, 2, 0, 0, 1, 2, 2, 0, 3, 3, 0, 0, 3, 0, 3, 1, 2, 1]"
153,21,98,57,4013,0,91,7,"[0, 1, 0, 2, 0, 1, 0, 2, 0, 1, 0, 1, 0, 2, 0, 1, 1, 2, 0, 0, 0, 0, 2, 0, 0, 0, 2]"
154,21,34,6,4041,0,21,13,"[1, 2, 1, 0, 3, 2, 1, 3, 1, 1, 2, 1, 0, 2, 0, 4, 3, 2, 2, 0, 4, 2, 0, 0, 2, 1, 2]"
155,21,65,35,4071,0,56,9,"[0, 3, 0, 1, 3, 0, 2, 3, 1, 3, 2, 0, 0, 1, 1, 3, 0, 2, 3, 0, 3, 0, 1, 0, 0, 1, 2]"
156,21,79,29,4121,0,15,64,"[12, 0, 12, 7, 13, 6, 15, 5, 10, 3, 14, 13, 4, 10, 4, 17, 21, 7, 2, 0, 3, 19, 16, 13, 14, 7, 4]"
157,21,35,18,4138,0,1,34,"[1, 8, 4, 0, 7, 9, 1, 10, 4, 9, 1, 4, 10, 5, 10, 11, 0, 2, 10, 0, 3, 4, 5, 7, 4, 6, 5]"
158,21,66,38,4166,0,53,13,"[3, 3, 1, 1, 0, 1, 2, 1, 1, 3, 2, 0, 1, 1, 1, 4, 0, 2, 1, 0, 3, 2, 2, 1, 3, 0, 1]"
159,21,79,23,4222,0,57,22,"[7, 6, 0, 1, 7, 5, 7, 4, 2, 0, 3, 6, 5, 7, 7, 3, 5, 5, 7, 0, 6, 3, 6, 7, 6, 5, 0]"
160,21,62,13,4271,0,40,22,"[6, 3, 5, 5, 1, 0, 2, 6, 1, 1, 2, 0, 2, 6, 7, 1, 7, 4, 4, 0, 4, 0, 5, 0, 4, 5, 4]"
161,21,92,22,4341,0,56,36,"[9, 10, 6, 3, 10, 6, 11, 9, 11, 5, 1, 10, 9, 3, 0, 4, 12, 4, 3, 0, 5, 9, 9, 1, 9, 2, 1]"
162,21,64,20,4385,0,61,3,"[1, 0, 1, 0, 0, 1, 1, 0, 1, 0, 0, 0, 0, 0, 0, 1, 0, 0, 1, 0, 0, 0, 0, 0, 0, 0, 0]"
163,21,51,20,4416,0,1,50,"[13, 3, 6, 9, 15, 7, 16, 10, 4, 12, 2, 0, 11, 11, 3, 5, 15, 13, 13, 0, 16, 11, 0, 2, 12, 15, 9]"
164,21,19,12,4423,0,15,4,"[1, 0, 1, 1, 0, 1, 0, 0, 1, 1, 0, 1, 0, 1, 0, 0, 1, 1, 1, 0, 1, 0, 0, 0, 1, 1, 0]"
165,21,1,0,4417,0,1,0,"[0, 0, 0, 0, 0, 0, 0, 0, 0, 0, 0, 0, 0, 0, 0, 0, 0, 0, 0, 0, 0, 0, 0, 0, 0, 0, 0]"
166,21,90,64,4443,0,48,42,"[3, 3, 5, 12, 8, 14, 0, 1, 6, 0, 3, 12, 10, 3, 9, 12, 1, 13, 3, 0, 3, 2, 1, 8, 12, 5, 14]"
167,21,13,12,4444,0,9,4,"[1, 0, 1, 0, 0, 1, 0, 1, 0, 0, 0, 1, 0, 0, 1, 0, 1, 1, 1, 0, 1, 1, 0, 0, 0, 1, 1]"
168,21,29,16,4457,0,21,8,"[1, 2, 0, 0, 2, 2, 2, 1, 2, 1, 1, 2, 2, 0, 1, 2, 2, 0, 0, 0, 2, 2, 0, 0, 1, 2, 2]"
169,21,12,5,4464,0,9,3,"[1, 0, 0, 1, 0, 0, 1, 0, 1, 0, 1, 1, 0, 1, 0, 0, 0, 1, 0, 0, 0, 0, 0, 0, 0, 0, 1]"
170,21,73,7,4530,0,52,21,"[3, 5, 2, 4, 0, 1, 4, 7, 1, 2, 1, 5, 5, 1, 3, 1, 6, 0, 3, 0, 5, 5, 3, 7, 1, 5, 1]"
171,21,26,6,4550,0,2,24,"[2, 1, 5, 8, 8, 3, 2, 0, 3, 1, 3, 0, 8, 8, 5, 7, 4, 5, 0, 0, 8, 4, 5, 3, 1, 7, 8]"
172,21,34,25,4559,0,27,7,"[0, 0, 1, 1, 2, 0, 2, 2, 2, 2, 0, 2, 2, 0, 2, 1, 0, 2, 1, 0, 0, 1, 2, 0, 2, 0, 0]"
173,21,68,14,4613,0,63,5,"[0, 0, 1, 1, 0, 1, 1, 0, 1, 0, 1, 0, 1, 0, 1, 0, 0, 0, 1, 0, 1, 1, 1, 1, 0, 1, 1]"
174,21,62,6,4669,0,13,49,"[5, 11, 3, 16, 3, 7, 10, 12, 12, 3, 14, 1, 13, 6, 10, 10, 11, 8, 12, 0, 12, 7, 10, 0, 8, 13, 0]"
175,21,30,7,4692,0,1,29,"[6, 4, 0, 6, 2, 0, 4, 1, 9, 1, 5, 2, 3, 0, 7, 8, 8, 4, 0, 0, 9, 5, 2, 8, 6, 7, 0]"
176,21,27,5,4714,0,3,24,"[1, 2, 1, 2, 6, 8, 0, 2, 1, 2, 2, 6, 7, 5, 1, 8, 0, 4, 2, 0, 3, 8, 5, 8, 7, 4, 8]"
177,21,39,26,4727,0,24,15,"[2, 4, 1, 2, 2, 1, 3, 1, 0, 0, 5, 0, 1, 0, 4, 3, 3, 2, 0, 0, 0, 3, 2, 0, 5, 0, 1]"
178,21,65,27,4765,0,22,43,"[0, 7, 12, 10, 4, 5, 3, 10, 5, 7, 9, 7, 11, 6, 14, 3, 3, 11, 10, 0, 7, 4, 2, 1, 14, 9, 0]"
179,21,84,42,4807,0,60,24,"[7, 0, 2, 8, 3, 3, 2, 2, 3, 4, 7, 5, 6, 0, 0, 4, 8, 1, 4, 0, 7, 2, 8, 5, 0, 7, 0]"
180,21,82,81,4808,0,44,38,"[7, 9, 2, 7, 4, 2, 1, 2, 7, 6, 0, 2, 5, 4, 1, 7, 4, 10, 11, 0, 0, 12, 0, 8, 12, 12, 4]"
181,21,96,30,4874,0,24,72,"[8, 5, 1, 8, 13, 15, 14, 9, 4, 7, 18, 11, 0, 21, 10, 24, 22, 2, 10, 0, 3, 13, 8, 5, 3, 17, 19]"
182,21,16,8,4882,0,6,10,"[3, 1, 1, 1, 3, 3, 3, 3, 1, 0, 0, 2, 2, 3, 2, 2, 0, 2, 1, 0, 3, 1, 3, 3, 2, 3, 2]"
183,21,45,24,4903,0,34,11,"[1, 0, 3, 1, 0, 1, 0, 1, 3, 3, 1, 2, 1, 0, 3, 1, 2, 1, 0, 0, 1, 1, 2, 0, 0, 0, 1]"
184,21,55,24,4934,0,1,54,"[18, 3, 8, 7, 11, 11, 8, 9, 17, 18, 8, 4, 11, 3, 4, 11, 5, 15, 5, 0, 4, 14, 5, 1, 17, 10, 11]"
185,21,27,26,4935,0,5,22,"[6, 4, 2, 7, 3, 3, 6, 1, 4, 0, 1, 4, 4, 7, 3, 7, 0, 2, 0, 0, 6, 4, 0, 7, 4, 3, 7]"
186,21,56,33,4958,0,51,5,"[0, 0, 0, 1, 0, 1, 0, 1, 1, 1, 0, 1, 1, 0, 1, 1, 0, 1, 0, 0, 0, 0, 0, 0, 1, 0, 1]"
187,21,12,5,4965,0,8,4,"[0, 0, 0, 1, 0, 0, 1, 0, 0, 1, 0, 0, 1, 0, 1, 0, 0, 1, 1, 0, 0, 0, 0, 1, 1, 0, 1]"
188,21,5,3,4967,0,0,5,"[1, 1, 0, 0, 1, 0, 0, 0, 0, 1, 0, 1, 1, 1, 1, 0, 0, 0, 0, 0, 0, 1, 1, 0, 1, 0, 0]"
189,21,50,39,4978,0,0,50,"[7, 12, 7, 10, 14, 7, 15, 0, 12, 6, 15, 2, 6, 13, 14, 16, 12, 8, 12, 0, 12, 1, 11, 5, 8, 1, 11]"
190,21,19,9,4988,0,6,13,"[4, 0, 3, 2, 4, 4, 2, 1, 2, 4, 1, 3, 1, 4, 4, 4, 4, 1, 0, 0, 1, 1, 1, 1, 1, 3, 4]"
191,21,79,23,5044,0,60,19,"[3, 3, 2, 0, 5, 0, 2, 5, 6, 6, 0, 5, 2, 3, 2, 1, 5, 6, 1, 0, 3, 2, 0, 4, 6, 6, 0]"
192,21,69,22,5091,0,2,67,"[19, 10, 17, 8, 10, 0, 6, 14, 17, 10, 5, 22, 15, 10, 21, 3, 11, 3, 1, 0, 8, 9, 22, 6, 20, 22, 19]"
193,21,39,12,5118,0,28,11,"[2, 0, 3, 0, 1, 1, 0, 1, 3, 1, 1, 2, 2, 3, 0, 0, 2, 0, 3, 0, 2, 1, 2, 1, 3, 3, 1]"
194,21,55,3,5170,0,24,31,"[9, 0, 10, 10, 0, 6, 2, 1, 7, 5, 3, 8, 9, 1, 4, 9, 4, 0, 3, 0, 6, 10, 1, 5, 8, 5, 10]"
195,21,19,14,5175,0,1,18,"[2, 2, 1, 6, 5, 1, 4, 3, 3, 5, 5, 2, 2, 5, 0, 1, 1, 0, 4, 0, 1, 0, 2, 6, 6, 1, 0]"
196,21,94,89,5180,0,23,71,"[19, 17, 12, 0, 0, 6, 11, 23, 1, 20, 23, 6, 0, 2, 21, 11, 12, 21, 5, 0, 22, 8, 19, 0, 17, 12, 10]"
197,21,88,1,5267,0,62,26,"[7, 5, 7, 5, 2, 5, 2, 1, 1, 6, 2, 4, 1, 1, 6, 1, 4, 4, 3, 0, 3, 8, 7, 6, 0, 6, 3]"
198,21,76,49,5294,0,19,57,"[3, 11, 2, 2, 4, 14, 19, 6, 5, 16, 9, 13, 7, 1, 3, 11, 17, 10, 5, 0, 18, 10, 10, 5, 17, 12, 19]"
199,21,78,38,5334,0,31,47,"[11, 8, 2, 6, 7, 8, 12, 0, 11, 11, 1, 14, 15, 0, 0, 5, 11, 4, 4, 0, 5, 14, 13, 3, 13, 3, 13]"
200,21,86,75,5345,0,47,39,"[13, 6, 0, 3, 6, 7, 2, 5, 7, 12, 2, 3, 9, 2, 0, 6, 9, 12, 2, 0, 11, 0, 4, 1, 5, 10, 2]"
201,21,46,32,5359,0,25,21,"[5, 7, 1, 5, 1, 3, 7, 4, 6, 4, 1, 4, 5, 0, 2, 3, 3, 6, 5, 0, 6, 1, 6, 2, 2, 4, 3]"
202,21,31,5,5385,0,2,29,"[8, 0, 8, 7, 7, 3, 1, 3, 8, 7, 3, 8, 1, 0, 8, 6, 5, 6, 5, 0, 4, 4, 5, 7, 0, 7, 7]"
203,21,67,40,5412,0,19,48,"[5, 5, 14, 3, 4, 5, 3, 16, 11, 3, 16, 11, 15, 16, 15, 3, 12, 14, 11, 0, 12, 6, 13, 2, 4, 3, 4]"
204,21,41,19,5434,0,12,29,"[0, 5, 5, 8, 1, 1, 8, 9, 0, 1, 9, 5, 3, 5, 6, 9, 1, 2, 0, 0, 5, 0, 5, 3, 0, 3, 9]"
205,21,20,14,5440,0,20,0,"[0, 0, 0, 0, 0, 0, 0, 0, 0, 0, 0, 0, 0, 0, 0, 0, 0, 0, 0, 0, 0, 0, 0, 0, 0, 0, 0]"
206,21,98,78,5460,0,46,52,"[6, 2, 17, 3, 0, 7, 8, 12, 0, 9, 10, 5, 17, 8, 6, 15, 15, 0, 3, 0, 2, 7, 10, 15, 4, 3, 2]"
207,21,62,36,5486,0,1,61,"[5, 16, 18, 18, 19, 14, 2, 19, 3, 17, 19, 17, 8, 17, 3, 10, 3, 11, 16, 0, 3, 19, 20, 3, 7, 16, 1]"
208,21,99,69,5516,0,73,26,"[5, 5, 8, 8, 6, 0, 0, 7, 1, 8, 1, 5, 5, 7, 5, 4, 1, 8, 6, 0, 8, 5, 2, 4, 4, 6, 1]"
209,21,8,4,5520,0,3,5,"[0, 0, 1, 1, 0, 0, 0, 1, 0, 1, 0, 0, 0, 0, 0, 0, 1, 0, 1, 0, 1, 1, 1, 1, 1, 0, 0]"
210,21,70,13,5577,0,57,13,"[1, 4, 0, 1, 4, 3, 2, 4, 2, 2, 2, 1, 4, 2, 0, 1, 0, 2, 3, 0, 3, 4, 2, 4, 1, 1, 4]"
211,21,85,72,5590,0,49,36,"[6, 4, 6, 5, 12, 1, 12, 11, 1, 12, 4, 2, 1, 7, 4, 7, 0, 12, 10, 0, 9, 7, 12, 0, 3, 5, 8]"
212,21,54,52,5592,0,38,16,"[1, 0, 3, 1, 3, 1, 3, 5, 5, 0, 0, 3, 0, 1, 3, 0, 1, 0, 2, 0, 0, 3, 4, 3, 3, 1, 0]"
213,21,18,3,5607,0,6,12,"[1, 4, 3, 1, 2, 1, 1, 1, 0, 2, 1, 1, 4, 2, 2, 0, 2, 3, 0, 0, 2, 4, 2, 3, 3, 3, 4]"
214,21,96,60,5643,0,25,71,"[3, 23, 2, 2, 17, 13, 9, 12, 20, 14, 15, 7, 22, 15, 10, 0, 7, 0, 18, 0, 11, 1, 1, 21, 9, 5, 23]"
215,21,31,15,5659,0,3,28,"[8, 5, 7, 2, 9, 8, 0, 9, 7, 1, 8, 5, 2, 8, 2, 8, 0, 1, 0, 0, 8, 1, 0, 5, 5, 2, 5]"
216,21,79,53,5685,0,11,68,"[22, 16, 21, 14, 5, 12, 16, 10, 4, 1, 18, 21, 4, 18, 20, 13, 1, 16, 15, 0, 1, 8, 7, 0, 20, 14, 0]"
217,21,79,65,5699,0,39,40,"[10, 3, 1, 6, 5, 5, 1, 9, 8, 13, 12, 7, 1, 5, 1, 9, 10, 10, 3, 0, 5, 1, 6, 12, 0, 12, 11]"
218,21,85,37,5747,0,52,33,"[4, 3, 11, 10, 2, 0, 1, 3, 2, 3, 11, 8, 11, 11, 0, 0, 0, 5, 9, 0, 2, 5, 10, 7, 2, 9, 11]"
219,21,24,17,5754,0,10,14,"[2, 3, 1, 3, 3, 2, 0, 3, 4, 1, 1, 2, 4, 3, 3, 1, 2, 3, 2, 0, 2, 4, 3, 2, 3, 3, 1]"
220,21,91,90,5755,0,43,48,"[1, 15, 14, 3, 10, 10, 16, 10, 9, 4, 8, 1, 11, 14, 10, 0, 15, 12, 2, 0, 14, 8, 9, 9, 9, 12, 10]"
221,21,33,7,5781,0,16,17,"[1, 3, 2, 2, 0, 0, 1, 2, 4, 1, 2, 2, 3, 5, 5, 1, 1, 0, 2, 0, 5, 1, 4, 4, 0, 5, 1]"
222,21,93,2,5872,0,66,27,"[6, 7, 9, 4, 3, 9, 4, 7, 0, 2, 6, 3, 5, 0, 2, 3, 0, 8, 2, 0, 8, 8, 1, 2, 3, 6, 0]"
223,21,88,45,5915,0,58,30,"[4, 7, 5, 6, 9, 4, 8, 4, 5, 7, 1, 7, 7, 10, 7, 2, 0, 1, 8, 0, 9, 4, 10, 10, 8, 7, 2]"
224,21,48,22,5941,0,25,23,"[6, 2, 7, 5, 3, 6, 3, 2, 3, 3, 1, 7, 6, 2, 6, 0, 4, 0, 3, 0, 1, 4, 4, 5, 6, 4, 5]"
225,21,69,61,5949,0,7,62,"[0, 15, 7, 9, 16, 14, 10, 12, 2, 0, 6, 4, 15, 8, 17, 3, 10, 12, 19, 0, 16, 19, 18, 14, 4, 16, 0]"
226,21,73,24,5998,0,0,73,"[22, 21, 0, 20, 12, 11, 21, 1, 5, 6, 5, 8, 24, 23, 14, 2, 1, 15, 19, 0, 12, 19, 10, 12, 6, 24, 1]"
227,21,51,49,6000,0,45,6,"[2, 1, 1, 1, 1, 2, 1, 1, 0, 2, 0, 0, 2, 1, 2, 2, 1, 2, 2, 0, 2, 2, 2, 1, 2, 2, 2]"
228,21,93,18,6075,0,58,35,"[0, 8, 5, 3, 2, 8, 5, 8, 8, 3, 1, 1, 6, 5, 0, 3, 8, 1, 1, 0, 11, 3, 4, 1, 2, 10, 8]"
229,21,70,8,6137,0,20,50,"[16, 12, 11, 3, 15, 8, 7, 0, 9, 14, 0, 7, 9, 4, 10, 9, 8, 11, 6, 0, 13, 8, 1, 11, 3, 9, 12]"
230,21,12,9,6140,0,4,8,"[2, 1, 0, 1, 0, 1, 2, 0, 0, 1, 2, 0, 1, 1, 1, 2, 1, 1, 2, 0, 1, 1, 2, 1, 0, 0, 1]"
231,21,80,79,6141,0,32,48,"[5, 8, 11, 8, 2, 15, 9, 2, 10, 9, 16, 9, 14, 0, 11, 14, 11, 8, 1, 0, 2, 9, 6, 13, 14, 0, 2]"
232,21,61,46,6156,0,27,34,"[8, 5, 3, 10, 2, 4, 8, 5, 10, 3, 9, 0, 6, 10, 1, 8, 7, 9, 2, 0, 7, 6, 5, 6, 9, 0, 6]"
233,21,53,20,6189,0,13,40,"[2, 9, 0, 5, 6, 5, 6, 2, 13, 11, 7, 7, 2, 12, 3, 13, 13, 3, 3, 0, 12, 1, 10, 0, 11, 4, 7]"
234,21,55,19,6225,0,24,31,"[7, 8, 10, 2, 6, 3, 0, 4, 3, 3, 9, 1, 9, 7, 2, 10, 2, 8, 3, 0, 7, 10, 4, 3, 9, 2, 2]"
235,21,13,7,6231,0,10,3,"[1, 1, 1, 0, 0, 1, 0, 0, 1, 0, 1, 0, 1, 1, 1, 1, 1, 1, 0, 0, 1, 0, 0, 1, 1, 0, 1]"
236,21,93,9,6315,0,69,24,"[4, 0, 0, 3, 5, 0, 8, 2, 7, 2, 0, 4, 6, 2, 2, 4, 3, 4, 4, 0, 7, 1, 1, 1, 0, 6, 0]"
237,21,45,4,6356,0,23,22,"[7, 1, 3, 7, 0, 0, 7, 4, 4, 2, 5, 4, 2, 6, 1, 4, 5, 3, 3, 0, 3, 3, 6, 7, 0, 7, 0]"
238,21,83,6,6433,0,5,78,"[12, 6, 10, 1, 11, 11, 23, 6, 26, 23, 20, 6, 21, 0, 20, 2, 17, 12, 15, 0, 1, 17, 15, 12, 19, 14, 1]"
239,21,0,0,6433,0,0,0,"[0, 0, 0, 0, 0, 0, 0, 0, 0, 0, 0, 0, 0, 0, 0, 0, 0, 0, 0, 0, 0, 0, 0, 0, 0, 0, 0]"
240,21,32,2,6463,0,20,12,"[1, 4, 0, 2, 4, 3, 2, 0, 4, 4, 0, 4, 4, 2, 2, 2, 2, 4, 0, 0, 4, 2, 3, 4, 4, 3, 3]"
241,21,35,8,6490,0,9,26,"[0, 1, 8, 2, 5, 5, 7, 6, 6, 5, 1, 4, 5, 5, 1, 4, 3, 4, 2, 0, 8, 4, 4, 2, 1, 5, 8]"
242,21,20,2,6508,0,2,18,"[4, 5, 3, 2, 4, 1, 4, 3, 4, 6, 0, 2, 1, 2, 6, 2, 0, 5, 3, 0, 6, 6, 1, 4, 5, 2, 5]"
243,21,36,3,6541,0,31,5,"[1, 0, 0, 1, 1, 1, 0, 1, 1, 1, 0, 0, 1, 0, 0, 1, 0, 1, 1, 0, 0, 1, 0, 0, 1, 0, 0]"
244,21,20,11,6550,0,12,8,"[2, 0, 1, 2, 0, 1, 1, 0, 2, 2, 2, 1, 2, 2, 2, 2, 1, 0, 0, 0, 2, 2, 1, 0, 1, 0, 0]"
245,21,64,6,6608,0,11,53,"[3, 0, 3, 17, 4, 4, 3, 17, 12, 10, 17, 15, 4, 13, 16, 9, 13, 17, 9, 0, 7, 13, 16, 12, 11, 5, 12]"
246,21,39,4,6643,0,34,5,"[0, 0, 1, 0, 0, 1, 1, 0, 0, 0, 1, 0, 1, 1, 0, 1, 0, 0, 0, 0, 0, 1, 0, 0, 1, 1, 0]"
247,21,45,14,6674,0,43,2,"[0, 0, 0, 0, 0, 0, 0, 0, 0, 0, 0, 0, 0, 0, 0, 0, 0, 0, 0, 0, 0, 0, 0, 0, 0, 0, 0]"
248,21,59,33,6700,0,34,25,"[7, 1, 1, 6, 0, 6, 2, 3, 4, 1, 1, 4, 7, 0, 6, 2, 3, 8, 1, 0, 7, 2, 6, 7, 5, 2, 5]"
249,21,43,25,6718,0,34,9,"[1, 0, 1, 3, 3, 0, 0, 3, 3, 3, 0, 0, 0, 0, 0, 0, 3, 2, 1, 0, 2, 2, 1, 1, 1, 2, 2]"
250,21,20,14,6724,0,18,2,"[0, 0, 0, 0, 0, 0, 0, 0, 0, 0, 0, 0, 0, 0, 0, 0, 0, 0, 0, 0, 0, 0, 0, 0, 0, 0, 0]"
251,21,40,2,6762,0,7,33,"[6, 6, 6, 11, 11, 2, 6, 0, 8, 10, 0, 11, 6, 3, 10, 7, 0, 11, 9, 0, 7, 4, 2, 8, 7, 4, 11]"
252,21,54,20,6796,0,53,1,"[0, 0, 0, 0, 0, 0, 0, 0, 0, 0, 0, 0, 0, 0, 0, 0, 0, 0, 0, 0, 0, 0, 0, 0, 0, 0, 0]"
253,21,45,0,6841,0,7,38,"[3, 3, 4, 9, 11, 7, 2, 3, 12, 3, 9, 0, 1, 0, 5, 8, 1, 12, 5, 0, 10, 6, 12, 2, 3, 0, 5]"
254,21,71,60,6852,0,46,25,"[3, 6, 3, 3, 5, 4, 1, 8, 7, 1, 2, 2, 5, 5, 1, 7, 1, 4, 7, 0, 2, 7, 1, 3, 7, 6, 7]"
255,21,38,38,6852,0,22,16,"[0, 4, 3, 2, 3, 5, 0, 5, 4, 5, 0, 4, 3, 1, 2, 2, 0, 1, 3, 0, 2, 3, 5, 4, 1, 3, 3]"
256,21,82,14,6920,0,28,54,"[17, 17, 8, 3, 2, 6, 15, 6, 0, 17, 9, 18, 7, 3, 5, 5, 5, 2, 12, 0, 15, 11, 10, 2, 9, 13, 5]"
257,21,13,9,6924,0,4,9,"[1, 1, 0, 1, 2, 2, 2, 1, 1, 0, 0, 3, 0, 0, 0, 1, 2, 3, 2, 0, 2, 3, 1, 0, 0, 1, 3]"
258,21,19,18,6925,0,13,6,"[0, 2, 2, 2, 2, 2, 2, 2, 2, 1, 1, 2, 2, 0, 2, 2, 1, 0, 1, 0, 1, 1, 1, 2, 1, 2, 0]"
259,21,2,1,6926,0,2,0,"[0, 0, 0, 0, 0, 0, 0, 0, 0, 0, 0, 0, 0, 0, 0, 0, 0, 0, 0, 0, 0, 0, 0, 0, 0, 0, 0]"
260,21,87,70,6943,0,31,56,"[15, 17, 14, 15, 14, 4, 7, 0, 1, 0, 8, 7, 18, 7, 17, 1, 18, 11, 2, 0, 3, 14, 13, 5, 4, 1, 10]"
261,21,5,2,6946,0,0,5,"[0, 0, 1, 0, 0, 0, 1, 0, 1, 0, 0, 1, 1, 1, 0, 1, 0, 0, 1, 0, 1, 1, 1, 0, 1, 1, 0]"
262,21,100,63,6983,0,19,81,"[22, 14, 7, 24, 27, 20, 24, 4, 8, 14, 1, 24, 25, 11, 1, 14, 1, 12, 1, 0, 18, 20, 24, 0, 17, 13, 10]"
263,21,21,11,6993,0,3,18,"[4, 6, 3, 3, 4, 4, 2, 1, 4, 6, 3, 0, 6, 6, 2, 1, 4, 1, 2, 0, 4, 3, 6, 1, 6, 1, 2]"
264,21,28,2,7019,0,18,10,"[1, 0, 0, 2, 3, 1, 3, 1, 0, 3, 2, 3, 3, 0, 2, 3, 1, 3, 3, 0, 1, 1, 1, 1, 1, 1, 3]"
265,21,3,2,7020,0,3,0,"[0, 0, 0, 0, 0, 0, 0, 0, 0, 0, 0, 0, 0, 0, 0, 0, 0, 0, 0, 0, 0, 0, 0, 0, 0, 0, 0]"
266,21,3,0,7023,0,0,3,"[1, 0, 0, 1, 0, 1, 0, 0, 0, 1, 0, 1, 1, 1, 1, 0, 0, 1, 1, 0, 0, 1, 1, 1, 0, 0, 1]"
267,21,26,26,7023,0,23,3,"[1, 0, 0, 1, 1, 0, 0, 0, 0, 0, 1, 0, 1, 1, 0, 1, 1, 1, 0, 0, 0, 1, 1, 0, 1, 0, 1]"
268,21,94,69,7048,0,35,59,"[15, 8, 9, 19, 11, 5, 12, 5, 16, 11, 3, 16, 17, 8, 18, 16, 5, 19, 12, 0, 9, 4, 16, 16, 9, 7, 0]"
269,21,86,49,7085,0,83,3,"[0, 1, 0, 0, 1, 0, 0, 1, 1, 0, 1, 0, 0, 0, 1, 1, 0, 1, 1, 0, 0, 1, 0, 1, 0, 1, 1]"
270,21,95,66,7114,0,23,72,"[10, 1, 14, 12, 8, 16, 16, 21, 22, 10, 17, 3, 8, 20, 1, 16, 21, 22, 10, 0, 3, 23, 4, 9, 16, 13, 22]"
271,21,18,4,7128,0,1,17,"[3, 0, 3, 4, 5, 3, 5, 5, 4, 4, 4, 2, 0, 1, 3, 0, 4, 2, 4, 0, 2, 0, 0, 3, 5, 1, 1]"
272,21,35,30,7133,0,6,29,"[8, 2, 3, 9, 1, 4, 1, 8, 2, 1, 7, 3, 6, 1, 8, 3, 7, 7, 2, 0, 9, 3, 8, 4, 8, 0, 4]"
273,21,99,9,7223,0,44,55,"[1, 9, 16, 3, 1, 12, 5, 7, 17, 10, 16, 11, 1, 2, 1, 5, 1, 15, 18, 0, 11, 15, 18, 5, 8, 16, 12]"
274,21,14,7,7230,0,0,14,"[2, 2, 0, 4, 3, 0, 2, 2, 4, 3, 1, 0, 2, 0, 1, 2, 1, 0, 2, 0, 3, 2, 1, 3, 2, 4, 4]"
275,21,30,11,7249,0,16,14,"[2, 3, 1, 2, 4, 1, 2, 1, 4, 3, 1, 3, 1, 4, 1, 4, 3, 1, 0, 0, 3, 4, 0, 3, 1, 3, 3]"
276,21,90,84,7255,0,18,72,"[15, 11, 5, 16, 1, 22, 21, 14, 21, 23, 24, 21, 18, 9, 23, 23, 21, 8, 22, 0, 14, 8, 3, 8, 19, 18, 20]"
277,21,15,14,7256,0,3,12,"[0, 1, 0, 1, 4, 4, 1, 4, 3, 4, 4, 3, 3, 1, 1, 1, 0, 2, 2, 0, 1, 4, 3, 0, 0, 1, 2]"
278,21,41,39,7258,0,37,4,"[0, 1, 1, 1, 0, 0, 1, 0, 0, 0, 1, 0, 0, 0, 1, 1, 1, 0, 1, 0, 1, 1, 1, 1, 1, 0, 0]"
279,21,48,44,7262,0,23,25,"[5, 4, 3, 8, 1, 1, 0, 6, 3, 7, 3, 6, 1, 6, 5, 6, 1, 1, 2, 0, 4, 0, 0, 3, 6, 7, 4]"
280,21,37,14,7285,0,0,37,"[10, 5, 5, 12, 4, 6, 8, 2, 8, 11, 1, 10, 1, 9, 12, 7, 2, 3, 10, 0, 8, 2, 2, 6, 1, 2, 6]"
281,21,25,6,7304,0,25,0,"[0, 0, 0, 0, 0, 0, 0, 0, 0, 0, 0, 0, 0, 0, 0, 0, 0, 0, 0, 0, 0, 0, 0, 0, 0, 0, 0]"
282,21,39,29,7314,0,37,2,"[0, 0, 0, 0, 0, 0, 0, 0, 0, 0, 0, 0, 0, 0, 0, 0, 0, 0, 0, 0, 0, 0, 0, 0, 0, 0, 0]"
283,21,96,4,7406,0,86,10,"[3, 2, 0, 2, 0, 1, 0, 2, 1, 1, 3, 2, 3, 2, 3, 0, 0, 1, 0, 0, 2, 1, 3, 2, 1, 1, 1]"
284,21,35,6,7435,0,13,22,"[4, 6, 5, 2, 7, 5, 2, 3, 3, 7, 0, 2, 7, 0, 5, 1, 5, 6, 7, 0, 1, 3, 1, 3, 3, 7, 2]"
285,21,67,56,7446,0,21,46,"[9, 5, 14, 7, 13, 4, 4, 9, 10, 6, 13, 4, 5, 6, 0, 4, 12, 0, 6, 0, 15, 14, 8, 2, 10, 0, 1]"
286,21,44,25,7465,0,20,24,"[1, 4, 3, 0, 3, 8, 3, 7, 4, 5, 7, 3, 3, 3, 7, 3, 1, 8, 0, 0, 8, 6, 1, 6, 2, 6, 7]"
287,21,93,69,7489,0,55,38,"[8, 0, 4, 9, 9, 5, 3, 10, 3, 2, 2, 1, 3, 2, 3, 12, 6, 10, 5, 0, 10, 5, 4, 3, 9, 11, 1]"
288,21,41,14,7516,0,40,1,"[0, 0, 0, 0, 0, 0, 0, 0, 0, 0, 0, 0, 0, 0, 0, 0, 0, 0, 0, 0, 0, 0, 0, 0, 0, 0, 0]"
289,21,19,6,7529,0,8,11,"[1, 2, 0, 2, 1, 0, 0, 2, 1, 0, 2, 1, 3, 1, 3, 1, 1, 0, 0, 0, 2, 3, 3, 3, 0, 0, 3]"
290,21,72,50,7551,0,26,46,"[2, 13, 7, 12, 2, 1, 9, 6, 11, 6, 11, 15, 3, 9, 11, 8, 13, 6, 12, 0, 10, 1, 8, 9, 7, 4, 2]"
291,21,92,56,7587,0,3,89,"[19, 29, 23, 23, 8, 19, 17, 14, 12, 26, 4, 17, 4, 17, 13, 25, 15, 11, 9, 0, 7, 18, 20, 16, 3, 22, 17]"
292,21,23,18,7592,0,10,13,"[1, 4, 1, 1, 1, 2, 3, 0, 0, 1, 0, 0, 2, 3, 1, 0, 0, 2, 4, 0, 4, 1, 4, 1, 0, 3, 3]"
293,21,67,56,7603,0,39,28,"[6, 4, 9, 1, 9, 5, 4, 4, 5, 0, 7, 0, 4, 9, 1, 2, 5, 6, 7, 0, 1, 0, 0, 0, 1, 5, 9]"
294,21,56,39,7620,0,39,17,"[3, 1, 2, 2, 3, 0, 3, 3, 5, 3, 4, 3, 5, 4, 2, 2, 0, 0, 3, 0, 3, 0, 3, 1, 4, 0, 2]"
295,21,36,3,7653,0,7,29,"[3, 8, 3, 6, 6, 0, 6, 9, 0, 0, 6, 0, 1, 3, 1, 5, 8, 9, 9, 0, 1, 6, 5, 3, 4, 9, 1]"
296,21,80,1,7732,0,22,58,"[11, 6, 6, 0, 10, 16, 7, 4, 12, 3, 4, 19, 19, 10, 8, 2, 5, 1, 15, 0, 8, 9, 10, 13, 13, 3, 14]"
297,21,85,15,7802,0,8,77,"[14, 11, 3, 14, 0, 6, 2, 13, 0, 16, 6, 7, 7, 3, 20, 21, 21, 23, 10, 0, 11, 6, 19, 13, 18, 4, 6]"
298,21,92,14,7880,0,7,85,"[21, 24, 17, 22, 6, 15, 11, 21, 24, 13, 23, 28, 0, 28, 12, 14, 6, 17, 20, 0, 4, 18, 19, 6, 27, 15, 8]"
299,21,77,77,7880,0,37,40,"[13, 6, 8, 0, 4, 12, 13, 2, 11, 2, 11, 4, 11, 10, 1, 5, 5, 4, 13, 0, 10, 0, 1, 8, 4, 8, 7]"
0,22,1973,0,1973,0,1376,597,"[125, 109, 60, 166, 121, 47, 99, 107, 64, 194, 172, 102, 56, 162, 190, 16, 166, 123, 132, 37, 0, 69, 136, 150, 2, 179, 9]"
1,22,2930,2215,2688,0,1484,1446,"[143, 52, 103, 407, 106, 60, 466, 228, 316, 61, 142, 27, 252, 368, 156, 136, 356, 79, 19, 352, 0, 467, 464, 146, 266, 85, 340]"
2,22,2365,1357,3696,0,1246,1119,"[214, 47, 117, 13, 18, 32, 331, 38, 297, 238, 335, 270, 8, 18, 75, 302, 68, 193, 191, 42, 0, 277, 176, 200, 66, 41, 191]"
3,22,1354,510,4540,0,1220,134,"[41, 6, 12, 26, 44, 14, 43, 27, 42, 26, 13, 37, 41, 9, 15, 44, 7, 24, 16, 29, 0, 32, 24, 14, 41, 18, 11]"
4,22,1783,1051,5272,0,669,1114,"[230, 104, 116, 304, 39, 28, 263, 35, 130, 108, 123, 38, 84, 247, 147, 71, 177, 367, 29, 95, 0, 358, 253, 275, 204, 202, 131]"
5,22,1983,1122,6133,0,750,1233,"[92, 92, 261, 28, 134, 203, 100, 16, 390, 79, 355, 283, 72, 179, 75, 348, 232, 106, 29, 372, 0, 100, 166, 198, 327, 154, 209]"
6,22,1494,1260,6367,0,196,1298,"[27, 321, 190, 239, 317, 134, 365, 21, 65, 251, 250, 412, 244, 143, 369, 19, 21, 128, 356, 49, 0, 56, 54, 182, 310, 258, 393]"
7,22,2896,2876,6387,0,2669,227,"[40, 9, 5, 3, 23, 54, 39, 46, 14, 74, 73, 47, 48, 43, 49, 65, 66, 58, 60, 48, 0, 20, 27, 29, 69, 14, 51]"
8,22,1758,915,7230,0,914,844,"[193, 134, 59, 274, 6, 122, 244, 103, 32, 15, 208, 160, 240, 8, 99, 274, 60, 264, 268, 262, 0, 156, 165, 105, 246, 272, 201]"
9,22,1942,1161,8011,0,892,1050,"[112, 295, 348, 156, 98, 345, 200, 42, 169, 130, 44, 188, 94, 229, 245, 64, 154, 298, 313, 293, 0, 125, 187, 293, 207, 244, 185]"
10,22,2395,918,9488,0,512,1883,"[302, 156, 398, 492, 123, 207, 202, 49, 476, 128, 599, 371, 446, 593, 512, 21, 495, 544, 621, 246, 0, 29, 329, 576, 465, 255, 133]"
11,22,1789,6569,4708,0,1454,335,"[90, 102, 98, 1, 10, 69, 64, 58, 25, 48, 82, 1, 27, 18, 104, 34, 89, 61, 66, 20, 0, 24, 64, 8, 56, 86, 65]"
12,22,1226,107,5827,0,573,653,"[47, 131, 127, 4, 89, 204, 1, 75, 19, 143, 14, 109, 32, 96, 112, 85, 54, 200, 52, 136, 0, 59, 33, 28, 123, 202, 121]"
13,22,2981,2965,5843,0,1812,1169,"[75, 33, 42, 360, 386, 14, 83, 172, 254, 239, 148, 158, 274, 279, 44, 57, 119, 191, 310, 140, 0, 128, 238, 12, 41, 120, 367]"
14,22,2043,1123,6763,0,1131,912,"[31, 250, 253, 166, 249, 6, 112, 183, 271, 14, 104, 227, 149, 298, 46, 286, 195, 45, 158, 246, 0, 283, 267, 214, 56, 61, 49]"
15,22,2188,1408,7543,0,1571,617,"[150, 152, 181, 39, 159, 73, 12, 126, 83, 204, 48, 115, 40, 199, 198, 193, 161, 107, 12, 90, 0, 12, 72, 136, 81, 141, 56]"
16,22,2314,419,9438,0,177,2137,"[223, 274, 8, 690, 658, 112, 701, 246, 117, 494, 131, 316, 331, 487, 137, 567, 119, 271, 461, 52, 0, 77, 426, 522, 476, 373, 515]"
17,22,1359,691,10000,106,1188,171,"[52, 55, 26, 22, 19, 49, 34, 7, 40, 10, 36, 8, 27, 28, 55, 42, 6, 51, 25, 34, 0, 38, 16, 23, 14, 12, 53]"
18,22,2075,5027,7048,0,1880,195,"[18, 38, 6, 27, 0, 40, 25, 43, 15, 30, 14, 48, 11, 44, 36, 16, 27, 56, 60, 63, 0, 2, 56, 52, 8, 24, 49]"
19,22,1026,79,7995,0,224,802,"[43, 225, 155, 72, 169, 93, 220, 227, 72, 15, 91, 125, 223, 240, 190, 97, 47, 11, 138, 23, 0, 89, 248, 172, 34, 47, 184]"
20,22,2460,704,9751,0,186,2274,"[194, 84, 371, 527, 644, 499, 501, 53, 184, 467, 570, 114, 668, 290, 414, 143, 564, 149, 627, 284, 0, 164, 239, 541, 746, 551, 565]"
21,22,1072,151,10000,672,982,90,"[27, 22, 3, 23, 18, 23, 29, 27, 22, 17, 20, 28, 2, 17, 7, 28, 6, 27, 0, 14, 0, 1, 4, 14, 17, 28, 2]"
22,22,2058,6065,5993,0,1385,673,"[133, 115, 185, 82, 164, 165, 187, 45, 124, 183, 77, 15, 198, 115, 97, 73, 79, 81, 127, 169, 0, 127, 154, 146, 17, 164, 173]"
23,22,2795,738,8050,0,1873,922,"[57, 99, 204, 247, 241, 75, 94, 290, 166, 138, 68, 96, 279, 139, 145, 89, 269, 127, 290, 37, 0, 72, 300, 250, 12, 98, 65]"
24,22,2379,176,10000,253,1810,569,"[176, 109, 35, 74, 26, 48, 132, 14, 20, 155, 95, 149, 71, 9, 181, 160, 129, 7, 174, 54, 0, 49, 154, 18, 177, 124, 28]"
25,22,2055,5409,6646,0,1837,218,"[71, 6, 25, 5, 29, 52, 8, 4, 51, 23, 59, 68, 14, 11, 44, 72, 52, 34, 8, 33, 0, 19, 44, 1, 23, 18, 27]"
26,22,2829,2114,7361,0,200,2629,"[805, 121, 16, 149, 143, 438, 427, 107, 529, 524, 392, 662, 530, 517, 638, 394, 653, 598, 543, 208, 0, 14, 138, 386, 678, 368, 371]"
27,22,1003,391,7973,0,917,86,"[2, 26, 16, 19, 1, 20, 19, 21, 20, 23, 20, 26, 23, 15, 5, 5, 9, 28, 6, 24, 0, 17, 17, 9, 4, 26, 18]"
28,22,2452,2014,8411,0,1400,1052,"[100, 51, 323, 34, 242, 179, 134, 209, 156, 320, 27, 217, 320, 158, 279, 150, 212, 343, 119, 1, 0, 36, 138, 215, 275, 119, 119]"
29,22,1651,326,9736,0,50,1601,"[123, 400, 403, 187, 240, 263, 448, 345, 517, 269, 353, 258, 363, 319, 474, 233, 422, 452, 23, 491, 0, 36, 97, 513, 504, 105, 490]"
30,22,2148,6910,4974,0,467,1681,"[535, 296, 459, 190, 125, 450, 234, 539, 244, 275, 419, 197, 517, 470, 373, 466, 278, 96, 37, 498, 0, 490, 26, 144, 385, 541, 360]"
31,22,2166,629,6511,0,1532,634,"[208, 146, 187, 8, 68, 174, 61, 28, 24, 0, 6, 95, 47, 20, 144, 160, 7, 88, 177, 66, 0, 89, 210, 176, 26, 182, 166]"
32,22,1217,809,6919,0,188,1029,"[161, 41, 106, 320, 51, 64, 226, 197, 188, 303, 61, 76, 255, 28, 55, 193, 130, 216, 24, 12, 0, 89, 139, 44, 341, 268, 190]"
33,22,1159,986,7092,0,751,408,"[126, 124, 47, 16, 91, 63, 29, 123, 81, 126, 102, 109, 21, 83, 69, 88, 81, 61, 89, 115, 0, 4, 78, 110, 63, 25, 87]"
34,22,1454,711,7835,0,236,1218,"[114, 342, 274, 345, 209, 90, 126, 39, 335, 156, 372, 18, 332, 234, 284, 164, 195, 19, 29, 20, 0, 14, 25, 154, 256, 43, 221]"
35,22,2100,1719,8216,0,185,1915,"[470, 258, 543, 508, 19, 282, 113, 407, 255, 417, 358, 449, 89, 420, 317, 547, 602, 65, 130, 36, 0, 163, 154, 328, 434, 428, 393]"
36,22,1877,1693,8400,0,1067,810,"[190, 196, 53, 219, 225, 134, 226, 194, 108, 125, 132, 155, 8, 152, 258, 250, 149, 223, 270, 161, 0, 133, 231, 113, 152, 229, 227]"
37,22,2201,398,10000,203,558,1643,"[373, 424, 179, 279, 50, 297, 174, 470, 413, 439, 494, 257, 547, 275, 6, 4, 86, 224, 545, 49, 0, 19, 261, 241, 426, 535, 524]"
38,22,1178,6666,4512,0,206,972,"[219, 67, 74, 267, 2, 177, 241, 85, 197, 12, 141, 110, 126, 232, 55, 74, 286, 71, 27, 312, 0, 81, 161, 261, 165, 27, 194]"
39,22,2889,1628,5773,0,1278,1611,"[320, 528, 10, 114, 418, 83, 500, 511, 292, 482, 426, 441, 422, 22, 353, 488, 449, 357, 422, 127, 0, 159, 350, 104, 78, 273, 153]"
40,22,2321,1669,6425,0,1338,983,"[249, 278, 109, 53, 149, 16, 312, 126, 274, 89, 120, 185, 276, 64, 79, 201, 131, 199, 180, 300, 0, 272, 254, 257, 4, 99, 118]"
41,22,2762,2509,6678,0,1378,1384,"[391, 181, 266, 185, 57, 313, 135, 236, 217, 354, 236, 224, 397, 402, 292, 249, 64, 354, 339, 71, 0, 78, 76, 230, 97, 37, 234]"
42,22,2056,479,8255,0,166,1890,"[558, 8, 322, 625, 34, 490, 439, 173, 51, 480, 552, 33, 333, 521, 556, 191, 626, 482, 480, 624, 0, 617, 55, 435, 444, 613, 334]"
43,22,2191,1679,8767,0,2009,182,"[23, 36, 34, 42, 59, 50, 32, 51, 34, 16, 44, 22, 3, 53, 42, 51, 57, 20, 24, 9, 0, 6, 24, 27, 39, 34, 5]"
44,22,2830,6708,4889,0,659,2171,"[690, 376, 308, 129, 536, 466, 111, 579, 213, 178, 582, 55, 177, 404, 78, 475, 317, 492, 472, 515, 0, 71, 276, 690, 346, 561, 278]"
45,22,1065,986,4968,0,516,549,"[132, 38, 156, 6, 167, 11, 104, 91, 68, 156, 155, 172, 40, 46, 181, 133, 181, 149, 55, 35, 0, 10, 68, 101, 80, 104, 154]"
46,22,1129,293,5804,0,590,539,"[32, 15, 105, 61, 72, 68, 173, 96, 164, 119, 144, 13, 94, 43, 177, 160, 151, 142, 142, 52, 0, 128, 111, 40, 53, 10, 127]"
47,22,2126,326,7604,0,340,1786,"[528, 422, 298, 588, 301, 422, 29, 591, 362, 237, 135, 570, 505, 568, 220, 87, 399, 425, 328, 219, 0, 566, 397, 41, 258, 381, 59]"
48,22,1530,1294,7840,0,365,1165,"[216, 259, 255, 265, 216, 6, 117, 56, 94, 246, 150, 262, 378, 13, 386, 260, 139, 138, 87, 108, 0, 368, 186, 25, 211, 49, 160]"
49,22,2324,315,9849,0,1236,1088,"[129, 188, 173, 148, 186, 330, 287, 234, 5, 212, 55, 194, 16, 221, 126, 26, 222, 250, 97, 277, 0, 219, 63, 203, 1, 39, 278]"
50,22,2961,6201,6609,0,1970,991,"[18, 65, 4, 57, 22, 193, 163, 25, 192, 197, 110, 170, 116, 258, 305, 158, 62, 269, 103, 295, 0, 173, 305, 31, 311, 35, 163]"
51,22,1003,353,7259,0,551,452,"[15, 55, 43, 135, 112, 123, 118, 75, 125, 68, 104, 139, 118, 9, 137, 35, 29, 114, 78, 21, 0, 88, 33, 135, 146, 21, 20]"
52,22,1647,581,8325,0,87,1560,"[37, 457, 464, 400, 389, 138, 316, 50, 265, 20, 424, 138, 395, 434, 367, 455, 61, 56, 493, 469, 0, 316, 214, 272, 224, 18, 55]"
53,22,2633,1000,9958,0,2525,108,"[4, 2, 15, 20, 22, 12, 4, 30, 4, 34, 22, 15, 25, 31, 34, 15, 18, 7, 33, 7, 0, 28, 3, 5, 0, 7, 19]"
54,22,2013,5835,6136,0,817,1196,"[44, 303, 25, 149, 194, 172, 220, 177, 66, 269, 362, 313, 80, 64, 98, 70, 242, 377, 140, 233, 0, 326, 54, 363, 167, 7, 318]"
55,22,2073,994,7215,0,580,1493,"[176, 474, 240, 167, 4, 55, 290, 353, 270, 200, 38, 383, 388, 361, 411, 342, 344, 68, 121, 342, 0, 394, 172, 363, 299, 333, 318]"
56,22,1775,716,8274,0,1358,417,"[68, 25, 109, 44, 40, 5, 129, 31, 13, 40, 80, 63, 83, 114, 111, 115, 79, 25, 77, 59, 0, 85, 28, 62, 120, 72, 57]"
57,22,2773,5799,5248,0,485,2288,"[492, 723, 619, 45, 198, 120, 382, 440, 83, 720, 310, 71, 438, 498, 75, 262, 104, 456, 708, 683, 0, 550, 75, 267, 601, 92, 360]"
58,22,1314,556,6006,0,1219,95,"[13, 21, 7, 0, 4, 19, 21, 15, 11, 27, 17, 8, 10, 4, 6, 18, 22, 26, 26, 17, 0, 11, 26, 30, 24, 17, 21]"
59,22,2632,1834,6804,0,2156,476,"[27, 116, 87, 76, 53, 80, 119, 10, 153, 91, 13, 8, 58, 68, 101, 117, 41, 129, 50, 13, 0, 54, 144, 51, 0, 109, 77]"
60,22,2193,1920,7077,0,1211,982,"[312, 56, 22, 180, 173, 120, 192, 241, 265, 210, 237, 165, 218, 82, 183, 191, 263, 109, 13, 290, 0, 88, 127, 27, 21, 108, 156]"
61,22,2822,1902,7997,0,935,1887,"[626, 213, 545, 270, 206, 595, 410, 49, 188, 127, 41, 185, 41, 334, 6, 620, 294, 361, 101, 379, 0, 358, 600, 201, 178, 569, 80]"
62,22,1088,184,8901,0,871,217,"[6, 54, 57, 53, 19, 36, 12, 36, 3, 26, 35, 68, 51, 67, 22, 56, 50, 72, 16, 63, 0, 19, 37, 24, 52, 46, 17]"
63,22,1510,1372,9039,0,397,1113,"[335, 240, 324, 191, 239, 122, 54, 313, 316, 371, 244, 70, 4, 329, 318, 108, 40, 106, 216, 174, 0, 361, 308, 29, 58, 17, 121]"
64,22,2093,7363,3769,0,1053,1040,"[179, 220, 278, 183, 27, 326, 137, 29, 245, 183, 331, 174, 262, 205, 345, 284, 185, 344, 303, 261, 0, 106, 226, 196, 54, 137, 197]"
65,22,1996,98,5667,0,1269,727,"[87, 3, 14, 73, 194, 153, 159, 141, 69, 208, 215, 71, 206, 12, 99, 164, 58, 148, 18, 121, 0, 154, 137, 199, 18, 82, 152]"
66,22,2728,655,7740,0,1512,1216,"[97, 217, 318, 104, 207, 384, 376, 5, 175, 18, 23, 253, 32, 96, 150, 309, 298, 67, 142, 168, 0, 278, 11, 394, 138, 266, 271]"
67,22,1216,335,8621,0,286,930,"[138, 89, 237, 303, 260, 33, 94, 281, 242, 158, 209, 292, 6, 224, 45, 209, 297, 141, 308, 198, 0, 160, 292, 300, 139, 178, 231]"
68,22,2609,7043,4187,0,1035,1574,"[281, 140, 248, 115, 82, 13, 257, 219, 408, 376, 447, 361, 145, 101, 15, 422, 369, 398, 475, 373, 0, 522, 49, 241, 100, 96, 452]"
69,22,1299,746,4740,0,122,1177,"[303, 75, 313, 314, 122, 338, 64, 345, 133, 261, 143, 198, 306, 95, 309, 322, 272, 74, 135, 186, 0, 117, 198, 371, 12, 383, 220]"
70,22,1793,110,6423,0,1131,662,"[86, 165, 163, 68, 122, 7, 123, 106, 8, 150, 82, 156, 156, 0, 110, 45, 13, 75, 166, 67, 0, 147, 49, 213, 115, 200, 187]"
71,22,2091,1212,7302,0,1141,950,"[298, 170, 178, 33, 125, 133, 76, 7, 62, 6, 210, 44, 156, 223, 222, 13, 288, 125, 247, 204, 0, 220, 210, 148, 56, 182, 116]"
72,22,2233,929,8606,0,2199,34,"[11, 0, 3, 4, 7, 11, 2, 11, 2, 9, 6, 1, 2, 6, 8, 0, 8, 4, 0, 6, 0, 8, 2, 8, 2, 1, 1]"
73,22,2201,89,10000,718,1153,1048,"[145, 178, 63, 218, 191, 177, 24, 152, 2, 84, 62, 126, 192, 312, 176, 86, 287, 322, 239, 345, 0, 213, 219, 41, 146, 55, 127]"
74,22,1847,6294,5553,0,893,954,"[283, 82, 27, 151, 111, 93, 198, 228, 307, 61, 58, 238, 80, 308, 307, 169, 295, 220, 283, 3, 0, 304, 267, 20, 188, 264, 239]"
75,22,1308,64,6797,0,1203,105,"[33, 23, 32, 15, 3, 4, 27, 15, 34, 25, 32, 1, 35, 7, 22, 35, 15, 0, 14, 18, 0, 35, 19, 27, 17, 2, 8]"
76,22,2771,422,9146,0,1481,1290,"[301, 99, 73, 345, 29, 148, 277, 428, 5, 428, 31, 357, 162, 164, 131, 108, 421, 92, 34, 428, 0, 420, 233, 140, 267, 187, 281]"
77,22,1788,1634,9300,0,1190,598,"[189, 123, 85, 168, 35, 84, 182, 154, 123, 93, 89, 112, 109, 138, 100, 186, 187, 67, 134, 86, 0, 34, 80, 113, 102, 162, 168]"
78,22,2654,6405,5549,0,396,2258,"[549, 733, 480, 586, 705, 364, 536, 595, 349, 341, 676, 329, 204, 681, 546, 230, 642, 612, 660, 505, 0, 650, 429, 310, 36, 637, 551]"
79,22,1342,1043,5848,0,894,448,"[145, 36, 17, 12, 13, 127, 7, 21, 106, 82, 28, 86, 28, 25, 123, 47, 8, 44, 105, 56, 0, 87, 14, 104, 48, 87, 12]"
80,22,1358,813,6393,0,90,1268,"[149, 238, 128, 370, 316, 420, 190, 101, 402, 309, 402, 319, 79, 23, 98, 162, 327, 376, 114, 183, 0, 251, 78, 134, 368, 80, 94]"
81,22,2357,1911,6839,0,66,2291,"[391, 341, 641, 561, 682, 557, 306, 260, 393, 178, 271, 59, 291, 655, 509, 643, 648, 174, 512, 168, 0, 714, 469, 303, 248, 541, 742]"
82,22,1657,1191,7305,0,89,1568,"[405, 296, 8, 510, 211, 197, 388, 426, 27, 135, 51, 326, 165, 486, 7, 194, 465, 48, 256, 491, 0, 3, 454, 4, 392, 409, 478]"
83,22,1497,1464,7338,0,326,1171,"[72, 214, 382, 71, 258, 24, 280, 381, 40, 7, 342, 263, 191, 68, 250, 388, 297, 214, 320, 7, 0, 351, 356, 290, 292, 267, 89]"
84,22,2202,228,9312,0,1487,715,"[209, 202, 216, 20, 201, 209, 52, 42, 132, 128, 35, 152, 231, 38, 28, 41, 102, 42, 236, 184, 0, 187, 163, 87, 169, 220, 231]"
85,22,1138,71,10000,379,69,1069,"[247, 15, 125, 7, 8, 79, 205, 54, 30, 197, 161, 31, 284, 110, 271, 27, 327, 61, 258, 20, 0, 171, 270, 28, 93, 278, 102]"
86,22,1180,5307,5873,0,1071,109,"[36, 28, 29, 10, 23, 9, 34, 27, 20, 33, 18, 27, 9, 19, 1, 29, 30, 0, 9, 19, 0, 17, 13, 19, 8, 4, 23]"
87,22,2011,1237,6647,0,549,1462,"[177, 205, 252, 56, 254, 49, 483, 187, 440, 449, 270, 273, 260, 398, 293, 6, 406, 137, 390, 357, 0, 243, 266, 471, 292, 381, 423]"
88,22,2044,1430,7261,0,782,1262,"[275, 393, 278, 252, 381, 302, 342, 174, 414, 274, 42, 268, 192, 13, 295, 385, 353, 112, 14, 348, 0, 344, 162, 118, 151, 383, 245]"
89,22,1350,15,8596,0,622,728,"[11, 183, 37, 237, 186, 65, 171, 30, 42, 194, 13, 26, 174, 71, 57, 133, 145, 79, 124, 167, 0, 70, 228, 227, 101, 3, 170]"
90,22,1259,1238,8617,0,962,297,"[91, 5, 54, 66, 48, 27, 23, 14, 85, 60, 15, 91, 71, 78, 29, 84, 4, 25, 97, 51, 0, 46, 98, 13, 51, 95, 51]"
91,22,1699,419,9897,0,824,875,"[193, 242, 219, 167, 107, 72, 204, 157, 181, 78, 136, 175, 23, 269, 234, 234, 155, 241, 31, 87, 0, 262, 50, 122, 116, 211, 48]"
92,22,1999,5608,6288,0,677,1322,"[92, 389, 166, 185, 149, 178, 259, 251, 167, 273, 120, 171, 179, 370, 72, 425, 69, 339, 356, 110, 0, 111, 381, 318, 280, 321, 148]"
93,22,2230,138,8380,0,412,1818,"[62, 431, 569, 119, 545, 158, 146, 19, 600, 478, 236, 141, 556, 247, 262, 576, 98, 458, 548, 566, 0, 338, 523, 175, 5, 196, 572]"
94,22,1021,262,9139,0,240,781,"[131, 220, 66, 210, 175, 224, 154, 162, 163, 161, 97, 52, 123, 27, 16, 177, 19, 247, 243, 87, 0, 126, 47, 118, 225, 91, 67]"
95,22,1861,434,10000,566,17,1844,"[158, 336, 513, 348, 481, 27, 449, 82, 482, 139, 87, 140, 157, 34, 265, 216, 142, 442, 298, 463, 0, 333, 46, 208, 30, 539, 106]"
96,22,1300,7057,4243,0,397,903,"[41, 125, 244, 196, 41, 100, 74, 300, 146, 216, 1, 59, 123, 162, 140, 251, 107, 246, 195, 79, 0, 299, 281, 231, 277, 34, 125]"
97,22,2762,747,6258,0,1235,1527,"[285, 393, 123, 196, 167, 286, 161, 64, 344, 237, 161, 81, 247, 156, 445, 155, 331, 472, 127, 133, 0, 374, 258, 442, 151, 356, 200]"
98,22,2370,255,8373,0,1799,571,"[68, 43, 21, 143, 153, 122, 66, 97, 143, 6, 1, 100, 35, 52, 3, 43, 23, 170, 39, 105, 0, 112, 67, 36, 19, 101, 8]"
99,22,2971,7304,4040,0,2502,469,"[152, 95, 61, 47, 127, 132, 69, 85, 87, 97, 21, 106, 153, 136, 58, 65, 85, 102, 40, 35, 0, 136, 18, 4, 38, 43, 10]"
100,22,2651,2156,4535,0,1615,1036,"[4, 239, 63, 162, 117, 94, 106, 286, 191, 51, 30, 202, 100, 132, 56, 220, 71, 235, 335, 146, 0, 153, 153, 225, 191, 14, 179]"
101,22,2428,634,6329,0,1216,1212,"[322, 362, 74, 143, 9, 158, 137, 379, 179, 308, 7, 302, 323, 355, 311, 40, 201, 1, 110, 97, 0, 69, 202, 360, 218, 305, 213]"
102,22,2492,2328,6493,0,841,1651,"[230, 69, 26, 44, 94, 322, 388, 140, 135, 439, 246, 88, 464, 9, 445, 281, 367, 258, 376, 219, 0, 45, 367, 521, 21, 57, 22]"
103,22,2535,2019,7009,0,1107,1428,"[449, 103, 105, 124, 460, 306, 30, 242, 68, 128, 342, 294, 79, 104, 310, 182, 423, 209, 233, 350, 0, 386, 84, 23, 44, 54, 283]"
104,22,2449,513,8945,0,527,1922,"[32, 138, 221, 162, 291, 37, 406, 33, 203, 170, 217, 173, 312, 537, 87, 462, 487, 404, 482, 492, 0, 342, 626, 165, 628, 488, 495]"
105,22,1588,1484,9049,0,1549,39,"[13, 10, 5, 3, 4, 13, 1, 4, 1, 11, 1, 10, 5, 6, 3, 12, 6, 12, 1, 13, 0, 1, 3, 13, 10, 4, 2]"
106,22,1967,6766,4250,0,1347,620,"[145, 17, 177, 159, 202, 2, 171, 16, 40, 47, 108, 77, 1, 106, 192, 101, 21, 98, 32, 205, 0, 128, 116, 113, 147, 1, 78]"
107,22,1840,1728,4362,0,807,1033,"[326, 259, 5, 235, 96, 341, 74, 265, 126, 94, 169, 133, 325, 162, 219, 131, 153, 269, 293, 339, 0, 252, 112, 161, 245, 108, 23]"
108,22,2123,1794,4691,0,1346,777,"[79, 13, 207, 147, 95, 105, 128, 147, 118, 2, 66, 13, 128, 204, 48, 73, 166, 148, 51, 58, 0, 198, 147, 109, 238, 178, 85]"
109,22,1340,662,5369,0,602,738,"[90, 193, 167, 2, 236, 241, 108, 197, 84, 174, 104, 191, 223, 166, 114, 207, 56, 133, 73, 128, 0, 49, 219, 86, 39, 162, 185]"
110,22,1931,895,6405,0,376,1555,"[321, 78, 180, 421, 75, 242, 367, 486, 348, 270, 126, 468, 221, 152, 355, 397, 468, 167, 21, 297, 0, 112, 126, 183, 337, 31, 493]"
111,22,2750,1777,7378,0,1578,1172,"[149, 31, 110, 51, 1, 211, 377, 295, 316, 238, 115, 9, 253, 299, 155, 90, 354, 215, 335, 110, 0, 207, 176, 139, 139, 256, 248]"
112,22,1640,891,8127,0,251,1389,"[237, 198, 428, 59, 131, 92, 313, 54, 414, 86, 425, 243, 348, 148, 257, 207, 449, 401, 249, 270, 0, 368, 172, 244, 406, 281, 131]"
113,22,1827,329,9625,0,1345,482,"[124, 146, 6, 46, 123, 105, 21, 30, 52, 123, 0, 116, 98, 75, 34, 47, 3, 75, 21, 33, 0, 50, 112, 116, 15, 124, 41]"
114,22,2073,7454,4244,0,1621,452,"[93, 30, 90, 60, 115, 73, 113, 36, 97, 110, 127, 8, 63, 125, 128, 130, 32, 113, 15, 89, 0, 125, 22, 65, 34, 142, 42]"
115,22,1166,860,4550,0,627,539,"[20, 111, 49, 131, 131, 2, 3, 173, 4, 25, 150, 126, 93, 100, 135, 14, 33, 29, 115, 104, 0, 101, 23, 102, 36, 65, 15]"
116,22,1896,385,6061,0,570,1326,"[298, 211, 427, 69, 172, 138, 131, 206, 40, 207, 297, 73, 144, 294, 110, 111, 312, 16, 101, 316, 0, 345, 419, 270, 211, 203, 311]"
117,22,2358,1525,6894,0,852,1506,"[432, 193, 448, 172, 375, 502, 166, 133, 137, 396, 96, 97, 122, 271, 497, 246, 22, 372, 51, 412, 0, 127, 96, 63, 282, 446, 38]"
118,22,2477,2417,6954,0,2335,142,"[10, 31, 24, 0, 11, 28, 38, 3, 4, 26, 2, 23, 23, 17, 19, 8, 39, 12, 5, 33, 0, 19, 10, 11, 2, 46, 34]"
119,22,2358,1283,8029,0,1768,590,"[67, 187, 183, 181, 89, 7, 52, 166, 149, 11, 4, 91, 23, 78, 97, 27, 79, 133, 29, 74, 0, 10, 165, 137, 151, 4, 72]"
120,22,2548,1616,8961,0,2403,145,"[37, 5, 15, 48, 32, 11, 39, 31, 41, 18, 3, 46, 31, 41, 33, 33, 6, 11, 31, 6, 0, 10, 41, 4, 17, 21, 4]"
121,22,2810,6528,5243,0,1134,1676,"[427, 510, 214, 278, 386, 195, 109, 42, 530, 279, 428, 5, 3, 340, 275, 416, 229, 273, 356, 204, 0, 92, 28, 546, 268, 522, 404]"
122,22,2561,2072,5732,0,1468,1093,"[34, 183, 291, 207, 30, 222, 293, 259, 141, 58, 211, 220, 80, 179, 135, 326, 76, 303, 194, 116, 0, 175, 287, 43, 9, 166, 140]"
123,22,1457,128,7061,0,1218,239,"[41, 78, 50, 72, 71, 37, 25, 57, 37, 64, 8, 50, 76, 54, 29, 2, 8, 28, 32, 12, 0, 8, 50, 11, 69, 63, 59]"
124,22,1360,749,7672,0,441,919,"[167, 195, 252, 66, 145, 281, 3, 211, 67, 251, 110, 210, 300, 141, 90, 7, 224, 161, 144, 162, 0, 172, 35, 303, 259, 167, 288]"
125,22,2845,155,10000,362,1133,1712,"[69, 59, 505, 548, 73, 157, 313, 200, 237, 151, 279, 268, 112, 373, 551, 206, 405, 160, 148, 557, 0, 69, 461, 489, 73, 512, 209]"
126,22,1692,5933,5759,0,771,921,"[261, 150, 274, 21, 254, 40, 69, 58, 200, 278, 242, 250, 269, 161, 208, 182, 201, 298, 63, 15, 0, 45, 250, 60, 293, 153, 285]"
127,22,1500,1330,5929,0,999,501,"[62, 1, 142, 160, 83, 80, 77, 28, 84, 27, 110, 8, 13, 119, 62, 16, 47, 167, 6, 143, 0, 85, 138, 100, 99, 113, 92]"
128,22,2959,710,8178,0,2719,240,"[32, 11, 75, 52, 30, 31, 31, 78, 80, 56, 8, 47, 50, 7, 37, 50, 53, 36, 3, 11, 0, 66, 34, 80, 3, 24, 42]"
129,22,2199,1437,8940,0,592,1607,"[326, 530, 284, 506, 159, 513, 364, 164, 97, 415, 79, 4, 449, 384, 434, 376, 183, 416, 477, 176, 0, 96, 249, 164, 390, 108, 311]"
130,22,1975,174,10000,741,360,1615,"[226, 221, 441, 497, 145, 492, 494, 293, 193, 173, 24, 502, 397, 501, 243, 62, 10, 471, 202, 49, 0, 158, 62, 367, 430, 409, 184]"
131,22,2247,5179,7068,0,1666,581,"[87, 11, 131, 98, 84, 60, 25, 78, 170, 143, 126, 122, 85, 35, 167, 106, 124, 170, 91, 185, 0, 142, 30, 173, 122, 137, 5]"
132,22,2049,868,8249,0,697,1352,"[9, 247, 295, 110, 437, 157, 104, 14, 357, 93, 83, 76, 355, 378, 22, 223, 228, 9, 272, 212, 0, 400, 82, 117, 123, 213, 255]"
133,22,1344,71,9522,0,587,757,"[65, 14, 226, 104, 6, 10, 11, 206, 7, 91, 175, 251, 152, 176, 78, 162, 21, 76, 193, 153, 0, 180, 23, 224, 3, 111, 96]"
134,22,1919,5941,5500,0,1462,457,"[12, 129, 112, 122, 78, 152, 89, 132, 89, 43, 118, 110, 6, 133, 125, 136, 143, 97, 117, 36, 0, 4, 8, 94, 102, 92, 108]"
135,22,2992,2726,5766,0,1076,1916,"[163, 343, 307, 118, 516, 421, 285, 171, 149, 55, 275, 321, 30, 389, 611, 101, 37, 91, 75, 202, 0, 196, 300, 427, 500, 587, 34]"
136,22,1474,605,6635,0,695,779,"[158, 139, 197, 52, 128, 214, 17, 185, 132, 98, 149, 113, 50, 88, 175, 193, 67, 109, 189, 45, 0, 216, 210, 195, 87, 70, 229]"
137,22,2636,1204,8067,0,552,2084,"[261, 395, 118, 503, 683, 284, 607, 29, 102, 162, 664, 478, 7, 679, 690, 521, 211, 85, 192, 257, 0, 282, 514, 439, 447, 374, 523]"
138,22,2581,827,9821,0,2102,479,"[139, 24, 40, 126, 3, 100, 73, 36, 143, 156, 34, 103, 27, 125, 104, 3, 49, 141, 137, 45, 0, 55, 159, 59, 148, 126, 27]"
139,22,2494,6001,6314,0,2387,107,"[30, 26, 10, 13, 3, 12, 16, 20, 3, 17, 17, 11, 24, 4, 7, 16, 29, 14, 2, 14, 0, 35, 4, 4, 20, 0, 18]"
140,22,2586,974,7926,0,2328,258,"[31, 35, 75, 60, 53, 81, 77, 17, 81, 58, 67, 78, 34, 78, 3, 12, 60, 54, 11, 85, 0, 71, 34, 24, 85, 41, 16]"
141,22,2548,1229,9245,0,2453,95,"[18, 6, 1, 7, 26, 8, 17, 13, 13, 10, 5, 19, 5, 2, 5, 13, 30, 23, 4, 9, 0, 24, 20, 0, 14, 30, 16]"
142,22,2846,6703,5388,0,1647,1199,"[198, 205, 247, 375, 128, 136, 279, 214, 305, 59, 182, 73, 330, 235, 157, 379, 4, 362, 171, 296, 0, 349, 46, 190, 269, 168, 360]"
143,22,1471,807,6052,0,501,970,"[189, 152, 183, 214, 305, 49, 117, 261, 263, 44, 321, 244, 271, 16, 202, 128, 0, 143, 289, 89, 0, 146, 272, 219, 112, 255, 5]"
144,22,1604,228,7428,0,550,1054,"[265, 86, 203, 265, 285, 110, 110, 17, 17, 346, 239, 15, 127, 329, 248, 65, 204, 83, 52, 112, 0, 36, 88, 162, 106, 246, 114]"
145,22,1255,370,8313,0,102,1153,"[364, 276, 248, 145, 314, 259, 229, 244, 199, 41, 361, 271, 38, 291, 357, 148, 384, 267, 370, 255, 0, 80, 269, 147, 316, 181, 75]"
146,22,1480,296,9497,0,1071,409,"[21, 100, 54, 74, 75, 31, 97, 121, 132, 31, 102, 36, 6, 43, 52, 78, 31, 71, 94, 12, 0, 24, 35, 78, 131, 98, 104]"
147,22,2008,6365,5140,0,844,1164,"[214, 104, 304, 166, 300, 139, 74, 48, 178, 8, 81, 102, 141, 272, 190, 91, 133, 137, 352, 145, 0, 85, 379, 50, 361, 312, 246]"
148,22,2986,2542,5584,0,1748,1238,"[338, 59, 244, 36, 293, 408, 252, 270, 402, 79, 204, 326, 70, 108, 119, 169, 362, 99, 319, 341, 0, 156, 137, 10, 87, 237, 48]"
149,22,2187,1885,5886,0,2104,83,"[25, 15, 1, 15, 22, 21, 14, 11, 3, 18, 27, 23, 13, 7, 23, 12, 6, 5, 26, 3, 0, 15, 20, 21, 25, 11, 18]"
150,22,2608,697,7797,0,2398,210,"[44, 27, 66, 38, 26, 12, 48, 5, 57, 62, 13, 60, 69, 38, 5, 13, 65, 47, 11, 15, 0, 63, 27, 0, 50, 45, 51]"
151,22,2352,972,9177,0,1883,469,"[66, 131, 111, 77, 38, 73, 126, 52, 57, 104, 19, 62, 119, 123, 3, 59, 39, 115, 136, 152, 0, 53, 7, 85, 73, 45, 72]"
152,22,2577,6356,5398,0,310,2267,"[28, 445, 338, 29, 555, 183, 326, 322, 619, 363, 204, 172, 278, 149, 498, 252, 604, 219, 732, 145, 0, 21, 394, 179, 87, 658, 722]"
153,22,1471,841,6028,0,324,1147,"[71, 42, 14, 297, 367, 353, 230, 181, 47, 346, 64, 21, 350, 157, 163, 132, 128, 154, 256, 242, 0, 301, 66, 94, 137, 28, 170]"
154,22,2046,341,7733,0,144,1902,"[607, 137, 437, 429, 77, 341, 576, 178, 519, 238, 592, 429, 152, 39, 93, 242, 278, 63, 270, 478, 0, 72, 254, 62, 470, 43, 266]"
155,22,1725,1490,7968,0,304,1421,"[122, 372, 408, 401, 406, 101, 411, 289, 293, 383, 456, 218, 235, 174, 80, 142, 458, 468, 195, 2, 0, 314, 120, 353, 145, 470, 312]"
156,22,1615,631,8952,0,710,905,"[171, 244, 192, 111, 6, 280, 218, 224, 14, 260, 8, 208, 210, 131, 117, 69, 35, 179, 258, 98, 0, 283, 117, 37, 139, 69, 0]"
157,22,1722,1247,9427,0,848,874,"[2, 202, 214, 254, 221, 5, 201, 198, 170, 136, 118, 148, 16, 277, 253, 263, 38, 220, 241, 88, 0, 235, 102, 38, 157, 264, 269]"
158,22,2569,6747,5249,0,526,2043,"[441, 332, 297, 201, 500, 155, 108, 271, 76, 477, 162, 468, 653, 53, 2, 342, 431, 645, 61, 466, 0, 334, 472, 273, 223, 154, 477]"
159,22,1465,180,6534,0,1142,323,"[74, 42, 6, 31, 106, 2, 43, 85, 102, 41, 55, 1, 20, 106, 40, 84, 7, 37, 27, 99, 0, 27, 59, 76, 30, 99, 96]"
160,22,2744,2408,6870,0,191,2553,"[164, 20, 451, 264, 327, 465, 67, 381, 558, 498, 243, 183, 693, 131, 477, 76, 362, 516, 834, 610, 0, 3, 165, 641, 678, 744, 703]"
161,22,1836,1291,7415,0,249,1587,"[243, 357, 445, 256, 203, 74, 2, 296, 99, 256, 252, 225, 42, 99, 527, 416, 50, 341, 191, 17, 0, 56, 28, 413, 352, 482, 162]"
162,22,2176,1740,7851,0,754,1422,"[443, 272, 138, 350, 6, 232, 88, 35, 178, 55, 416, 98, 34, 15, 333, 445, 334, 75, 260, 433, 0, 35, 187, 309, 447, 352, 190]"
163,22,1922,580,9193,0,1594,328,"[53, 99, 95, 74, 103, 79, 27, 93, 20, 92, 27, 99, 51, 28, 104, 89, 0, 11, 52, 93, 0, 91, 15, 82, 3, 62, 24]"
164,22,2484,6749,4928,0,691,1793,"[46, 321, 67, 249, 560, 4, 85, 359, 313, 526, 9, 517, 282, 282, 142, 533, 444, 323, 430, 205, 0, 64, 13, 15, 371, 506, 367]"
165,22,2005,266,6667,0,1051,954,"[304, 35, 124, 18, 86, 232, 76, 123, 3, 264, 158, 125, 88, 38, 168, 180, 25, 36, 55, 81, 0, 105, 257, 257, 54, 24, 94]"
166,22,2700,2373,6994,0,337,2363,"[463, 280, 398, 644, 457, 760, 517, 465, 202, 213, 777, 678, 315, 701, 480, 479, 263, 534, 631, 448, 0, 643, 652, 558, 643, 402, 465]"
167,22,1361,914,7441,0,1113,248,"[61, 9, 54, 24, 80, 1, 36, 72, 68, 53, 21, 31, 31, 34, 6, 10, 25, 38, 61, 47, 0, 15, 59, 3, 48, 10, 46]"
168,22,2965,2225,8181,0,761,2204,"[697, 92, 308, 630, 671, 505, 692, 312, 158, 104, 524, 580, 487, 278, 407, 300, 603, 570, 572, 544, 0, 183, 485, 701, 547, 78, 724]"
169,22,1743,897,9027,0,821,922,"[59, 213, 216, 282, 28, 95, 266, 33, 86, 128, 31, 186, 149, 14, 296, 22, 184, 59, 95, 305, 0, 200, 156, 260, 285, 301, 58]"
170,22,2589,7429,4187,0,921,1668,"[163, 380, 456, 443, 459, 39, 483, 223, 505, 181, 104, 505, 35, 251, 6, 82, 497, 481, 143, 234, 0, 94, 446, 538, 481, 85, 13]"
171,22,2403,1826,4764,0,2192,211,"[63, 32, 40, 7, 52, 7, 54, 15, 4, 32, 52, 15, 18, 45, 44, 65, 9, 28, 32, 43, 0, 37, 15, 67, 62, 63, 23]"
172,22,1666,1223,5207,0,262,1404,"[368, 69, 227, 177, 332, 228, 312, 145, 332, 43, 273, 92, 76, 331, 202, 32, 251, 67, 346, 372, 0, 404, 329, 256, 194, 8, 150]"
173,22,2753,2726,5234,0,1623,1130,"[32, 74, 102, 294, 31, 354, 376, 329, 180, 338, 374, 185, 67, 14, 23, 352, 172, 170, 207, 235, 0, 140, 103, 57, 213, 175, 246]"
174,22,1131,317,6048,0,115,1016,"[127, 253, 101, 258, 134, 20, 156, 56, 250, 216, 286, 282, 154, 260, 26, 116, 239, 115, 43, 278, 0, 147, 236, 17, 120, 186, 163]"
175,22,1824,439,7433,0,781,1043,"[10, 96, 12, 13, 178, 78, 47, 205, 46, 58, 159, 328, 46, 328, 89, 165, 187, 269, 320, 266, 0, 195, 199, 187, 247, 279, 312]"
176,22,1466,445,8454,0,1321,145,"[14, 21, 43, 31, 41, 42, 3, 34, 26, 40, 20, 34, 4, 4, 18, 37, 21, 35, 19, 39, 0, 25, 33, 1, 35, 7, 15]"
177,22,2505,2212,8747,0,188,2317,"[457, 395, 258, 26, 644, 607, 328, 309, 308, 252, 193, 616, 386, 488, 559, 769, 622, 288, 631, 67, 0, 768, 550, 405, 514, 733, 307]"
178,22,1686,764,9669,0,815,871,"[39, 206, 267, 262, 285, 136, 60, 148, 158, 163, 276, 229, 168, 287, 287, 10, 236, 41, 254, 40, 0, 222, 256, 289, 137, 20, 135]"
179,22,2935,5043,7561,0,320,2615,"[471, 41, 248, 58, 47, 300, 270, 818, 558, 41, 756, 95, 227, 458, 573, 864, 716, 643, 568, 222, 0, 685, 253, 142, 127, 447, 131]"
180,22,2325,1938,7948,0,2261,64,"[12, 10, 17, 15, 12, 9, 2, 7, 15, 15, 21, 16, 1, 17, 3, 20, 18, 9, 15, 4, 0, 0, 14, 19, 8, 12, 1]"
181,22,2058,480,9526,0,867,1191,"[199, 77, 179, 72, 369, 100, 104, 137, 134, 294, 75, 83, 365, 371, 133, 312, 336, 112, 169, 343, 0, 310, 152, 46, 90, 198, 80]"
182,22,2248,6428,5346,0,1737,511,"[43, 72, 162, 26, 29, 120, 165, 53, 110, 13, 4, 118, 3, 157, 120, 102, 164, 49, 30, 38, 0, 115, 5, 25, 30, 110, 88]"
183,22,2091,2057,5380,0,1870,221,"[62, 56, 2, 34, 54, 55, 12, 0, 72, 44, 53, 34, 52, 46, 35, 18, 33, 31, 52, 64, 0, 44, 1, 53, 26, 12, 45]"
184,22,1505,357,6528,0,1368,137,"[26, 2, 19, 39, 43, 22, 19, 24, 32, 44, 1, 20, 43, 35, 41, 41, 4, 45, 14, 41, 0, 23, 18, 21, 27, 12, 29]"
185,22,2576,813,8291,0,540,2036,"[178, 572, 413, 290, 408, 377, 618, 590, 624, 502, 298, 416, 248, 303, 388, 14, 122, 280, 147, 483, 0, 368, 497, 125, 83, 117, 550]"
186,22,2607,1246,9652,0,494,2113,"[422, 202, 10, 304, 583, 13, 112, 592, 309, 463, 607, 51, 239, 34, 647, 91, 174, 478, 594, 615, 0, 293, 151, 437, 626, 55, 685]"
187,22,2793,6796,5649,0,1011,1782,"[237, 38, 37, 125, 483, 202, 164, 552, 290, 522, 501, 419, 104, 523, 50, 136, 337, 234, 516, 150, 0, 161, 554, 593, 347, 292, 96]"
188,22,2913,2707,5855,0,2010,903,"[290, 191, 294, 34, 90, 97, 215, 44, 35, 122, 216, 84, 50, 83, 45, 290, 62, 216, 25, 283, 0, 168, 83, 120, 203, 30, 207]"
189,22,2385,1802,6438,0,1746,639,"[55, 71, 57, 210, 179, 25, 23, 141, 44, 75, 172, 25, 154, 147, 128, 154, 66, 76, 143, 209, 0, 58, 8, 171, 20, 131, 119]"
190,22,2277,1258,7457,0,801,1476,"[333, 395, 16, 159, 380, 433, 133, 94, 154, 326, 420, 310, 179, 37, 174, 193, 123, 273, 184, 281, 0, 483, 235, 478, 209, 404, 185]"
191,22,2343,641,9159,0,1125,1218,"[338, 222, 167, 181, 14, 93, 122, 118, 113, 353, 84, 131, 149, 287, 328, 343, 253, 260, 109, 325, 0, 134, 97, 327, 168, 29, 261]"
192,22,1299,297,10000,161,94,1205,"[295, 164, 26, 166, 36, 158, 94, 86, 386, 4, 341, 310, 274, 180, 57, 20, 390, 320, 188, 182, 0, 123, 378, 373, 39, 199, 309]"
193,22,1043,5762,5281,0,168,875,"[30, 228, 138, 104, 217, 285, 274, 258, 233, 194, 22, 190, 219, 260, 96, 48, 100, 196, 165, 22, 0, 254, 94, 226, 177, 217, 83]"
194,22,1037,665,5653,0,84,953,"[160, 242, 24, 71, 215, 294, 17, 313, 287, 274, 200, 137, 172, 39, 295, 174, 71, 267, 97, 186, 0, 251, 210, 288, 267, 288, 138]"
195,22,1472,1351,5774,0,696,776,"[55, 8, 232, 53, 115, 143, 112, 96, 170, 31, 238, 30, 141, 8, 248, 139, 229, 139, 224, 60, 0, 177, 193, 60, 30, 161, 32]"
196,22,2946,2546,6174,0,521,2425,"[105, 128, 319, 396, 100, 774, 717, 773, 361, 527, 583, 25, 233, 75, 498, 50, 557, 637, 378, 374, 0, 394, 443, 184, 712, 54, 84]"
197,22,1215,692,6697,0,1130,85,"[12, 26, 19, 0, 20, 18, 7, 3, 15, 27, 28, 25, 26, 7, 28, 21, 19, 20, 23, 1, 0, 18, 7, 28, 1, 28, 22]"
198,22,1562,288,7971,0,1028,534,"[67, 62, 77, 21, 101, 170, 27, 149, 29, 92, 129, 172, 72, 137, 45, 3, 24, 42, 76, 167, 0, 145, 56, 49, 40, 27, 155]"
199,22,1266,427,8810,0,1014,252,"[15, 16, 1, 10, 6, 80, 45, 82, 81, 21, 68, 4, 43, 3, 29, 63, 48, 31, 38, 72, 0, 67, 75, 17, 47, 69, 71]"
200,22,1168,450,9528,0,231,937,"[188, 110, 248, 239, 268, 60, 169, 72, 73, 47, 290, 203, 81, 261, 138, 144, 131, 265, 97, 306, 0, 114, 147, 69, 263, 187, 52]"
201,22,1187,15,10000,700,1004,183,"[12, 49, 2, 22, 21, 31, 52, 41, 38, 0, 18, 61, 59, 14, 23, 0, 40, 29, 54, 27, 0, 46, 30, 26, 14, 56, 23]"
202,22,2781,5702,7079,0,1705,1076,"[199, 211, 146, 69, 218, 286, 65, 129, 168, 273, 50, 30, 335, 279, 349, 49, 246, 19, 131, 169, 0, 357, 196, 161, 335, 62, 125]"
203,22,1419,189,8309,0,720,699,"[68, 133, 82, 207, 44, 218, 189, 76, 188, 163, 186, 35, 95, 115, 18, 30, 82, 121, 215, 91, 0, 187, 195, 105, 56, 202, 226]"
204,22,2001,1843,8467,0,443,1558,"[281, 308, 425, 30, 259, 328, 296, 361, 282, 211, 501, 258, 234, 323, 373, 21, 379, 129, 506, 45, 0, 67, 180, 302, 121, 299, 41]"
205,22,2978,6917,4528,0,2384,594,"[136, 150, 36, 133, 124, 131, 6, 108, 102, 141, 170, 160, 169, 110, 194, 124, 146, 98, 73, 45, 0, 63, 62, 163, 198, 113, 123]"
206,22,1026,892,4662,0,186,840,"[143, 96, 31, 247, 123, 261, 126, 245, 83, 150, 196, 47, 46, 20, 83, 82, 200, 62, 229, 239, 0, 176, 267, 233, 65, 187, 250]"
207,22,2300,1994,4968,0,1883,417,"[74, 56, 68, 116, 85, 67, 18, 121, 73, 82, 34, 28, 114, 59, 81, 32, 63, 31, 100, 66, 0, 131, 103, 23, 68, 119, 17]"
208,22,1036,923,5081,0,166,870,"[196, 240, 176, 90, 192, 173, 16, 105, 143, 200, 144, 147, 88, 126, 257, 32, 283, 9, 215, 71, 0, 79, 72, 98, 30, 16, 284]"
209,22,2860,2486,5455,0,744,2116,"[377, 231, 304, 664, 77, 265, 625, 219, 104, 344, 598, 614, 27, 171, 122, 606, 284, 211, 474, 111, 0, 0, 673, 24, 54, 3, 383]"
210,22,2098,1840,5713,0,1357,741,"[83, 5, 136, 231, 113, 179, 17, 242, 18, 170, 23, 97, 187, 183, 184, 191, 89, 240, 188, 230, 0, 206, 49, 207, 59, 124, 169]"
211,22,1866,1814,5765,0,1593,273,"[12, 38, 7, 31, 5, 43, 15, 72, 38, 54, 60, 41, 54, 14, 27, 26, 43, 78, 44, 60, 0, 18, 84, 37, 55, 57, 0]"
212,22,2305,1134,6936,0,313,1992,"[193, 150, 394, 598, 94, 9, 650, 617, 481, 499, 333, 337, 198, 545, 638, 205, 436, 382, 657, 58, 0, 571, 589, 108, 148, 106, 407]"
213,22,2216,329,8823,0,1561,655,"[63, 23, 49, 99, 39, 21, 115, 166, 193, 71, 3, 133, 169, 215, 216, 131, 8, 203, 52, 154, 0, 195, 2, 128, 168, 191, 146]"
214,22,2335,5179,5979,0,1677,658,"[4, 44, 105, 6, 119, 202, 20, 149, 55, 191, 160, 137, 79, 161, 132, 98, 39, 152, 49, 34, 0, 4, 134, 111, 147, 5, 87]"
215,22,1123,31,7071,0,286,837,"[237, 68, 176, 79, 222, 190, 43, 256, 146, 41, 98, 229, 83, 277, 55, 239, 36, 101, 9, 256, 0, 219, 154, 175, 31, 18, 240]"
216,22,2143,931,8283,0,1387,756,"[18, 86, 78, 179, 116, 57, 65, 249, 136, 180, 72, 220, 174, 133, 46, 13, 121, 92, 180, 140, 0, 68, 168, 66, 96, 120, 174]"
217,22,2857,5932,5208,0,1022,1835,"[395, 201, 372, 567, 417, 395, 347, 514, 565, 67, 367, 218, 27, 526, 545, 116, 287, 218, 78, 467, 0, 216, 51, 562, 168, 572, 131]"
218,22,2390,2335,5263,0,679,1711,"[4, 497, 145, 469, 486, 312, 382, 169, 112, 237, 245, 235, 399, 418, 475, 438, 47, 327, 286, 562, 0, 36, 414, 95, 459, 200, 326]"
219,22,1185,260,6188,0,150,1035,"[138, 344, 184, 314, 25, 84, 250, 100, 7, 342, 251, 129, 49, 281, 106, 160, 119, 164, 117, 127, 0, 130, 316, 82, 83, 143, 167]"
220,22,1602,1366,6424,0,1210,392,"[72, 11, 65, 102, 48, 30, 60, 120, 112, 92, 40, 87, 94, 76, 48, 72, 110, 50, 120, 0, 0, 77, 6, 6, 11, 104, 71]"
221,22,2627,489,8562,0,1969,658,"[46, 131, 133, 203, 68, 160, 151, 80, 29, 39, 122, 35, 214, 117, 105, 31, 58, 114, 119, 144, 0, 97, 109, 16, 130, 175, 17]"
222,22,1676,594,9644,0,1265,411,"[101, 51, 94, 129, 100, 93, 48, 80, 86, 111, 9, 43, 8, 19, 72, 88, 100, 61, 37, 81, 0, 95, 135, 8, 126, 128, 85]"
223,22,2768,6141,6271,0,976,1792,"[370, 449, 540, 590, 163, 7, 597, 292, 402, 92, 248, 547, 558, 447, 278, 28, 111, 231, 89, 426, 0, 139, 11, 267, 389, 125, 510]"
224,22,1983,1785,6469,0,501,1482,"[262, 268, 342, 249, 337, 182, 331, 204, 238, 143, 208, 464, 449, 460, 145, 390, 237, 186, 352, 0, 0, 430, 357, 95, 279, 173, 175]"
225,22,2047,830,7686,0,800,1247,"[399, 405, 136, 108, 313, 74, 318, 170, 236, 55, 355, 59, 36, 344, 276, 403, 142, 343, 310, 248, 0, 16, 357, 206, 388, 127, 38]"
226,22,2637,216,10000,107,1956,681,"[35, 202, 89, 107, 5, 40, 46, 12, 120, 51, 38, 80, 97, 225, 215, 61, 153, 179, 21, 163, 0, 121, 19, 128, 55, 20, 82]"
227,22,2723,5510,7213,0,2515,208,"[17, 34, 47, 10, 2, 52, 19, 15, 43, 36, 62, 62, 8, 61, 42, 61, 8, 7, 69, 42, 0, 67, 6, 26, 25, 52, 14]"
228,22,2240,751,8702,0,1536,704,"[35, 6, 79, 52, 108, 7, 177, 48, 146, 171, 70, 55, 145, 82, 61, 92, 230, 209, 165, 152, 0, 152, 22, 30, 202, 145, 79]"
229,22,2641,5435,5908,0,624,2017,"[485, 397, 8, 264, 133, 618, 237, 620, 242, 249, 186, 355, 145, 232, 11, 290, 354, 227, 293, 569, 0, 8, 234, 76, 351, 244, 92]"
230,22,1199,636,6471,0,425,774,"[190, 79, 184, 24, 18, 163, 192, 15, 66, 121, 208, 146, 204, 234, 102, 142, 131, 216, 130, 120, 0, 170, 181, 63, 225, 117, 192]"
231,22,2649,2096,7024,0,935,1714,"[111, 508, 536, 552, 102, 491, 42, 506, 321, 75, 471, 344, 222, 553, 563, 243, 263, 214, 82, 453, 0, 2, 401, 519, 561, 246, 129]"
232,22,2063,185,8902,0,193,1870,"[304, 499, 545, 305, 460, 261, 264, 103, 605, 129, 19, 469, 492, 1, 78, 120, 515, 348, 328, 98, 0, 219, 12, 514, 128, 294, 238]"
233,22,1660,281,10000,281,1283,377,"[8, 91, 78, 106, 115, 120, 87, 13, 30, 87, 122, 122, 106, 74, 100, 64, 80, 18, 7, 65, 0, 98, 90, 0, 22, 100, 26]"
234,22,1791,6036,5755,0,1559,232,"[26, 36, 16, 49, 66, 8, 74, 46, 69, 67, 77, 73, 18, 69, 45, 35, 74, 67, 0, 40, 0, 76, 68, 20, 30, 71, 10]"
235,22,2653,457,7951,0,1624,1029,"[298, 295, 111, 18, 308, 64, 30, 272, 125, 38, 340, 283, 118, 57, 109, 238, 243, 275, 60, 196, 0, 145, 24, 244, 224, 180, 242]"
236,22,1390,818,8523,0,684,706,"[148, 116, 60, 91, 216, 226, 152, 62, 90, 208, 129, 184, 145, 185, 145, 140, 19, 232, 136, 21, 0, 115, 50, 0, 6, 233, 150]"
237,22,1705,262,9966,0,1178,527,"[168, 172, 157, 78, 150, 72, 6, 119, 79, 59, 117, 59, 140, 4, 112, 138, 101, 172, 45, 153, 0, 129, 4, 130, 128, 174, 27]"
238,22,1851,7064,4753,0,1535,316,"[28, 36, 79, 91, 65, 18, 11, 53, 60, 24, 16, 85, 40, 96, 20, 17, 90, 31, 0, 67, 0, 51, 5, 69, 90, 98, 52]"
239,22,1717,889,5581,0,1701,16,"[1, 5, 3, 4, 5, 4, 1, 3, 3, 2, 2, 4, 0, 0, 3, 1, 1, 2, 0, 5, 0, 4, 0, 4, 0, 5, 1]"
240,22,2007,567,7021,0,1746,261,"[44, 72, 52, 18, 38, 86, 3, 6, 19, 8, 9, 75, 81, 60, 3, 54, 81, 9, 15, 7, 0, 82, 84, 67, 23, 31, 11]"
241,22,1555,1058,7518,0,940,615,"[146, 65, 58, 122, 182, 204, 115, 205, 156, 178, 35, 66, 160, 88, 98, 89, 79, 62, 195, 91, 0, 8, 197, 24, 168, 152, 77]"
242,22,2475,386,9607,0,807,1668,"[448, 51, 524, 211, 531, 66, 544, 432, 84, 493, 294, 79, 138, 527, 114, 52, 344, 54, 539, 319, 0, 253, 218, 341, 143, 261, 21]"
243,22,2702,6800,5509,0,2249,453,"[20, 82, 3, 25, 105, 55, 140, 8, 47, 95, 77, 21, 22, 38, 99, 115, 14, 107, 140, 63, 0, 70, 110, 139, 76, 139, 133]"
244,22,2225,297,7437,0,864,1361,"[47, 245, 399, 173, 270, 253, 256, 22, 233, 143, 207, 118, 258, 267, 313, 110, 193, 42, 124, 179, 0, 126, 267, 145, 367, 404, 424]"
245,22,2861,2052,8246,0,2315,546,"[140, 20, 33, 140, 39, 57, 2, 14, 132, 131, 97, 91, 31, 169, 32, 153, 116, 166, 107, 126, 0, 51, 165, 17, 13, 137, 10]"
246,22,2162,919,9489,0,197,1965,"[641, 150, 78, 351, 210, 91, 507, 526, 33, 257, 610, 132, 19, 211, 586, 453, 180, 71, 378, 113, 0, 175, 329, 532, 14, 117, 308]"
247,22,1527,5758,5258,0,844,683,"[23, 24, 162, 168, 203, 214, 6, 119, 95, 27, 33, 2, 93, 209, 84, 85, 67, 114, 74, 26, 0, 198, 212, 0, 3, 103, 99]"
248,22,2017,494,6781,0,1188,829,"[232, 236, 190, 178, 146, 263, 3, 201, 270, 72, 41, 78, 234, 229, 132, 75, 153, 9, 232, 182, 0, 202, 120, 208, 232, 171, 93]"
249,22,1329,861,7249,0,311,1018,"[288, 236, 72, 121, 84, 284, 53, 198, 198, 299, 186, 96, 43, 17, 43, 153, 218, 216, 210, 260, 0, 41, 108, 277, 224, 139, 230]"
250,22,2576,2214,7611,0,2071,505,"[111, 25, 111, 32, 126, 45, 166, 32, 105, 30, 25, 82, 92, 167, 98, 77, 124, 67, 71, 15, 0, 153, 154, 37, 100, 112, 42]"
251,22,2382,2072,7921,0,92,2290,"[473, 537, 321, 385, 47, 474, 324, 307, 504, 631, 400, 566, 413, 198, 63, 303, 186, 441, 198, 262, 0, 429, 99, 503, 508, 728, 265]"
252,22,1834,857,8898,0,1120,714,"[152, 187, 73, 150, 3, 196, 188, 95, 16, 54, 41, 125, 22, 17, 48, 15, 12, 20, 106, 228, 0, 134, 173, 87, 230, 33, 82]"
253,22,2729,7405,4222,0,1018,1711,"[328, 462, 27, 106, 561, 25, 167, 340, 123, 191, 49, 506, 324, 179, 345, 487, 529, 124, 491, 160, 0, 463, 478, 346, 282, 188, 86]"
254,22,1686,1172,4736,0,315,1371,"[343, 146, 282, 265, 164, 118, 57, 203, 89, 10, 446, 317, 411, 278, 118, 89, 443, 356, 49, 137, 0, 412, 181, 399, 216, 76, 350]"
255,22,2294,839,6191,0,1646,648,"[195, 146, 178, 85, 101, 9, 20, 185, 15, 160, 91, 201, 208, 106, 71, 122, 41, 135, 101, 53, 0, 89, 64, 152, 121, 188, 28]"
256,22,2623,1557,7257,0,185,2438,"[421, 33, 336, 610, 3, 721, 606, 31, 712, 549, 354, 539, 381, 14, 332, 633, 790, 451, 6, 611, 0, 440, 164, 158, 81, 343, 483]"
257,22,2898,429,9726,0,2528,370,"[73, 3, 94, 11, 0, 66, 93, 15, 14, 9, 117, 17, 14, 101, 17, 64, 121, 12, 54, 59, 0, 68, 85, 46, 1, 91, 117]"
258,22,1163,785,10000,104,1059,104,"[19, 11, 2, 12, 28, 30, 6, 1, 13, 28, 21, 10, 17, 11, 9, 29, 14, 5, 19, 10, 0, 33, 9, 0, 15, 14, 4]"
259,22,2036,6675,5361,0,1569,467,"[152, 107, 110, 5, 145, 103, 136, 138, 23, 8, 56, 148, 137, 5, 147, 34, 55, 3, 72, 42, 0, 99, 40, 0, 15, 29, 115]"
260,22,1706,1616,5451,0,870,836,"[5, 36, 39, 31, 56, 119, 249, 86, 248, 82, 252, 262, 70, 109, 173, 207, 221, 173, 100, 270, 0, 182, 276, 139, 125, 139, 148]"
261,22,1664,940,6175,0,1273,391,"[99, 82, 11, 1, 106, 50, 82, 127, 39, 126, 49, 60, 6, 2, 29, 7, 75, 88, 119, 67, 0, 53, 75, 84, 85, 71, 105]"
262,22,1258,1139,6294,0,707,551,"[1, 175, 119, 70, 11, 92, 98, 18, 15, 102, 44, 136, 125, 19, 29, 149, 75, 84, 70, 107, 0, 7, 38, 104, 74, 22, 158]"
263,22,2479,1575,7198,0,2415,64,"[17, 3, 2, 17, 7, 13, 9, 0, 17, 19, 10, 7, 2, 15, 10, 5, 8, 15, 4, 12, 0, 11, 8, 5, 11, 0, 20]"
264,22,1232,1163,7267,0,855,377,"[64, 91, 8, 112, 114, 125, 54, 26, 57, 122, 4, 63, 27, 113, 54, 10, 70, 18, 58, 26, 0, 112, 39, 20, 93, 51, 102]"
265,22,2648,355,9560,0,2162,486,"[82, 116, 30, 147, 113, 53, 135, 1, 38, 56, 112, 85, 144, 14, 29, 128, 137, 22, 134, 127, 0, 6, 111, 34, 59, 77, 148]"
266,22,1456,6332,4684,0,1443,13,"[0, 3, 3, 2, 4, 0, 4, 1, 2, 2, 1, 0, 2, 3, 2, 4, 0, 0, 3, 0, 0, 3, 2, 4, 1, 2, 3]"
267,22,1663,353,5994,0,895,768,"[15, 178, 206, 91, 62, 139, 50, 232, 72, 146, 201, 15, 35, 25, 199, 27, 106, 118, 61, 90, 0, 235, 115, 172, 151, 20, 245]"
268,22,2499,1454,7039,0,1236,1263,"[274, 278, 179, 300, 167, 192, 346, 363, 31, 304, 126, 200, 101, 81, 171, 240, 224, 239, 32, 177, 0, 264, 304, 404, 323, 231, 7]"
269,22,2957,805,9191,0,1924,1033,"[192, 339, 107, 136, 144, 317, 244, 327, 182, 6, 54, 270, 225, 20, 37, 248, 72, 71, 314, 196, 0, 220, 257, 181, 91, 322, 228]"
270,22,2258,5186,6263,0,1646,612,"[78, 138, 28, 35, 39, 198, 98, 16, 101, 43, 201, 185, 74, 160, 86, 171, 6, 122, 47, 19, 0, 29, 160, 106, 22, 151, 150]"
271,22,1040,555,6748,0,349,691,"[23, 17, 109, 24, 42, 41, 182, 142, 123, 16, 218, 130, 91, 150, 223, 39, 186, 76, 97, 77, 0, 9, 182, 207, 85, 160, 21]"
272,22,1806,189,8365,0,1087,719,"[202, 114, 142, 9, 191, 224, 99, 20, 68, 163, 93, 204, 71, 92, 155, 3, 53, 236, 47, 205, 0, 227, 165, 93, 190, 126, 1]"
273,22,1642,373,9634,0,1189,453,"[52, 103, 31, 144, 148, 38, 104, 69, 99, 91, 64, 134, 123, 27, 105, 60, 104, 85, 0, 120, 0, 74, 55, 50, 40, 128, 44]"
274,22,1063,373,10000,324,552,511,"[160, 37, 5, 3, 138, 110, 1, 131, 75, 15, 32, 8, 67, 87, 39, 150, 145, 89, 17, 97, 0, 56, 59, 44, 145, 106, 170]"
275,22,1824,5262,6562,0,576,1248,"[157, 344, 210, 247, 346, 389, 234, 156, 14, 90, 181, 292, 7, 403, 383, 65, 402, 319, 303, 319, 0, 175, 284, 180, 43, 203, 314]"
276,22,2847,1506,7903,0,2076,771,"[244, 10, 131, 184, 35, 11, 117, 134, 235, 185, 88, 141, 227, 117, 84, 197, 127, 212, 145, 240, 0, 5, 225, 91, 107, 57, 75]"
277,22,2483,2360,8026,0,2106,377,"[100, 58, 69, 64, 62, 62, 12, 36, 9, 115, 56, 104, 110, 120, 0, 78, 102, 122, 24, 22, 0, 32, 45, 56, 118, 90, 20]"
278,22,1264,1118,8172,0,865,399,"[56, 102, 61, 81, 2, 91, 127, 84, 107, 23, 19, 108, 105, 11, 102, 22, 58, 37, 75, 48, 0, 127, 9, 108, 8, 46, 4]"
279,22,1590,1493,8269,0,775,815,"[79, 214, 158, 20, 186, 128, 207, 270, 203, 117, 247, 173, 79, 239, 112, 39, 209, 237, 255, 69, 0, 121, 130, 104, 92, 162, 158]"
280,22,1376,1059,8586,0,910,466,"[85, 92, 138, 128, 16, 26, 66, 141, 151, 126, 128, 38, 100, 9, 13, 84, 51, 150, 93, 21, 0, 34, 137, 102, 138, 124, 25]"
281,22,2866,5472,5980,0,1962,904,"[248, 286, 23, 150, 189, 42, 201, 85, 298, 242, 21, 180, 3, 50, 176, 49, 264, 100, 232, 233, 0, 203, 21, 22, 276, 88, 99]"
282,22,1999,1461,6518,0,168,1831,"[285, 93, 406, 39, 414, 220, 303, 7, 520, 375, 272, 552, 493, 154, 83, 335, 499, 106, 198, 366, 0, 490, 538, 282, 30, 46, 585]"
283,22,1845,968,7395,0,116,1729,"[294, 301, 376, 448, 2, 146, 245, 0, 271, 545, 324, 264, 574, 524, 462, 2, 209, 567, 422, 374, 0, 565, 159, 466, 543, 554, 221]"
284,22,1110,55,8450,0,773,337,"[60, 10, 67, 33, 103, 106, 98, 15, 90, 50, 102, 88, 14, 60, 47, 74, 25, 6, 65, 77, 0, 50, 26, 41, 65, 60, 84]"
285,22,1730,939,9241,0,737,993,"[301, 196, 148, 281, 273, 139, 15, 214, 239, 261, 67, 21, 270, 63, 98, 168, 204, 202, 304, 331, 0, 145, 192, 267, 266, 271, 77]"
286,22,2353,6368,5226,0,44,2309,"[394, 666, 74, 300, 118, 271, 8, 666, 352, 168, 260, 732, 260, 634, 491, 35, 664, 8, 642, 701, 0, 9, 496, 294, 647, 209, 78]"
287,22,2925,1013,7138,0,149,2776,"[274, 232, 162, 768, 662, 375, 840, 526, 204, 50, 882, 173, 406, 541, 481, 640, 484, 240, 871, 680, 0, 127, 722, 890, 868, 856, 469]"
288,22,2832,1366,8604,0,1114,1718,"[244, 143, 363, 423, 414, 309, 426, 26, 527, 372, 537, 554, 299, 407, 427, 307, 435, 156, 128, 150, 0, 138, 35, 38, 229, 126, 24]"
289,22,2770,6768,4606,0,1230,1540,"[381, 329, 74, 374, 21, 269, 459, 508, 190, 260, 182, 513, 139, 358, 219, 44, 60, 136, 209, 359, 0, 340, 151, 463, 366, 442, 241]"
290,22,1408,198,5816,0,1311,97,"[27, 2, 27, 11, 6, 1, 15, 9, 13, 25, 6, 15, 18, 29, 10, 12, 18, 21, 26, 20, 0, 8, 24, 13, 0, 9, 32]"
291,22,1450,1359,5907,0,147,1303,"[281, 234, 275, 387, 26, 26, 274, 231, 293, 75, 240, 66, 307, 269, 264, 79, 23, 111, 309, 264, 0, 67, 136, 379, 197, 28, 416]"
292,22,1367,1311,5963,0,963,404,"[42, 2, 17, 134, 54, 97, 3, 93, 109, 9, 121, 51, 34, 29, 40, 134, 90, 54, 60, 47, 0, 89, 41, 55, 122, 64, 120]"
293,22,1003,661,6305,0,196,807,"[6, 208, 199, 124, 176, 113, 30, 98, 109, 90, 94, 259, 101, 264, 21, 107, 39, 83, 262, 110, 0, 243, 58, 20, 237, 266, 110]"
294,22,2111,366,8050,0,968,1143,"[197, 323, 252, 125, 7, 332, 174, 358, 27, 164, 334, 196, 341, 39, 134, 70, 213, 97, 369, 94, 0, 175, 130, 216, 76, 312, 117]"
295,22,2356,1170,9236,0,300,2056,"[466, 266, 389, 60, 420, 281, 127, 361, 498, 163, 12, 100, 482, 478, 621, 226, 218, 571, 612, 202, 0, 292, 670, 389, 273, 109, 95]"
296,22,2122,5633,5725,0,749,1373,"[76, 381, 296, 124, 332, 96, 54, 399, 96, 179, 47, 331, 440, 376, 269, 452, 247, 323, 433, 226, 0, 220, 278, 233, 457, 53, 159]"
297,22,2231,914,7042,0,1254,977,"[285, 323, 25, 113, 126, 103, 0, 260, 323, 200, 258, 54, 53, 318, 73, 10, 19, 282, 27, 35, 0, 122, 263, 82, 284, 57, 14]"
298,22,2197,2175,7064,0,1762,435,"[59, 140, 88, 99, 107, 112, 31, 38, 14, 42, 88, 83, 90, 19, 51, 3, 26, 92, 14, 113, 0, 4, 7, 117, 135, 111, 19]"
299,22,2413,569,8908,0,805,1608,"[292, 374, 258, 306, 65, 175, 43, 460, 91, 7, 420, 352, 5, 124, 264, 8, 335, 420, 121, 139, 0, 423, 217, 345, 263, 319, 322]"
0,23,2214,0,2214,0,1800,414,"[83, 107, 14, 17, 83, 55, 40, 46, 31, 36, 94, 122, 28, 68, 12, 71, 72, 44, 99, 76, 22, 59, 0, 121, 62, 65, 12]"
1,23,1092,75,3231,0,519,573,"[177, 143, 76, 162, 8, 158, 32, 44, 141, 26, 18, 28, 123, 70, 70, 184, 168, 80, 82, 156, 96, 113, 0, 20, 106, 86, 176]"
2,23,1216,677,3770,0,706,510,"[87, 156, 75, 22, 104, 119, 148, 25, 24, 3, 100, 48, 23, 125, 65, 152, 157, 27, 131, 46, 42, 89, 0, 107, 43, 103, 50]"
3,23,2543,331,5982,0,819,1724,"[224, 325, 135, 307, 505, 409, 488, 26, 167, 225, 409, 542, 307, 481, 523, 341, 450, 98, 290, 287, 203, 464, 0, 487, 413, 148, 62]"
4,23,2685,638,8029,0,90,2595,"[133, 90, 139, 508, 29, 11, 467, 89, 199, 87, 203, 833, 588, 284, 302, 730, 3, 443, 703, 316, 619, 399, 0, 851, 712, 386, 486]"
5,23,1063,176,8916,0,585,478,"[54, 117, 40, 34, 159, 0, 45, 120, 103, 75, 67, 90, 3, 126, 24, 10, 24, 147, 19, 32, 100, 78, 0, 1, 57, 127, 11]"
6,23,2938,6573,5281,0,2237,701,"[122, 200, 184, 15, 168, 16, 196, 179, 53, 97, 97, 104, 131, 60, 223, 120, 69, 95, 115, 180, 122, 59, 0, 125, 25, 125, 0]"
7,23,1568,528,6321,0,1466,102,"[27, 13, 18, 24, 0, 25, 3, 29, 18, 4, 22, 16, 18, 3, 23, 29, 12, 9, 11, 18, 28, 10, 0, 23, 6, 6, 34]"
8,23,1106,282,7145,0,1018,88,"[5, 7, 19, 20, 15, 16, 29, 1, 18, 28, 3, 9, 1, 29, 8, 13, 13, 11, 6, 25, 8, 27, 0, 25, 10, 1, 5]"
9,23,1480,1351,7274,0,876,604,"[83, 94, 177, 160, 137, 136, 40, 177, 91, 198, 172, 195, 135, 88, 107, 191, 60, 64, 19, 187, 165, 133, 0, 115, 154, 148, 173]"
10,23,1451,1099,7626,0,239,1212,"[359, 261, 285, 191, 231, 144, 162, 345, 96, 309, 300, 137, 285, 20, 256, 304, 14, 148, 235, 28, 110, 305, 0, 43, 26, 347, 27]"
11,23,2768,2610,7784,0,1635,1133,"[274, 142, 39, 270, 83, 225, 336, 294, 132, 243, 223, 242, 98, 316, 67, 11, 291, 136, 277, 282, 352, 17, 0, 301, 185, 6, 123]"
12,23,2456,1627,8613,0,1475,981,"[117, 326, 212, 220, 177, 207, 173, 3, 123, 122, 216, 68, 1, 113, 25, 263, 40, 90, 150, 188, 177, 21, 0, 164, 179, 197, 256]"
13,23,2761,5969,5405,0,163,2598,"[403, 620, 438, 537, 817, 90, 7, 686, 638, 357, 682, 702, 706, 178, 769, 53, 691, 256, 230, 229, 128, 141, 0, 129, 446, 665, 863]"
14,23,2160,1638,5927,0,122,2038,"[83, 636, 283, 95, 393, 30, 540, 649, 231, 558, 216, 306, 376, 213, 514, 597, 407, 95, 281, 305, 280, 552, 0, 164, 659, 568, 384]"
15,23,1175,138,6964,0,530,645,"[138, 140, 14, 198, 48, 147, 131, 58, 100, 21, 174, 193, 21, 179, 115, 60, 100, 135, 0, 129, 191, 53, 0, 18, 60, 78, 90]"
16,23,2251,1068,8147,0,295,1956,"[49, 634, 641, 128, 639, 519, 645, 574, 625, 376, 318, 58, 96, 326, 117, 66, 70, 59, 242, 277, 206, 508, 0, 426, 113, 621, 202]"
17,23,1844,1318,8673,0,1744,100,"[6, 9, 18, 17, 1, 26, 1, 20, 0, 11, 4, 8, 33, 28, 5, 12, 6, 1, 12, 8, 10, 4, 0, 7, 33, 17, 15]"
18,23,1707,855,9525,0,51,1656,"[245, 319, 55, 431, 379, 61, 351, 156, 404, 376, 91, 489, 193, 434, 24, 409, 220, 24, 70, 51, 270, 108, 0, 39, 347, 549, 349]"
19,23,2867,6621,5771,0,2546,321,"[16, 88, 87, 81, 33, 51, 45, 17, 80, 88, 2, 92, 81, 31, 44, 106, 59, 103, 68, 76, 77, 47, 0, 65, 44, 104, 100]"
20,23,1573,1048,6296,0,523,1050,"[76, 280, 181, 12, 230, 226, 296, 132, 129, 3, 283, 289, 23, 138, 129, 64, 58, 191, 56, 16, 237, 268, 0, 342, 290, 195, 87]"
21,23,2468,1958,6806,0,691,1777,"[518, 164, 418, 525, 231, 203, 476, 489, 339, 291, 33, 98, 285, 34, 69, 262, 556, 307, 369, 276, 427, 269, 0, 49, 190, 530, 432]"
22,23,1950,732,8024,0,764,1186,"[299, 225, 304, 322, 309, 283, 341, 104, 367, 108, 124, 370, 202, 195, 295, 66, 201, 320, 67, 167, 303, 91, 0, 106, 36, 171, 160]"
23,23,1292,142,9174,0,510,782,"[203, 31, 20, 123, 93, 246, 109, 156, 181, 28, 121, 111, 140, 77, 175, 241, 256, 180, 8, 53, 162, 240, 0, 155, 102, 101, 224]"
24,23,2804,5886,6092,0,1753,1051,"[76, 276, 212, 344, 111, 61, 124, 203, 222, 132, 63, 138, 235, 119, 123, 292, 191, 111, 26, 65, 180, 272, 0, 52, 46, 141, 313]"
25,23,1729,539,7282,0,55,1674,"[206, 83, 25, 242, 150, 524, 252, 527, 250, 36, 452, 381, 150, 125, 264, 271, 5, 132, 311, 443, 345, 399, 0, 42, 135, 348, 315]"
26,23,2131,533,8880,0,759,1372,"[29, 120, 61, 248, 311, 328, 132, 264, 408, 152, 410, 420, 106, 228, 89, 276, 282, 430, 174, 302, 199, 168, 0, 221, 362, 288, 210]"
27,23,1845,1650,9075,0,1226,619,"[178, 61, 187, 130, 182, 38, 31, 200, 118, 152, 8, 9, 2, 11, 15, 2, 198, 11, 139, 158, 61, 36, 0, 51, 191, 0, 100]"
28,23,1674,404,10000,345,1633,41,"[4, 8, 9, 2, 8, 8, 1, 7, 2, 5, 2, 11, 0, 5, 5, 3, 5, 13, 1, 1, 0, 1, 0, 8, 0, 3, 5]"
29,23,1727,6952,4775,0,80,1647,"[532, 422, 91, 32, 18, 174, 205, 275, 495, 349, 180, 481, 400, 167, 289, 77, 337, 79, 401, 32, 251, 417, 0, 365, 13, 462, 180]"
30,23,1237,1205,4807,0,942,295,"[97, 94, 90, 64, 39, 62, 90, 12, 80, 75, 89, 65, 28, 93, 43, 79, 5, 23, 84, 9, 47, 40, 0, 72, 20, 94, 82]"
31,23,1821,1,6627,0,1537,284,"[69, 35, 75, 37, 60, 0, 38, 34, 54, 73, 56, 70, 16, 3, 64, 69, 7, 69, 10, 46, 30, 63, 0, 79, 74, 15, 7]"
32,23,2791,1462,7956,0,220,2571,"[359, 12, 213, 805, 181, 348, 469, 271, 36, 662, 435, 365, 562, 464, 402, 167, 158, 169, 90, 475, 543, 387, 0, 556, 683, 708, 167]"
33,23,1348,760,8544,0,983,365,"[20, 57, 79, 45, 56, 75, 13, 10, 71, 49, 60, 73, 102, 89, 121, 55, 45, 68, 61, 23, 8, 42, 0, 75, 38, 18, 63]"
34,23,1699,813,9430,0,624,1075,"[312, 13, 339, 105, 272, 151, 171, 148, 98, 185, 103, 179, 284, 253, 318, 152, 174, 0, 337, 113, 1, 75, 0, 265, 247, 25, 147]"
35,23,2069,5806,5693,0,353,1716,"[541, 244, 286, 165, 473, 12, 312, 79, 250, 450, 102, 373, 217, 225, 187, 554, 28, 140, 275, 141, 142, 29, 0, 114, 137, 303, 444]"
36,23,1028,754,5967,0,488,540,"[98, 53, 145, 51, 40, 147, 145, 32, 25, 153, 167, 0, 21, 38, 119, 172, 114, 85, 166, 171, 106, 37, 0, 12, 108, 15, 71]"
37,23,2483,281,8169,0,451,2032,"[639, 669, 171, 471, 449, 350, 299, 530, 66, 659, 396, 187, 143, 361, 244, 498, 490, 480, 471, 483, 58, 165, 0, 378, 635, 306, 524]"
38,23,1967,494,9642,0,1692,275,"[35, 72, 67, 42, 67, 84, 71, 10, 50, 14, 50, 21, 31, 65, 7, 18, 68, 41, 61, 59, 78, 52, 0, 61, 56, 16, 27]"
39,23,2391,5338,6695,0,69,2322,"[305, 679, 380, 346, 764, 427, 513, 497, 224, 245, 392, 624, 26, 510, 528, 278, 766, 390, 472, 712, 672, 135, 0, 182, 760, 668, 359]"
40,23,1372,896,7171,0,342,1030,"[315, 71, 304, 37, 127, 61, 86, 78, 216, 32, 137, 10, 267, 4, 148, 316, 258, 156, 225, 204, 13, 255, 0, 339, 50, 250, 138]"
41,23,2285,1199,8257,0,2046,239,"[2, 71, 33, 32, 0, 43, 78, 21, 63, 44, 34, 37, 73, 64, 37, 52, 65, 75, 17, 36, 19, 5, 0, 14, 29, 38, 49]"
42,23,2423,274,10000,406,1733,690,"[31, 134, 164, 45, 95, 36, 28, 9, 120, 175, 31, 109, 169, 221, 57, 201, 162, 67, 0, 161, 130, 45, 0, 21, 223, 103, 176]"
43,23,1731,7291,4440,0,277,1454,"[114, 252, 395, 339, 437, 78, 484, 261, 341, 106, 362, 228, 178, 433, 221, 187, 61, 432, 436, 13, 310, 200, 0, 199, 52, 432, 474]"
44,23,2959,1246,6153,0,2614,345,"[62, 100, 73, 91, 98, 88, 89, 74, 80, 102, 112, 64, 91, 18, 82, 92, 30, 108, 22, 100, 22, 81, 0, 22, 106, 60, 20]"
45,23,1093,675,6571,0,35,1058,"[268, 318, 90, 220, 83, 125, 180, 20, 21, 145, 56, 200, 182, 226, 83, 276, 184, 308, 239, 5, 85, 307, 0, 126, 261, 85, 333]"
46,23,2240,955,7856,0,2114,126,"[41, 0, 4, 8, 42, 0, 10, 40, 31, 29, 20, 26, 0, 40, 33, 20, 42, 42, 22, 30, 10, 32, 0, 4, 14, 13, 19]"
47,23,1761,1513,8104,0,1519,242,"[34, 55, 20, 76, 75, 22, 41, 1, 47, 67, 41, 65, 26, 48, 14, 9, 67, 78, 67, 34, 41, 70, 0, 27, 62, 28, 24]"
48,23,1119,873,8350,0,23,1096,"[348, 104, 252, 327, 194, 295, 74, 126, 47, 145, 108, 291, 73, 260, 106, 211, 13, 149, 153, 228, 128, 12, 0, 250, 139, 99, 53]"
49,23,2943,5536,5757,0,2140,803,"[78, 172, 74, 44, 19, 57, 188, 220, 105, 260, 72, 252, 169, 57, 22, 131, 254, 243, 214, 237, 102, 19, 0, 265, 111, 130, 8]"
50,23,2572,2462,5867,0,2494,78,"[22, 19, 14, 15, 7, 9, 23, 26, 26, 0, 18, 21, 5, 10, 8, 12, 13, 25, 11, 1, 23, 4, 0, 21, 5, 21, 1]"
51,23,2790,1206,7451,0,1495,1295,"[420, 386, 29, 329, 123, 28, 295, 182, 364, 251, 146, 296, 97, 231, 17, 137, 252, 303, 398, 220, 232, 222, 0, 215, 128, 212, 180]"
52,23,2016,226,9241,0,210,1806,"[597, 318, 562, 519, 43, 595, 71, 390, 122, 166, 82, 54, 379, 411, 391, 0, 458, 249, 28, 312, 202, 425, 0, 433, 421, 17, 391]"
53,23,2219,5124,6336,0,2150,69,"[2, 1, 10, 19, 5, 0, 21, 1, 5, 17, 22, 4, 12, 12, 18, 9, 0, 12, 8, 17, 8, 19, 0, 16, 18, 22, 3]"
54,23,1641,353,7624,0,1274,367,"[45, 30, 39, 66, 90, 50, 65, 78, 89, 43, 86, 112, 112, 17, 87, 97, 64, 115, 111, 86, 28, 0, 0, 69, 80, 67, 67]"
55,23,2596,448,9772,0,1690,906,"[171, 129, 84, 143, 87, 142, 130, 7, 100, 111, 291, 235, 236, 110, 126, 258, 136, 28, 274, 126, 263, 217, 0, 9, 192, 201, 49]"
56,23,1374,5333,5813,0,882,492,"[37, 62, 36, 123, 114, 138, 42, 151, 147, 55, 39, 65, 31, 26, 46, 111, 42, 138, 113, 154, 131, 62, 0, 23, 36, 149, 115]"
57,23,1290,464,6639,0,421,869,"[280, 232, 92, 159, 275, 158, 239, 215, 38, 197, 141, 196, 71, 136, 33, 248, 188, 117, 269, 53, 264, 111, 0, 253, 90, 194, 232]"
58,23,1703,47,8295,0,1238,465,"[124, 117, 129, 18, 119, 41, 116, 59, 132, 68, 111, 124, 0, 8, 121, 52, 42, 8, 67, 4, 141, 35, 0, 27, 59, 38, 11]"
59,23,2691,2678,8308,0,11,2680,"[276, 847, 265, 820, 489, 250, 76, 662, 661, 773, 794, 336, 650, 670, 571, 73, 252, 352, 433, 7, 423, 678, 0, 513, 51, 95, 239]"
60,23,2749,5722,5335,0,2014,735,"[69, 76, 20, 130, 100, 124, 111, 188, 40, 233, 212, 143, 20, 172, 223, 28, 94, 150, 140, 155, 60, 134, 0, 185, 109, 186, 208]"
61,23,1504,663,6176,0,922,582,"[130, 164, 61, 3, 188, 46, 147, 120, 29, 45, 55, 74, 159, 119, 45, 108, 15, 121, 180, 192, 9, 44, 0, 76, 121, 84, 166]"
62,23,2369,863,7682,0,1833,536,"[49, 143, 57, 62, 74, 105, 169, 162, 138, 80, 122, 168, 32, 4, 133, 51, 99, 158, 110, 12, 67, 110, 0, 134, 6, 174, 124]"
63,23,2859,1121,9420,0,2331,528,"[79, 40, 75, 151, 85, 9, 20, 25, 105, 50, 14, 27, 74, 80, 105, 45, 170, 48, 72, 110, 74, 59, 0, 129, 170, 2, 7]"
64,23,2571,7051,4940,0,1910,661,"[44, 91, 78, 56, 26, 149, 69, 199, 8, 96, 56, 201, 102, 119, 38, 205, 113, 37, 173, 92, 87, 9, 0, 10, 39, 32, 93]"
65,23,2160,1585,5515,0,2054,106,"[18, 22, 15, 11, 33, 30, 11, 8, 2, 20, 34, 23, 10, 24, 35, 5, 25, 3, 2, 35, 4, 22, 0, 8, 2, 10, 13]"
66,23,1365,857,6023,0,538,827,"[260, 172, 86, 228, 113, 227, 84, 138, 211, 83, 160, 90, 105, 5, 32, 7, 28, 10, 105, 235, 122, 202, 0, 233, 137, 267, 87]"
67,23,1264,780,6507,0,136,1128,"[86, 100, 61, 330, 316, 189, 276, 27, 0, 105, 290, 361, 157, 365, 188, 322, 249, 230, 72, 26, 102, 48, 0, 295, 99, 328, 170]"
68,23,2913,659,8761,0,1585,1328,"[85, 93, 230, 348, 234, 200, 117, 204, 162, 18, 379, 85, 389, 184, 438, 366, 240, 197, 46, 268, 332, 102, 0, 389, 9, 226, 300]"
69,23,2401,7218,3944,0,1924,477,"[0, 104, 99, 43, 65, 145, 19, 31, 79, 50, 47, 91, 74, 37, 143, 150, 11, 91, 5, 26, 11, 2, 0, 131, 154, 13, 93]"
70,23,2595,1955,4584,0,1898,697,"[81, 72, 64, 103, 186, 8, 46, 82, 57, 41, 177, 21, 179, 77, 165, 25, 166, 164, 83, 48, 30, 9, 0, 83, 106, 4, 214]"
71,23,2533,2122,4995,0,1748,785,"[80, 220, 172, 61, 194, 62, 207, 208, 212, 97, 32, 87, 202, 228, 45, 16, 50, 78, 141, 234, 81, 169, 0, 246, 53, 129, 115]"
72,23,2241,1638,5598,0,319,1922,"[503, 302, 11, 39, 80, 489, 190, 599, 3, 240, 538, 183, 340, 607, 240, 260, 410, 580, 134, 264, 423, 168, 0, 102, 253, 15, 110]"
73,23,1414,181,6831,0,493,921,"[253, 280, 32, 272, 58, 37, 85, 155, 87, 231, 184, 214, 159, 265, 243, 104, 4, 90, 207, 304, 218, 274, 0, 298, 207, 231, 292]"
74,23,2923,2707,7047,0,694,2229,"[368, 280, 220, 312, 255, 461, 71, 352, 585, 167, 689, 202, 68, 645, 569, 35, 397, 78, 458, 37, 568, 315, 0, 285, 467, 49, 363]"
75,23,2242,2084,7205,0,24,2218,"[545, 433, 150, 288, 174, 28, 353, 50, 453, 400, 265, 451, 173, 510, 283, 511, 517, 246, 251, 721, 581, 688, 0, 518, 38, 174, 20]"
76,23,1638,936,7907,0,196,1442,"[187, 121, 457, 77, 13, 122, 81, 47, 114, 209, 453, 38, 177, 392, 19, 200, 436, 170, 67, 145, 285, 386, 0, 367, 294, 85, 61]"
77,23,1791,652,9046,0,253,1538,"[104, 434, 377, 288, 304, 273, 203, 468, 274, 428, 188, 163, 43, 30, 75, 403, 186, 280, 445, 217, 56, 143, 0, 11, 273, 109, 96]"
78,23,1531,547,10000,30,943,588,"[85, 168, 100, 61, 163, 136, 109, 110, 7, 46, 90, 44, 66, 108, 100, 75, 63, 122, 28, 70, 51, 137, 0, 95, 159, 58, 158]"
79,23,2435,7108,5327,0,2423,12,"[2, 1, 3, 2, 1, 0, 0, 4, 4, 2, 0, 3, 2, 2, 2, 1, 2, 4, 1, 1, 1, 2, 0, 0, 4, 1, 4]"
80,23,2658,1373,6612,0,527,2131,"[431, 664, 24, 504, 197, 704, 207, 149, 50, 8, 88, 381, 272, 132, 298, 230, 634, 539, 526, 352, 280, 483, 0, 458, 594, 11, 709]"
81,23,2921,1301,8232,0,1986,935,"[252, 142, 234, 83, 291, 253, 193, 142, 96, 248, 235, 286, 43, 91, 82, 60, 75, 66, 67, 311, 277, 39, 0, 118, 8, 113, 64]"
82,23,2345,2252,8325,0,214,2131,"[587, 268, 101, 285, 402, 593, 488, 79, 596, 310, 583, 154, 476, 12, 611, 555, 285, 415, 117, 602, 254, 47, 0, 569, 458, 339, 284]"
83,23,2311,1194,9442,0,2293,18,"[2, 5, 5, 2, 5, 2, 3, 0, 5, 5, 4, 5, 0, 2, 2, 0, 0, 3, 4, 3, 3, 0, 0, 5, 2, 0, 0]"
84,23,1844,7474,3812,0,963,881,"[167, 135, 17, 170, 4, 97, 193, 84, 77, 175, 143, 23, 183, 126, 135, 243, 229, 209, 95, 279, 152, 283, 0, 55, 205, 166, 247]"
85,23,1417,1275,3954,0,1300,117,"[25, 21, 0, 16, 3, 13, 14, 2, 19, 10, 30, 13, 10, 15, 5, 25, 30, 5, 11, 35, 36, 29, 0, 32, 25, 36, 10]"
86,23,1789,1521,4222,0,286,1503,"[292, 271, 112, 104, 25, 479, 304, 111, 152, 322, 175, 277, 178, 485, 202, 357, 317, 147, 208, 18, 34, 462, 0, 221, 307, 158, 368]"
87,23,1965,1750,4437,0,1591,374,"[88, 9, 87, 2, 53, 9, 124, 93, 25, 63, 123, 78, 9, 86, 110, 15, 26, 91, 10, 93, 30, 82, 0, 99, 55, 71, 56]"
88,23,1737,1024,5150,0,1170,567,"[2, 89, 21, 5, 169, 54, 71, 21, 88, 70, 96, 44, 17, 99, 77, 123, 138, 61, 109, 137, 181, 27, 0, 76, 93, 110, 188]"
89,23,2008,156,7002,0,1441,567,"[136, 47, 21, 69, 156, 161, 109, 111, 79, 143, 58, 142, 78, 109, 108, 96, 25, 95, 31, 55, 178, 88, 0, 73, 21, 19, 63]"
90,23,1780,272,8510,0,265,1515,"[334, 441, 62, 451, 504, 36, 302, 484, 465, 76, 458, 469, 300, 150, 133, 484, 113, 347, 148, 325, 489, 353, 0, 185, 296, 358, 335]"
91,23,2689,6236,4963,0,553,2136,"[452, 204, 238, 592, 201, 166, 213, 323, 62, 375, 417, 133, 515, 672, 183, 213, 42, 538, 75, 503, 140, 710, 0, 255, 79, 546, 337]"
92,23,2373,35,7301,0,922,1451,"[245, 367, 53, 302, 468, 74, 288, 11, 196, 362, 206, 170, 183, 304, 254, 14, 367, 74, 211, 361, 286, 434, 0, 293, 249, 383, 481]"
93,23,2696,562,9435,0,2478,218,"[24, 32, 32, 2, 12, 54, 25, 63, 52, 25, 19, 58, 23, 59, 15, 56, 69, 51, 18, 71, 5, 11, 0, 7, 1, 35, 63]"
94,23,2882,5611,6706,0,2419,463,"[73, 39, 70, 8, 147, 49, 42, 53, 32, 4, 133, 123, 96, 55, 97, 114, 61, 77, 145, 64, 31, 121, 0, 93, 31, 120, 145]"
95,23,1739,303,8142,0,1112,627,"[186, 21, 117, 144, 3, 165, 191, 17, 182, 99, 181, 11, 139, 165, 131, 72, 126, 98, 112, 175, 17, 35, 0, 119, 106, 177, 26]"
96,23,2154,1669,8627,0,2022,132,"[24, 33, 9, 27, 18, 28, 4, 24, 41, 41, 14, 21, 0, 9, 18, 34, 14, 9, 30, 36, 38, 28, 0, 26, 14, 34, 44]"
97,23,2800,6263,5164,0,11,2789,"[82, 230, 287, 295, 658, 689, 832, 732, 200, 885, 53, 200, 898, 58, 846, 330, 309, 873, 703, 231, 894, 359, 0, 167, 913, 601, 882]"
98,23,1833,954,6043,0,588,1245,"[152, 342, 364, 271, 284, 202, 54, 339, 120, 137, 279, 77, 65, 267, 187, 343, 98, 29, 161, 331, 264, 163, 0, 97, 140, 90, 361]"
99,23,2447,668,7822,0,405,2042,"[401, 477, 287, 206, 104, 264, 480, 303, 569, 254, 169, 177, 593, 67, 132, 75, 420, 336, 575, 616, 662, 299, 0, 446, 312, 380, 106]"
100,23,1137,183,8776,0,37,1100,"[307, 114, 365, 145, 169, 119, 245, 213, 278, 133, 133, 212, 122, 178, 119, 239, 138, 110, 349, 19, 328, 133, 0, 276, 77, 94, 295]"
101,23,1233,109,9900,0,714,519,"[1, 129, 100, 139, 58, 17, 11, 84, 157, 15, 142, 17, 76, 138, 129, 138, 146, 15, 43, 79, 17, 57, 0, 171, 62, 75, 164]"
102,23,1213,6715,4398,0,894,319,"[39, 65, 58, 65, 35, 86, 75, 47, 87, 38, 72, 86, 55, 14, 59, 82, 71, 29, 9, 8, 101, 11, 0, 88, 12, 85, 42]"
103,23,2399,1012,5785,0,1498,901,"[62, 43, 20, 33, 123, 165, 228, 75, 300, 226, 25, 164, 242, 265, 228, 145, 78, 61, 216, 207, 130, 60, 0, 86, 4, 102, 274]"
104,23,1176,788,6173,0,109,1067,"[271, 65, 313, 128, 74, 211, 284, 300, 232, 168, 188, 230, 54, 306, 156, 202, 80, 191, 217, 68, 284, 262, 0, 73, 123, 277, 182]"
105,23,2811,1776,7208,0,255,2556,"[591, 48, 305, 125, 839, 650, 508, 17, 760, 340, 633, 425, 706, 48, 743, 552, 458, 449, 175, 382, 188, 132, 0, 558, 635, 559, 206]"
106,23,1733,1080,7861,0,79,1654,"[439, 120, 50, 27, 464, 31, 417, 124, 445, 466, 60, 296, 263, 263, 55, 99, 202, 376, 54, 349, 23, 26, 0, 392, 397, 377, 81]"
107,23,1998,1807,8052,0,1113,885,"[30, 143, 226, 143, 183, 220, 165, 25, 78, 186, 223, 79, 124, 186, 47, 189, 120, 272, 40, 183, 263, 258, 0, 90, 213, 209, 238]"
108,23,2203,1385,8870,0,935,1268,"[48, 144, 81, 416, 218, 303, 300, 409, 62, 244, 162, 345, 283, 199, 277, 172, 296, 135, 5, 71, 384, 393, 0, 90, 224, 137, 328]"
109,23,1510,1334,9046,0,1330,180,"[55, 14, 38, 17, 39, 37, 40, 7, 24, 12, 48, 45, 12, 57, 39, 55, 39, 54, 36, 19, 57, 13, 0, 17, 11, 58, 12]"
110,23,2260,6582,4724,0,1309,951,"[55, 104, 213, 180, 100, 146, 240, 267, 181, 5, 293, 44, 279, 135, 30, 131, 8, 238, 276, 310, 100, 210, 0, 42, 272, 283, 191]"
111,23,1537,533,5728,0,54,1483,"[62, 38, 87, 244, 46, 66, 323, 444, 138, 403, 316, 119, 482, 10, 177, 72, 242, 465, 204, 337, 351, 350, 0, 207, 289, 360, 207]"
112,23,2372,1081,7019,0,389,1983,"[52, 423, 67, 252, 279, 571, 485, 303, 104, 149, 579, 572, 34, 168, 648, 82, 180, 144, 562, 60, 599, 317, 0, 37, 125, 262, 339]"
113,23,1684,117,8586,0,753,931,"[215, 52, 81, 271, 109, 231, 140, 160, 102, 126, 120, 170, 114, 253, 261, 279, 248, 148, 226, 6, 241, 126, 0, 92, 259, 68, 226]"
114,23,1116,60,9642,0,674,442,"[55, 7, 116, 113, 112, 26, 51, 134, 11, 104, 1, 115, 109, 117, 124, 119, 61, 63, 26, 34, 137, 135, 0, 112, 8, 112, 23]"
115,23,1079,622,10000,99,1037,42,"[14, 4, 2, 5, 14, 4, 4, 2, 5, 5, 5, 4, 13, 12, 6, 12, 2, 10, 9, 0, 14, 4, 0, 12, 1, 6, 11]"
116,23,1472,5105,6367,0,461,1011,"[133, 229, 129, 246, 53, 221, 29, 217, 300, 295, 153, 63, 145, 157, 77, 235, 122, 100, 321, 169, 184, 179, 0, 12, 50, 104, 275]"
117,23,2394,670,8091,0,2004,390,"[97, 8, 47, 45, 66, 31, 128, 56, 76, 98, 109, 28, 123, 62, 66, 34, 106, 97, 24, 57, 108, 78, 0, 85, 81, 86, 73]"
118,23,1946,1271,8766,0,12,1934,"[552, 58, 299, 230, 503, 27, 632, 174, 371, 224, 481, 52, 293, 366, 449, 307, 254, 585, 296, 525, 165, 305, 0, 384, 306, 420, 229]"
119,23,2114,2043,8837,0,1823,291,"[70, 48, 51, 88, 2, 6, 22, 55, 16, 33, 72, 81, 95, 27, 24, 36, 49, 62, 46, 5, 1, 6, 0, 65, 20, 16, 19]"
120,23,1890,1302,9425,0,1269,621,"[19, 185, 73, 47, 65, 93, 49, 23, 163, 106, 77, 182, 172, 97, 199, 180, 128, 0, 47, 144, 129, 116, 0, 43, 37, 66, 207]"
121,23,2162,5948,5639,0,1731,431,"[87, 141, 5, 17, 62, 27, 42, 100, 96, 50, 41, 33, 72, 120, 19, 48, 104, 37, 56, 106, 86, 42, 0, 95, 37, 98, 10]"
122,23,2153,848,6944,0,897,1256,"[326, 292, 348, 133, 418, 30, 12, 307, 401, 142, 270, 141, 116, 91, 45, 105, 334, 293, 198, 94, 13, 398, 0, 93, 261, 154, 222]"
123,23,1813,964,7793,0,796,1017,"[218, 208, 121, 170, 312, 103, 91, 145, 334, 303, 285, 15, 307, 74, 35, 266, 245, 173, 144, 144, 38, 19, 0, 130, 98, 82, 234]"
124,23,1456,937,8312,0,348,1108,"[135, 214, 3, 310, 154, 211, 105, 341, 156, 270, 276, 192, 322, 249, 333, 222, 105, 342, 202, 76, 258, 333, 0, 265, 114, 226, 184]"
125,23,2528,426,10000,414,438,2090,"[88, 10, 273, 467, 173, 148, 616, 224, 515, 690, 127, 364, 265, 627, 2, 131, 462, 512, 138, 121, 213, 584, 0, 249, 593, 190, 466]"
126,23,1096,5917,5179,0,1028,68,"[7, 0, 10, 6, 9, 4, 3, 14, 6, 22, 15, 10, 22, 10, 1, 7, 19, 18, 16, 2, 18, 8, 0, 0, 11, 4, 11]"
127,23,1313,196,6296,0,1149,164,"[14, 54, 14, 51, 36, 2, 41, 38, 12, 24, 20, 24, 8, 5, 0, 51, 4, 18, 51, 53, 3, 3, 0, 29, 40, 52, 36]"
128,23,2711,1124,7883,0,2269,442,"[43, 5, 125, 31, 92, 65, 83, 46, 23, 26, 36, 132, 78, 0, 147, 99, 0, 110, 84, 136, 58, 52, 0, 112, 98, 17, 33]"
129,23,1377,1316,7944,0,1309,68,"[6, 19, 3, 1, 17, 1, 0, 13, 11, 5, 2, 12, 4, 7, 7, 5, 2, 15, 10, 2, 19, 19, 0, 14, 1, 21, 16]"
130,23,1476,1159,8261,0,1265,211,"[34, 22, 42, 13, 40, 35, 10, 44, 68, 45, 69, 5, 28, 68, 30, 50, 57, 51, 22, 69, 53, 18, 0, 60, 66, 48, 9]"
131,23,1372,1076,8557,0,1008,364,"[4, 90, 68, 12, 76, 121, 41, 113, 105, 66, 116, 5, 86, 49, 79, 85, 85, 80, 33, 26, 2, 52, 0, 20, 51, 62, 74]"
132,23,2497,5782,5272,0,968,1529,"[46, 418, 29, 273, 368, 280, 476, 49, 62, 358, 435, 61, 380, 282, 459, 145, 164, 168, 28, 7, 201, 383, 0, 307, 57, 19, 188]"
133,23,1594,1420,5446,0,1388,206,"[19, 61, 38, 3, 21, 15, 17, 43, 18, 30, 41, 53, 7, 33, 2, 2, 54, 23, 37, 0, 64, 28, 0, 35, 29, 31, 26]"
134,23,2685,1042,7089,0,1663,1022,"[201, 127, 202, 145, 77, 71, 242, 302, 39, 184, 21, 260, 245, 326, 278, 32, 46, 254, 266, 252, 208, 104, 0, 305, 239, 168, 308]"
135,23,1676,0,8765,0,790,886,"[91, 173, 235, 236, 86, 20, 74, 289, 222, 95, 142, 2, 129, 220, 81, 224, 213, 117, 168, 190, 26, 272, 0, 68, 138, 110, 174]"
136,23,1147,650,9262,0,801,346,"[39, 103, 46, 72, 50, 73, 2, 5, 58, 72, 93, 114, 103, 55, 16, 84, 8, 20, 100, 49, 42, 23, 0, 57, 51, 25, 0]"
137,23,2642,6575,5329,0,1347,1295,"[335, 207, 120, 339, 370, 220, 243, 363, 108, 309, 58, 5, 50, 285, 400, 363, 407, 40, 320, 391, 412, 377, 0, 406, 345, 240, 253]"
138,23,1350,723,5956,0,1260,90,"[23, 2, 14, 23, 27, 14, 12, 0, 2, 14, 21, 29, 23, 30, 15, 12, 17, 23, 21, 10, 15, 15, 0, 25, 20, 8, 5]"
139,23,1464,504,6916,0,1387,77,"[10, 14, 7, 9, 14, 8, 7, 17, 6, 23, 24, 4, 12, 23, 24, 15, 0, 24, 8, 8, 3, 23, 0, 19, 12, 20, 18]"
140,23,2374,673,8617,0,234,2140,"[667, 331, 696, 518, 230, 347, 394, 468, 289, 641, 472, 184, 84, 424, 694, 699, 521, 161, 332, 662, 61, 329, 0, 376, 635, 331, 604]"
141,23,2065,1930,8752,0,554,1511,"[202, 109, 173, 316, 197, 208, 113, 187, 370, 263, 60, 201, 258, 367, 2, 136, 342, 470, 482, 106, 196, 244, 0, 57, 161, 67, 501]"
142,23,2441,6437,4756,0,1951,490,"[45, 103, 102, 26, 110, 29, 98, 35, 21, 147, 155, 152, 151, 41, 28, 106, 77, 55, 80, 63, 37, 85, 0, 78, 139, 116, 126]"
143,23,2720,548,6928,0,2234,486,"[23, 13, 5, 90, 50, 77, 118, 32, 121, 69, 37, 57, 16, 9, 52, 13, 43, 152, 15, 61, 111, 81, 0, 77, 84, 12, 114]"
144,23,1082,871,7139,0,314,768,"[44, 57, 63, 123, 79, 123, 140, 197, 23, 64, 227, 111, 203, 210, 16, 193, 24, 218, 23, 186, 237, 208, 0, 151, 179, 160, 229]"
145,23,1782,1598,7323,0,1416,366,"[113, 118, 36, 17, 59, 29, 89, 93, 73, 80, 122, 112, 37, 4, 111, 3, 22, 96, 20, 49, 91, 62, 0, 103, 16, 64, 94]"
146,23,1202,232,8293,0,663,539,"[105, 167, 5, 150, 54, 150, 160, 85, 127, 160, 73, 29, 169, 118, 54, 39, 138, 1, 98, 84, 130, 54, 0, 175, 78, 123, 162]"
147,23,1026,333,8986,0,851,175,"[2, 22, 1, 37, 56, 18, 27, 30, 2, 58, 55, 37, 40, 17, 58, 23, 32, 45, 55, 38, 37, 35, 0, 27, 18, 14, 29]"
148,23,2105,7422,3669,0,1302,803,"[225, 236, 167, 50, 253, 164, 3, 39, 229, 76, 5, 265, 61, 255, 212, 170, 181, 199, 250, 58, 137, 266, 0, 73, 109, 11, 169]"
149,23,2389,624,5434,0,1106,1283,"[304, 259, 204, 310, 11, 370, 365, 246, 309, 389, 81, 335, 169, 41, 278, 178, 299, 363, 287, 253, 373, 257, 0, 199, 103, 166, 176]"
150,23,2023,1594,5863,0,1689,334,"[65, 101, 106, 17, 15, 76, 104, 88, 84, 95, 96, 104, 5, 97, 90, 85, 94, 61, 77, 41, 49, 26, 0, 93, 82, 68, 99]"
151,23,2798,217,8444,0,632,2166,"[497, 610, 672, 216, 154, 622, 97, 339, 574, 671, 435, 373, 269, 97, 710, 185, 168, 574, 642, 305, 698, 180, 0, 639, 297, 55, 60]"
152,23,1297,1236,8505,0,291,1006,"[177, 214, 92, 313, 209, 151, 239, 189, 287, 277, 134, 188, 327, 47, 29, 192, 288, 50, 161, 172, 172, 286, 0, 244, 25, 3, 239]"
153,23,2757,7293,3969,0,472,2285,"[734, 541, 603, 177, 526, 155, 347, 196, 537, 410, 471, 153, 719, 151, 439, 623, 63, 469, 512, 408, 624, 458, 0, 280, 533, 545, 245]"
154,23,1631,1176,4424,0,699,932,"[184, 300, 42, 2, 18, 243, 168, 194, 183, 111, 22, 178, 62, 157, 107, 131, 253, 201, 226, 32, 108, 263, 0, 75, 236, 75, 118]"
155,23,2519,1496,5447,0,1735,784,"[53, 52, 253, 59, 178, 98, 71, 110, 139, 3, 216, 5, 219, 249, 145, 0, 31, 96, 261, 254, 121, 28, 0, 255, 168, 199, 67]"
156,23,1986,1573,5860,0,1700,286,"[15, 56, 18, 16, 6, 46, 90, 10, 95, 25, 10, 80, 81, 68, 35, 20, 42, 81, 43, 45, 76, 87, 0, 74, 3, 9, 34]"
157,23,1423,290,6993,0,1200,223,"[36, 64, 37, 4, 52, 31, 5, 14, 44, 52, 64, 37, 48, 34, 32, 42, 10, 24, 63, 19, 71, 1, 0, 38, 65, 2, 31]"
158,23,2545,405,9133,0,5,2540,"[301, 229, 508, 67, 773, 237, 32, 285, 603, 662, 832, 107, 18, 228, 104, 327, 265, 746, 714, 364, 379, 470, 0, 511, 267, 328, 791]"
159,23,1953,6519,4567,0,462,1491,"[23, 44, 325, 176, 55, 322, 45, 14, 224, 327, 366, 174, 369, 317, 467, 400, 287, 206, 149, 209, 183, 16, 0, 336, 329, 287, 36]"
160,23,1319,470,5416,0,78,1241,"[171, 343, 278, 352, 169, 245, 170, 27, 406, 112, 200, 34, 238, 145, 310, 384, 47, 82, 272, 301, 175, 243, 0, 181, 169, 188, 406]"
161,23,1795,558,6653,0,1772,23,"[6, 1, 7, 5, 6, 7, 5, 1, 3, 4, 6, 3, 3, 6, 0, 5, 4, 6, 3, 1, 7, 2, 0, 1, 3, 2, 7]"
162,23,1238,781,7110,0,959,279,"[30, 10, 15, 61, 36, 59, 1, 42, 71, 54, 33, 79, 13, 14, 66, 50, 54, 38, 62, 14, 40, 2, 0, 40, 35, 43, 3]"
163,23,2238,851,8497,0,1230,1008,"[37, 49, 36, 205, 249, 232, 293, 195, 87, 128, 21, 274, 106, 319, 148, 237, 138, 70, 132, 162, 49, 116, 0, 27, 299, 314, 86]"
164,23,2592,7295,3794,0,740,1852,"[562, 530, 372, 241, 270, 268, 209, 143, 459, 256, 224, 579, 93, 289, 550, 570, 421, 223, 196, 16, 405, 325, 0, 36, 222, 114, 175]"
165,23,2675,110,6359,0,905,1770,"[176, 185, 400, 458, 542, 17, 255, 282, 382, 259, 274, 320, 497, 246, 97, 476, 356, 306, 417, 92, 158, 230, 0, 312, 381, 32, 266]"
166,23,2111,928,7542,0,2061,50,"[6, 8, 1, 15, 13, 3, 8, 8, 4, 2, 4, 9, 2, 6, 4, 9, 4, 6, 15, 5, 4, 3, 0, 6, 13, 8, 16]"
167,23,2662,1156,9048,0,1140,1522,"[9, 507, 500, 129, 451, 172, 158, 20, 118, 229, 411, 341, 305, 366, 239, 215, 450, 343, 2, 484, 210, 180, 0, 279, 119, 88, 86]"
168,23,2827,6682,5193,0,1380,1447,"[161, 286, 421, 201, 404, 277, 482, 350, 214, 141, 242, 451, 362, 476, 367, 41, 266, 196, 410, 381, 272, 228, 0, 132, 236, 392, 190]"
169,23,1099,133,6159,0,753,346,"[107, 45, 70, 60, 105, 97, 101, 62, 98, 11, 64, 72, 14, 87, 44, 74, 3, 73, 115, 59, 3, 114, 0, 97, 68, 16, 5]"
170,23,2369,1830,6698,0,960,1409,"[249, 358, 271, 43, 89, 86, 255, 267, 234, 178, 201, 189, 161, 331, 311, 89, 168, 104, 229, 19, 40, 323, 0, 275, 386, 131, 86]"
171,23,2190,1519,7369,0,326,1864,"[238, 539, 204, 97, 236, 399, 11, 119, 191, 340, 307, 594, 122, 300, 193, 382, 216, 117, 445, 8, 380, 471, 0, 281, 9, 264, 151]"
172,23,1312,151,8530,0,223,1089,"[317, 260, 133, 362, 351, 46, 209, 141, 298, 337, 260, 156, 329, 317, 83, 190, 213, 261, 69, 107, 331, 331, 0, 210, 118, 195, 203]"
173,23,1076,882,8724,0,1026,50,"[6, 4, 12, 15, 14, 0, 13, 13, 13, 10, 0, 16, 5, 4, 4, 16, 2, 16, 5, 11, 1, 14, 0, 6, 14, 0, 13]"
174,23,1851,542,10000,33,451,1400,"[103, 161, 142, 397, 195, 415, 262, 458, 344, 260, 462, 459, 150, 2, 207, 438, 418, 67, 319, 385, 332, 184, 0, 81, 225, 91, 235]"
175,23,2070,6846,5224,0,1499,571,"[14, 113, 60, 146, 40, 125, 58, 78, 16, 107, 48, 86, 2, 173, 54, 173, 31, 130, 150, 156, 55, 71, 0, 5, 181, 158, 145]"
176,23,1959,181,7002,0,294,1665,"[513, 195, 468, 443, 543, 109, 553, 331, 476, 536, 479, 422, 0, 133, 72, 423, 127, 297, 469, 366, 259, 19, 0, 269, 205, 112, 415]"
177,23,1968,1617,7353,0,793,1175,"[339, 159, 214, 137, 379, 229, 48, 79, 37, 0, 48, 33, 253, 76, 386, 378, 62, 137, 113, 287, 230, 381, 0, 42, 81, 304, 13]"
178,23,1036,660,7729,0,652,384,"[88, 27, 87, 5, 92, 73, 53, 73, 14, 58, 79, 120, 61, 39, 112, 33, 75, 16, 126, 70, 17, 91, 0, 74, 87, 11, 44]"
179,23,2660,332,10000,57,445,2215,"[35, 689, 446, 408, 230, 621, 166, 690, 233, 602, 265, 329, 529, 149, 31, 220, 715, 239, 260, 575, 226, 630, 0, 383, 591, 632, 578]"
180,23,2375,5960,6415,0,2335,40,"[11, 0, 8, 4, 1, 1, 1, 10, 4, 4, 5, 9, 6, 12, 12, 13, 3, 4, 0, 2, 13, 7, 0, 5, 3, 8, 2]"
181,23,2336,787,7964,0,1555,781,"[222, 165, 13, 45, 141, 70, 5, 20, 190, 238, 38, 176, 6, 135, 70, 164, 9, 76, 254, 160, 121, 1, 0, 87, 145, 22, 157]"
182,23,2235,638,9561,0,1771,464,"[43, 110, 124, 124, 141, 67, 143, 40, 120, 43, 132, 109, 14, 82, 36, 66, 8, 49, 20, 85, 137, 94, 0, 89, 81, 48, 40]"
183,23,2723,6402,5882,0,527,2196,"[426, 2, 499, 318, 163, 464, 577, 657, 68, 23, 605, 426, 237, 188, 674, 274, 534, 407, 732, 557, 230, 638, 0, 140, 195, 378, 281]"
184,23,1230,1213,5899,0,29,1201,"[93, 357, 197, 28, 218, 334, 217, 244, 222, 229, 218, 242, 116, 235, 226, 102, 81, 371, 193, 235, 200, 344, 0, 67, 82, 124, 364]"
185,23,1337,483,6753,0,1045,292,"[44, 31, 93, 23, 60, 29, 78, 6, 32, 71, 78, 1, 41, 17, 24, 12, 23, 46, 22, 44, 40, 4, 0, 75, 33, 15, 24]"
186,23,1855,444,8164,0,437,1418,"[198, 227, 226, 74, 295, 416, 265, 330, 182, 130, 29, 305, 95, 419, 146, 91, 72, 250, 299, 121, 206, 232, 0, 341, 184, 314, 304]"
187,23,2723,252,10000,635,1929,794,"[250, 245, 143, 157, 28, 106, 187, 137, 22, 122, 180, 170, 232, 177, 203, 0, 255, 133, 11, 79, 240, 239, 0, 22, 43, 41, 194]"
188,23,1899,7401,4498,0,1734,165,"[55, 10, 10, 31, 18, 9, 51, 8, 45, 55, 53, 0, 1, 4, 16, 44, 37, 42, 13, 7, 19, 55, 0, 12, 19, 49, 10]"
189,23,2554,1939,5113,0,2052,502,"[107, 82, 30, 92, 132, 136, 67, 117, 128, 108, 80, 25, 133, 7, 128, 134, 138, 122, 111, 28, 78, 107, 0, 72, 165, 54, 132]"
190,23,2198,783,6528,0,1141,1057,"[26, 214, 330, 251, 81, 187, 83, 240, 100, 83, 279, 16, 232, 156, 268, 261, 107, 117, 124, 320, 257, 246, 0, 312, 222, 211, 275]"
191,23,2252,635,8145,0,189,2063,"[501, 511, 565, 385, 229, 184, 322, 488, 562, 327, 156, 49, 40, 413, 448, 617, 487, 6, 103, 203, 218, 429, 0, 265, 463, 586, 61]"
192,23,1796,1380,8561,0,723,1073,"[49, 65, 14, 313, 301, 90, 105, 161, 152, 306, 332, 121, 277, 114, 235, 4, 212, 54, 8, 211, 349, 326, 0, 62, 283, 288, 154]"
193,23,1555,1183,8933,0,1240,315,"[46, 95, 78, 3, 90, 42, 47, 88, 21, 51, 46, 79, 86, 104, 96, 74, 96, 57, 35, 99, 6, 16, 0, 105, 96, 90, 81]"
194,23,2680,6153,5460,0,1810,870,"[79, 222, 257, 17, 281, 145, 212, 130, 192, 252, 23, 77, 261, 120, 272, 73, 122, 44, 114, 141, 151, 284, 0, 271, 87, 120, 245]"
195,23,1443,122,6781,0,1046,397,"[50, 79, 87, 90, 75, 74, 72, 17, 23, 57, 32, 97, 88, 55, 78, 73, 52, 22, 90, 65, 3, 120, 0, 92, 76, 39, 121]"
196,23,1839,1135,7485,0,316,1523,"[214, 360, 279, 0, 505, 187, 506, 475, 196, 487, 276, 213, 42, 423, 91, 489, 404, 228, 199, 304, 348, 441, 0, 294, 317, 211, 10]"
197,23,2916,805,9596,0,2200,716,"[197, 214, 9, 109, 158, 74, 27, 221, 151, 80, 96, 20, 54, 127, 47, 202, 102, 66, 223, 9, 144, 127, 0, 131, 103, 177, 14]"
198,23,1228,1164,9660,0,1104,124,"[28, 12, 1, 20, 0, 41, 33, 2, 29, 0, 28, 4, 11, 16, 14, 26, 30, 8, 5, 37, 31, 14, 0, 33, 11, 13, 29]"
199,23,2259,5493,6426,0,1495,764,"[86, 248, 221, 218, 92, 116, 206, 165, 122, 103, 254, 46, 19, 74, 14, 0, 47, 251, 247, 221, 57, 59, 0, 69, 216, 111, 28]"
200,23,1421,542,7305,0,753,668,"[8, 151, 73, 30, 114, 190, 126, 31, 209, 69, 222, 191, 8, 179, 157, 167, 50, 94, 202, 215, 160, 103, 0, 144, 11, 28, 199]"
201,23,1684,108,8881,0,785,899,"[288, 286, 188, 12, 27, 150, 76, 275, 45, 219, 178, 34, 216, 125, 220, 144, 183, 128, 61, 61, 252, 14, 0, 3, 88, 37, 225]"
202,23,1510,741,9650,0,272,1238,"[197, 309, 249, 183, 385, 282, 180, 258, 270, 223, 260, 286, 2, 389, 51, 266, 82, 156, 249, 98, 268, 411, 0, 308, 364, 196, 37]"
203,23,1356,6239,4767,0,1279,77,"[5, 16, 10, 10, 13, 6, 5, 19, 16, 16, 4, 16, 15, 14, 22, 5, 24, 7, 6, 11, 6, 10, 0, 17, 23, 3, 25]"
204,23,1451,432,5786,0,526,925,"[291, 272, 295, 47, 47, 134, 233, 43, 232, 145, 302, 184, 286, 154, 39, 20, 205, 293, 273, 202, 132, 188, 0, 123, 19, 70, 30]"
205,23,2725,1692,6819,0,1072,1653,"[366, 64, 300, 126, 459, 340, 172, 141, 3, 408, 334, 135, 448, 118, 105, 422, 524, 311, 267, 508, 41, 201, 0, 217, 169, 282, 37]"
206,23,2297,2033,7083,0,786,1511,"[209, 494, 403, 445, 367, 143, 121, 226, 442, 174, 96, 356, 294, 460, 475, 367, 146, 401, 497, 252, 436, 393, 0, 311, 345, 432, 385]"
207,23,1544,1534,7093,0,536,1008,"[126, 57, 225, 19, 314, 317, 244, 170, 231, 169, 111, 98, 157, 251, 53, 16, 250, 77, 51, 301, 240, 46, 0, 273, 170, 162, 42]"
208,23,2203,1269,8027,0,71,2132,"[123, 511, 6, 28, 22, 470, 645, 125, 366, 30, 236, 164, 244, 204, 389, 518, 200, 395, 24, 117, 85, 424, 0, 612, 629, 164, 600]"
209,23,1389,688,8728,0,850,539,"[164, 77, 88, 113, 123, 4, 113, 11, 112, 103, 118, 65, 92, 40, 144, 117, 81, 3, 50, 174, 155, 35, 0, 0, 51, 47, 41]"
210,23,1728,107,10000,349,1366,362,"[3, 93, 55, 22, 67, 42, 5, 54, 116, 15, 27, 104, 115, 13, 80, 4, 40, 13, 53, 15, 92, 31, 0, 37, 24, 105, 85]"
211,23,2496,7189,5307,0,2056,440,"[17, 122, 87, 24, 11, 98, 89, 74, 6, 73, 135, 9, 47, 45, 3, 128, 143, 143, 92, 111, 85, 26, 0, 128, 124, 16, 84]"
212,23,2642,127,7822,0,1104,1538,"[64, 477, 481, 469, 37, 191, 468, 390, 375, 505, 145, 300, 388, 427, 34, 6, 81, 199, 156, 192, 200, 164, 0, 278, 218, 167, 508]"
213,23,1644,274,9192,0,1491,153,"[12, 21, 4, 31, 48, 23, 27, 29, 17, 14, 21, 12, 39, 17, 40, 2, 31, 16, 2, 17, 22, 47, 0, 26, 31, 51, 29]"
214,23,2973,6678,5487,0,2324,649,"[128, 187, 155, 105, 204, 118, 138, 7, 131, 34, 58, 176, 24, 181, 171, 64, 132, 51, 126, 210, 118, 71, 0, 90, 46, 206, 188]"
215,23,2220,1931,5776,0,1032,1188,"[7, 96, 199, 90, 390, 55, 126, 345, 29, 200, 124, 140, 244, 324, 198, 97, 280, 285, 192, 200, 296, 105, 0, 287, 338, 4, 317]"
216,23,1271,96,6951,0,375,896,"[222, 85, 150, 151, 87, 87, 235, 156, 176, 2, 26, 192, 287, 192, 1, 66, 97, 80, 15, 148, 184, 116, 0, 100, 130, 122, 250]"
217,23,2437,51,9337,0,2241,196,"[62, 12, 33, 34, 36, 60, 47, 51, 42, 25, 39, 59, 12, 45, 31, 16, 1, 38, 4, 60, 5, 2, 0, 14, 5, 56, 5]"
218,23,1553,300,10000,590,1279,274,"[63, 67, 37, 50, 22, 75, 58, 87, 9, 56, 10, 52, 10, 12, 2, 4, 65, 26, 36, 70, 69, 40, 0, 75, 32, 86, 72]"
219,23,2605,6284,6321,0,810,1795,"[239, 132, 454, 278, 94, 401, 250, 314, 245, 44, 517, 385, 313, 219, 216, 33, 279, 468, 403, 517, 288, 444, 0, 219, 344, 163, 472]"
220,23,1116,417,7020,0,197,919,"[274, 42, 71, 255, 217, 202, 189, 300, 83, 26, 202, 238, 173, 286, 160, 74, 119, 155, 161, 3, 297, 141, 0, 75, 81, 166, 219]"
221,23,1551,1393,7178,0,224,1327,"[321, 108, 433, 374, 193, 157, 358, 339, 408, 280, 269, 98, 66, 332, 282, 269, 367, 230, 290, 122, 159, 411, 0, 257, 57, 41, 112]"
222,23,2189,507,8860,0,1401,788,"[111, 247, 212, 74, 255, 33, 48, 126, 252, 187, 143, 61, 69, 103, 150, 41, 174, 84, 180, 25, 110, 254, 0, 45, 232, 30, 20]"
223,23,2352,6770,4442,0,1512,840,"[203, 151, 83, 120, 120, 70, 276, 142, 126, 232, 128, 78, 145, 151, 73, 275, 33, 7, 10, 158, 99, 144, 0, 4, 49, 263, 19]"
224,23,1430,616,5256,0,31,1399,"[41, 143, 98, 167, 212, 449, 0, 253, 66, 57, 338, 265, 399, 247, 232, 208, 188, 182, 440, 440, 249, 112, 0, 167, 288, 222, 400]"
225,23,1169,21,6404,0,562,607,"[177, 139, 7, 32, 121, 99, 123, 82, 45, 71, 121, 122, 117, 56, 84, 69, 22, 92, 97, 104, 185, 138, 0, 9, 147, 172, 194]"
226,23,2592,386,8610,0,2485,107,"[0, 23, 32, 4, 8, 28, 24, 23, 3, 27, 35, 8, 18, 33, 33, 16, 25, 21, 29, 14, 0, 12, 0, 24, 1, 1, 31]"
227,23,2967,6374,5203,0,1094,1873,"[304, 58, 599, 475, 287, 194, 299, 573, 314, 307, 72, 474, 529, 51, 208, 376, 481, 476, 328, 161, 3, 412, 0, 454, 43, 36, 284]"
228,23,2588,1042,6749,0,69,2519,"[128, 186, 492, 147, 316, 532, 263, 526, 575, 657, 444, 540, 481, 601, 574, 578, 823, 448, 649, 398, 130, 337, 0, 13, 311, 775, 583]"
229,23,2409,900,8258,0,2033,376,"[36, 10, 45, 62, 49, 116, 54, 97, 100, 112, 44, 72, 73, 39, 113, 66, 47, 4, 55, 39, 85, 35, 0, 7, 62, 62, 125]"
230,23,1577,1135,8700,0,645,932,"[170, 126, 250, 29, 173, 149, 180, 48, 211, 165, 41, 190, 12, 226, 266, 285, 70, 162, 241, 250, 204, 117, 0, 145, 227, 161, 115]"
231,23,2759,6239,5220,0,939,1820,"[577, 42, 128, 522, 92, 455, 121, 606, 566, 329, 196, 174, 273, 435, 427, 523, 265, 386, 106, 262, 294, 602, 0, 571, 239, 452, 476]"
232,23,1582,1394,5408,0,1529,53,"[13, 9, 13, 1, 6, 2, 2, 5, 6, 2, 16, 4, 16, 6, 14, 9, 14, 13, 17, 11, 14, 2, 0, 13, 0, 7, 4]"
233,23,2750,570,7588,0,113,2637,"[680, 592, 262, 619, 108, 31, 374, 785, 157, 203, 643, 445, 51, 517, 301, 786, 827, 852, 587, 606, 820, 423, 0, 138, 722, 505, 253]"
234,23,1622,419,8791,0,1141,481,"[159, 66, 136, 157, 57, 11, 34, 73, 131, 20, 119, 132, 24, 20, 126, 67, 13, 158, 98, 22, 16, 31, 0, 154, 159, 34, 55]"
235,23,2705,7117,4379,0,889,1816,"[319, 20, 76, 587, 531, 462, 307, 578, 352, 565, 125, 188, 596, 479, 61, 597, 253, 587, 146, 162, 349, 239, 0, 393, 149, 104, 557]"
236,23,2530,131,6778,0,2459,71,"[17, 4, 4, 4, 9, 19, 3, 6, 20, 16, 18, 3, 2, 4, 11, 8, 3, 4, 13, 23, 4, 19, 0, 10, 2, 5, 20]"
237,23,2738,768,8748,0,1915,823,"[130, 145, 139, 215, 192, 129, 67, 165, 114, 193, 65, 268, 227, 65, 34, 63, 137, 35, 18, 135, 96, 32, 0, 84, 253, 181, 186]"
238,23,2449,5966,5231,0,2019,430,"[139, 41, 101, 33, 18, 3, 124, 80, 13, 121, 100, 31, 54, 120, 33, 78, 39, 91, 117, 135, 35, 123, 0, 104, 70, 34, 117]"
239,23,2589,1702,6118,0,584,2005,"[415, 3, 209, 597, 373, 408, 554, 571, 399, 351, 241, 271, 96, 227, 514, 24, 586, 668, 462, 595, 446, 552, 0, 516, 30, 37, 468]"
240,23,1670,910,6878,0,1208,462,"[22, 46, 121, 33, 21, 98, 13, 55, 40, 22, 72, 29, 10, 93, 9, 60, 134, 69, 71, 3, 133, 52, 0, 30, 75, 89, 153]"
241,23,1413,1263,7028,0,90,1323,"[0, 198, 100, 225, 36, 265, 99, 358, 308, 395, 88, 118, 368, 28, 361, 155, 162, 329, 56, 244, 75, 364, 0, 47, 339, 435, 352]"
242,23,1647,465,8210,0,483,1164,"[197, 376, 25, 231, 311, 369, 273, 161, 63, 255, 113, 203, 16, 226, 260, 85, 111, 7, 260, 75, 332, 17, 0, 275, 300, 149, 189]"
243,23,1338,312,9236,0,437,901,"[214, 161, 138, 267, 62, 94, 107, 84, 147, 119, 165, 241, 178, 47, 267, 85, 213, 245, 234, 133, 138, 192, 0, 231, 212, 76, 199]"
244,23,1606,1601,9241,0,1023,583,"[188, 138, 95, 139, 33, 94, 125, 151, 50, 115, 86, 13, 69, 28, 174, 66, 145, 177, 1, 23, 95, 165, 0, 175, 92, 178, 148]"
245,23,2193,5465,5969,0,1709,484,"[61, 157, 133, 5, 82, 147, 85, 102, 82, 36, 25, 21, 96, 19, 79, 73, 76, 86, 18, 59, 77, 119, 0, 72, 1, 62, 101]"
246,23,1893,715,7147,0,15,1878,"[310, 57, 311, 29, 357, 229, 308, 176, 357, 403, 302, 191, 33, 162, 98, 104, 615, 152, 415, 275, 150, 155, 0, 557, 284, 273, 545]"
247,23,2752,677,9222,0,2440,312,"[19, 60, 30, 14, 43, 70, 53, 23, 94, 82, 75, 25, 90, 95, 95, 59, 20, 70, 55, 31, 22, 22, 0, 56, 65, 31, 99]"
248,23,2576,5672,6126,0,725,1851,"[87, 308, 598, 162, 376, 512, 400, 91, 367, 615, 67, 487, 476, 237, 511, 156, 157, 110, 479, 185, 50, 217, 0, 27, 503, 59, 30]"
249,23,1388,539,6975,0,847,541,"[148, 56, 34, 21, 81, 103, 23, 71, 118, 37, 173, 107, 154, 174, 79, 31, 71, 179, 85, 71, 173, 140, 0, 156, 19, 128, 93]"
250,23,1214,322,7867,0,912,302,"[72, 76, 100, 48, 8, 62, 67, 53, 64, 54, 93, 33, 77, 54, 61, 95, 92, 44, 79, 74, 94, 0, 0, 49, 60, 89, 17]"
251,23,1755,1450,8172,0,1324,431,"[71, 24, 101, 94, 79, 103, 6, 39, 10, 122, 91, 9, 71, 84, 17, 47, 52, 4, 62, 16, 136, 129, 0, 124, 42, 112, 59]"
252,23,1755,962,8965,0,482,1273,"[355, 286, 212, 408, 333, 250, 240, 334, 131, 340, 272, 211, 222, 385, 212, 258, 89, 236, 240, 272, 343, 393, 0, 158, 150, 8, 136]"
253,23,1214,899,9280,0,187,1027,"[234, 95, 287, 234, 215, 132, 113, 320, 143, 43, 199, 202, 28, 84, 132, 165, 174, 213, 245, 39, 273, 279, 0, 153, 39, 326, 59]"
254,23,1159,810,9629,0,321,838,"[46, 225, 1, 272, 133, 127, 167, 142, 150, 5, 54, 163, 259, 213, 111, 259, 262, 86, 224, 9, 101, 259, 0, 206, 220, 10, 23]"
255,23,1759,7415,3973,0,1445,314,"[47, 45, 90, 18, 43, 37, 74, 82, 87, 28, 74, 35, 96, 18, 17, 21, 20, 88, 56, 46, 92, 20, 0, 28, 25, 8, 33]"
256,23,2937,472,6438,0,2653,284,"[35, 51, 63, 52, 34, 84, 87, 20, 47, 7, 19, 38, 57, 42, 8, 79, 76, 8, 22, 87, 66, 61, 0, 83, 34, 17, 90]"
257,23,1683,1161,6960,0,525,1158,"[347, 10, 348, 101, 116, 252, 244, 228, 257, 358, 371, 321, 191, 10, 148, 49, 298, 126, 249, 193, 300, 57, 0, 177, 140, 120, 39]"
258,23,2631,460,9131,0,739,1892,"[137, 584, 395, 442, 10, 606, 265, 8, 444, 336, 202, 38, 370, 126, 379, 318, 35, 274, 293, 97, 474, 46, 0, 125, 88, 326, 563]"
259,23,2574,6562,5143,0,2545,29,"[3, 8, 0, 5, 5, 1, 4, 0, 8, 0, 1, 0, 2, 4, 5, 3, 8, 6, 5, 1, 5, 1, 0, 8, 4, 0, 5]"
260,23,1809,115,6837,0,1223,586,"[169, 145, 34, 133, 140, 8, 74, 34, 194, 49, 130, 51, 162, 21, 151, 151, 149, 68, 102, 90, 81, 105, 0, 13, 131, 84, 191]"
261,23,1782,928,7691,0,709,1073,"[286, 346, 175, 68, 140, 92, 162, 76, 276, 5, 77, 45, 203, 80, 151, 37, 255, 227, 338, 70, 78, 60, 0, 106, 141, 168, 340]"
262,23,2296,1891,8096,0,1735,561,"[161, 123, 65, 104, 80, 87, 109, 2, 124, 28, 104, 159, 12, 172, 65, 176, 142, 180, 105, 149, 124, 153, 0, 13, 103, 60, 40]"
263,23,2771,1286,9581,0,2444,327,"[93, 74, 96, 46, 92, 2, 52, 58, 82, 41, 36, 88, 61, 37, 35, 34, 37, 76, 7, 76, 63, 87, 0, 7, 33, 61, 70]"
264,23,2055,5476,6160,0,1949,106,"[30, 5, 19, 11, 8, 27, 18, 9, 1, 21, 20, 23, 15, 2, 0, 32, 17, 33, 30, 8, 34, 4, 0, 4, 11, 9, 0]"
265,23,2276,1310,7126,0,1803,473,"[143, 123, 1, 121, 11, 78, 91, 4, 65, 130, 86, 67, 74, 146, 44, 77, 92, 74, 19, 19, 72, 141, 0, 139, 80, 27, 13]"
266,23,1727,204,8649,0,1280,447,"[142, 137, 6, 29, 40, 5, 62, 109, 19, 30, 46, 111, 106, 4, 104, 139, 87, 16, 144, 137, 26, 149, 0, 11, 36, 46, 35]"
267,23,2156,666,10000,139,576,1580,"[190, 347, 153, 153, 439, 512, 411, 314, 521, 420, 437, 283, 23, 44, 413, 116, 344, 499, 133, 387, 301, 429, 0, 386, 411, 85, 240]"
268,23,1073,5443,5630,0,823,250,"[10, 54, 8, 7, 77, 28, 53, 66, 45, 35, 60, 45, 45, 80, 81, 25, 59, 21, 21, 8, 64, 12, 0, 55, 74, 74, 33]"
269,23,2835,567,7898,0,1756,1079,"[326, 16, 37, 290, 229, 152, 126, 247, 147, 211, 320, 14, 245, 100, 114, 260, 14, 351, 304, 216, 359, 136, 0, 74, 40, 321, 291]"
270,23,2480,949,9429,0,1517,963,"[100, 164, 55, 165, 125, 98, 310, 53, 158, 176, 257, 59, 109, 2, 184, 253, 288, 140, 84, 261, 65, 317, 0, 159, 71, 265, 142]"
271,23,2083,7023,4489,0,615,1468,"[319, 289, 119, 468, 383, 192, 188, 73, 107, 466, 470, 451, 482, 405, 459, 300, 442, 225, 288, 139, 313, 285, 0, 20, 1, 211, 67]"
272,23,1901,129,6261,0,983,918,"[260, 177, 145, 79, 251, 151, 282, 275, 267, 153, 227, 272, 246, 246, 97, 269, 56, 173, 231, 148, 66, 306, 0, 141, 224, 196, 294]"
273,23,2034,986,7309,0,640,1394,"[347, 178, 308, 362, 109, 464, 322, 401, 68, 143, 245, 454, 422, 356, 423, 62, 421, 193, 429, 320, 228, 214, 0, 45, 307, 47, 329]"
274,23,2462,127,9644,0,1352,1110,"[94, 209, 322, 273, 16, 273, 52, 262, 258, 140, 74, 123, 359, 117, 201, 93, 263, 93, 13, 262, 118, 279, 0, 23, 80, 85, 113]"
275,23,2130,6659,5115,0,226,1904,"[515, 438, 10, 237, 249, 143, 56, 37, 523, 201, 623, 582, 520, 290, 583, 563, 622, 324, 180, 597, 311, 19, 0, 118, 521, 588, 112]"
276,23,1954,492,6577,0,1431,523,"[56, 158, 120, 168, 165, 118, 151, 5, 39, 96, 37, 24, 156, 46, 17, 172, 23, 51, 48, 16, 117, 16, 0, 11, 11, 17, 35]"
277,23,2799,1509,7867,0,1791,1008,"[78, 238, 277, 139, 145, 314, 187, 68, 123, 216, 170, 253, 14, 62, 142, 43, 54, 196, 161, 225, 274, 312, 0, 244, 64, 246, 188]"
278,23,1030,96,8801,0,614,416,"[58, 125, 80, 21, 24, 89, 2, 107, 137, 9, 19, 30, 115, 51, 112, 131, 127, 32, 133, 84, 96, 79, 0, 87, 135, 29, 78]"
279,23,1202,800,9203,0,108,1094,"[134, 132, 342, 109, 258, 16, 32, 10, 119, 92, 158, 158, 25, 172, 232, 14, 43, 185, 320, 108, 359, 13, 0, 229, 80, 126, 285]"
280,23,1881,6940,4144,0,115,1766,"[581, 281, 473, 147, 432, 62, 98, 48, 462, 238, 73, 275, 376, 497, 136, 323, 65, 501, 517, 161, 401, 229, 0, 166, 500, 338, 332]"
281,23,1810,35,5919,0,466,1344,"[203, 367, 363, 245, 227, 159, 314, 36, 282, 251, 56, 215, 340, 272, 36, 287, 153, 445, 26, 149, 105, 2, 0, 281, 53, 124, 52]"
282,23,2422,1203,7138,0,1166,1256,"[134, 198, 60, 345, 374, 409, 281, 375, 175, 214, 36, 61, 382, 264, 189, 250, 147, 355, 360, 260, 86, 313, 0, 315, 88, 51, 326]"
283,23,1971,1804,7305,0,1120,851,"[226, 220, 216, 234, 201, 175, 33, 26, 239, 1, 126, 208, 279, 36, 86, 228, 2, 237, 9, 184, 170, 203, 0, 155, 183, 234, 180]"
284,23,1675,1081,7899,0,1578,97,"[16, 5, 31, 22, 32, 11, 26, 20, 9, 23, 7, 7, 32, 32, 3, 18, 32, 32, 10, 10, 17, 17, 0, 15, 9, 10, 21]"
285,23,1455,723,8631,0,1095,360,"[20, 107, 78, 45, 6, 56, 91, 44, 0, 57, 92, 29, 42, 84, 99, 60, 33, 98, 80, 89, 55, 69, 0, 85, 74, 120, 45]"
286,23,2526,6883,4274,0,609,1917,"[352, 62, 505, 94, 249, 275, 357, 595, 176, 368, 224, 80, 237, 634, 354, 146, 100, 356, 128, 317, 208, 300, 0, 575, 284, 267, 322]"
287,23,1426,1138,4562,0,1290,136,"[40, 39, 13, 36, 4, 4, 35, 26, 8, 21, 29, 42, 27, 28, 45, 0, 7, 3, 11, 17, 28, 15, 0, 17, 9, 15, 24]"
288,23,1927,1597,4892,0,1093,834,"[226, 129, 109, 258, 165, 113, 220, 111, 32, 165, 175, 102, 73, 102, 203, 150, 250, 11, 74, 191, 156, 270, 0, 44, 33, 254, 208]"
289,23,1693,230,6355,0,422,1271,"[212, 84, 189, 25, 385, 328, 231, 341, 65, 110, 99, 236, 50, 241, 201, 364, 19, 193, 155, 94, 372, 387, 0, 90, 244, 260, 329]"
290,23,2061,1871,6545,0,1967,94,"[24, 14, 29, 8, 15, 8, 13, 31, 17, 25, 29, 14, 13, 12, 9, 31, 22, 19, 10, 8, 14, 7, 0, 2, 5, 7, 4]"
291,23,1821,1724,6642,0,536,1285,"[322, 363, 380, 395, 389, 203, 342, 71, 24, 201, 423, 413, 160, 170, 275, 243, 40, 225, 33, 304, 222, 424, 0, 110, 417, 370, 411]"
292,23,1971,993,7620,0,943,1028,"[67, 148, 194, 146, 142, 73, 252, 232, 50, 203, 271, 256, 174, 172, 163, 235, 16, 207, 181, 315, 73, 25, 0, 321, 197, 67, 64]"
293,23,2498,1460,8658,0,1261,1237,"[279, 192, 411, 328, 400, 28, 136, 109, 46, 207, 79, 22, 97, 281, 263, 203, 375, 246, 36, 143, 188, 136, 0, 276, 192, 156, 77]"
294,23,1996,1217,9437,0,650,1346,"[286, 1, 80, 201, 347, 301, 234, 98, 262, 388, 379, 4, 144, 426, 384, 435, 386, 432, 329, 257, 294, 120, 0, 23, 221, 152, 234]"
295,23,1793,7400,3830,0,789,1004,"[54, 29, 37, 208, 232, 9, 109, 285, 171, 35, 165, 22, 39, 211, 93, 64, 127, 294, 99, 195, 163, 169, 0, 134, 257, 311, 112]"
296,23,2789,218,6401,0,2363,426,"[8, 57, 37, 39, 86, 74, 92, 107, 18, 100, 125, 3, 92, 37, 142, 8, 125, 62, 57, 46, 27, 65, 0, 19, 64, 106, 69]"
297,23,1857,915,7343,0,159,1698,"[550, 63, 536, 272, 179, 561, 198, 337, 75, 49, 204, 397, 340, 61, 128, 467, 496, 49, 344, 459, 388, 237, 0, 471, 513, 26, 200]"
298,23,2621,819,9145,0,1680,941,"[254, 296, 246, 307, 302, 238, 132, 90, 37, 39, 79, 86, 111, 287, 297, 142, 19, 52, 303, 26, 24, 63, 0, 291, 54, 169, 4]"
299,23,1518,604,10000,59,405,1113,"[284, 251, 12, 371, 262, 24, 212, 5, 296, 225, 283, 289, 188, 146, 143, 178, 48, 10, 93, 69, 293, 109, 0, 363, 302, 318, 222]"
0,24,4947,0,4947,0,2365,2582,"[89, 364, 401, 30, 785, 108, 859, 476, 586, 32, 218, 217, 382, 732, 128, 501, 304, 60, 244, 659, 93, 313, 88, 0, 663, 687, 277]"
1,24,3095,1786,6256,0,242,2853,"[878, 76, 215, 462, 634, 74, 671, 736, 895, 360, 139, 671, 417, 310, 177, 174, 696, 432, 517, 838, 323, 647, 490, 0, 453, 508, 690]"
2,24,4154,3971,6439,0,1446,2708,"[806, 283, 580, 524, 502, 226, 325, 509, 222, 571, 884, 447, 141, 893, 537, 825, 654, 735, 619, 661, 781, 873, 770, 0, 398, 296, 109]"
3,24,4688,5246,5881,0,3862,826,"[23, 207, 39, 238, 103, 163, 56, 109, 55, 242, 88, 149, 168, 104, 254, 7, 176, 85, 140, 241, 223, 57, 93, 0, 97, 209, 246]"
4,24,4044,3798,6127,0,930,3114,"[153, 359, 655, 433, 355, 737, 710, 795, 113, 769, 732, 597, 834, 302, 94, 896, 462, 150, 324, 627, 258, 341, 393, 0, 967, 790, 805]"
5,24,4606,877,9856,0,3346,1260,"[65, 137, 53, 169, 71, 31, 257, 265, 69, 203, 62, 21, 100, 278, 292, 410, 143, 207, 13, 211, 291, 73, 383, 0, 23, 402, 30]"
6,24,4109,7285,6680,0,538,3571,"[79, 678, 573, 414, 514, 733, 1005, 283, 1020, 997, 1061, 111, 323, 26, 1103, 889, 883, 989, 1056, 1072, 1074, 656, 37, 0, 721, 157, 113]"
7,24,4590,5657,5613,0,1808,2782,"[522, 487, 310, 175, 793, 419, 390, 48, 131, 857, 716, 803, 551, 175, 893, 811, 35, 653, 81, 267, 96, 708, 875, 0, 435, 83, 823]"
8,24,4014,3690,5937,0,1684,2330,"[133, 193, 492, 80, 267, 716, 459, 463, 157, 82, 92, 82, 295, 172, 564, 169, 748, 558, 257, 544, 432, 496, 374, 0, 461, 134, 296]"
9,24,3024,1518,7443,0,2099,925,"[184, 27, 67, 76, 297, 134, 43, 228, 238, 254, 14, 49, 40, 38, 102, 18, 221, 81, 162, 237, 245, 204, 149, 0, 296, 83, 104]"
10,24,3010,2544,7909,0,2370,640,"[118, 193, 155, 22, 106, 155, 206, 208, 58, 70, 107, 3, 142, 178, 206, 36, 127, 8, 111, 26, 212, 48, 154, 0, 84, 51, 200]"
11,24,3814,5272,6451,0,3078,736,"[221, 126, 179, 61, 97, 17, 215, 130, 124, 132, 33, 229, 156, 28, 240, 53, 20, 58, 190, 90, 211, 159, 195, 0, 102, 71, 100]"
12,24,3192,2087,7556,0,373,2819,"[273, 396, 416, 876, 587, 676, 770, 828, 921, 637, 240, 379, 832, 751, 56, 638, 380, 250, 103, 637, 264, 857, 591, 0, 473, 787, 244]"
13,24,3951,5779,5728,0,23,3928,"[410, 798, 278, 286, 397, 1157, 739, 675, 969, 596, 741, 335, 1221, 642, 1095, 280, 1027, 813, 977, 58, 945, 1226, 565, 0, 807, 43, 926]"
14,24,4103,1310,8521,0,3539,564,"[91, 115, 86, 77, 50, 1, 92, 79, 145, 0, 146, 21, 10, 31, 96, 65, 67, 14, 73, 127, 98, 128, 166, 0, 12, 93, 27]"
15,24,3738,6375,5884,0,178,3560,"[1172, 213, 1070, 545, 1021, 880, 195, 830, 9, 675, 783, 584, 303, 727, 160, 1048, 424, 222, 87, 941, 970, 32, 448, 0, 78, 469, 1123]"
16,24,4452,1114,9222,0,233,4219,"[862, 283, 30, 524, 1066, 855, 552, 185, 975, 549, 417, 34, 1342, 200, 703, 456, 610, 752, 91, 1228, 59, 1026, 246, 0, 1301, 857, 972]"
17,24,4319,6449,7092,0,2632,1687,"[311, 287, 426, 464, 531, 229, 49, 25, 559, 519, 538, 60, 212, 18, 345, 544, 401, 483, 127, 315, 140, 393, 453, 0, 119, 486, 367]"
18,24,3067,1506,8653,0,897,2170,"[572, 150, 334, 98, 106, 107, 91, 469, 11, 311, 244, 396, 473, 268, 658, 175, 590, 215, 470, 539, 384, 681, 168, 0, 518, 416, 480]"
19,24,3498,7319,4832,0,3287,211,"[13, 19, 45, 37, 68, 2, 35, 62, 64, 5, 57, 25, 55, 25, 29, 37, 7, 49, 50, 3, 41, 51, 69, 0, 59, 17, 66]"
20,24,3062,1520,6374,0,494,2568,"[466, 330, 300, 840, 612, 115, 506, 182, 477, 103, 756, 708, 90, 312, 571, 398, 560, 513, 485, 274, 382, 155, 226, 0, 338, 675, 268]"
21,24,3332,694,9012,0,2726,606,"[187, 149, 43, 55, 150, 102, 2, 201, 126, 78, 56, 42, 94, 169, 135, 106, 198, 78, 131, 0, 91, 5, 56, 0, 195, 143, 46]"
22,24,4552,6741,6823,0,3542,1010,"[112, 182, 316, 319, 310, 304, 59, 278, 272, 90, 317, 288, 106, 259, 107, 81, 275, 14, 20, 87, 163, 285, 248, 0, 190, 261, 131]"
23,24,3994,1186,9631,0,2945,1049,"[7, 33, 42, 326, 255, 158, 276, 20, 50, 33, 209, 90, 6, 324, 1, 296, 221, 150, 258, 137, 94, 251, 155, 0, 229, 24, 75]"
24,24,4507,7422,6716,0,1039,3468,"[1121, 373, 795, 223, 126, 105, 647, 1014, 850, 215, 1031, 35, 728, 403, 167, 144, 648, 1115, 706, 241, 246, 753, 761, 0, 699, 663, 311]"
25,24,3383,367,9732,0,2826,557,"[69, 54, 21, 13, 131, 144, 110, 99, 58, 93, 53, 90, 136, 149, 4, 121, 76, 117, 73, 141, 29, 75, 19, 0, 37, 86, 137]"
26,24,3510,5968,7274,0,1100,2410,"[81, 288, 569, 769, 628, 257, 620, 672, 455, 501, 745, 467, 330, 485, 720, 482, 294, 417, 286, 280, 335, 789, 570, 0, 522, 802, 514]"
27,24,3424,2668,8030,0,3055,369,"[13, 20, 63, 98, 115, 18, 86, 82, 112, 102, 36, 9, 103, 29, 87, 93, 42, 77, 42, 101, 63, 96, 78, 0, 50, 43, 42]"
28,24,3022,6443,4609,0,3019,3,"[0, 0, 0, 1, 1, 1, 0, 0, 0, 1, 0, 0, 0, 0, 0, 0, 1, 1, 0, 1, 1, 1, 1, 0, 0, 1, 0]"
29,24,3947,1408,7148,0,1729,2218,"[491, 129, 668, 500, 296, 59, 386, 326, 560, 181, 72, 519, 566, 73, 287, 53, 714, 620, 286, 589, 724, 309, 566, 0, 22, 244, 303]"
30,24,3343,429,10000,62,1354,1989,"[563, 495, 236, 591, 476, 579, 297, 143, 540, 522, 484, 313, 554, 64, 117, 412, 564, 199, 350, 383, 11, 262, 267, 0, 456, 435, 291]"
31,24,3103,6630,6473,0,182,2921,"[324, 782, 555, 652, 591, 405, 192, 766, 239, 566, 708, 916, 635, 109, 968, 325, 85, 328, 887, 941, 907, 315, 900, 0, 80, 825, 669]"
32,24,4522,1880,9115,0,1723,2799,"[650, 914, 687, 798, 161, 576, 573, 368, 423, 707, 292, 525, 604, 856, 743, 422, 216, 63, 38, 501, 220, 228, 477, 0, 232, 475, 740]"
33,24,4298,5508,7905,0,2597,1701,"[458, 505, 261, 399, 429, 391, 319, 363, 526, 296, 318, 285, 126, 396, 154, 34, 277, 19, 479, 528, 295, 278, 182, 0, 349, 394, 422]"
34,24,4368,6191,6082,0,1273,3095,"[423, 327, 687, 1011, 335, 134, 554, 712, 34, 871, 998, 543, 173, 790, 812, 87, 711, 208, 755, 133, 1021, 89, 617, 0, 113, 849, 949]"
35,24,4918,1964,9036,0,730,4188,"[1389, 795, 1297, 78, 645, 867, 1214, 828, 31, 1117, 550, 1024, 49, 229, 646, 761, 1390, 216, 180, 868, 420, 1002, 1210, 0, 198, 182, 346]"
36,24,3593,6438,6191,0,1905,1688,"[338, 327, 153, 152, 509, 159, 122, 403, 282, 341, 3, 118, 515, 66, 28, 25, 103, 481, 334, 107, 86, 240, 416, 0, 58, 137, 197]"
37,24,4756,3004,7943,0,1128,3628,"[916, 6, 349, 840, 8, 88, 1126, 1011, 690, 1131, 1054, 820, 319, 166, 295, 584, 930, 1183, 931, 1135, 810, 528, 472, 0, 89, 714, 1114]"
38,24,3455,6335,5063,0,1038,2417,"[86, 340, 364, 83, 313, 238, 389, 261, 276, 331, 629, 540, 422, 674, 347, 790, 776, 378, 341, 241, 739, 247, 499, 0, 52, 476, 477]"
39,24,4975,4955,5083,0,1863,3112,"[558, 322, 811, 713, 475, 10, 701, 20, 146, 380, 520, 844, 596, 123, 717, 654, 446, 641, 958, 339, 357, 68, 656, 0, 785, 338, 959]"
40,24,3595,687,7991,0,1040,2555,"[136, 358, 116, 48, 217, 545, 661, 411, 687, 111, 407, 673, 501, 380, 82, 128, 657, 834, 838, 777, 608, 141, 333, 0, 54, 79, 400]"
41,24,3948,5080,6859,0,633,3315,"[574, 35, 650, 1019, 9, 156, 742, 664, 785, 934, 224, 578, 13, 549, 166, 969, 513, 459, 958, 470, 944, 962, 750, 0, 178, 644, 919]"
42,24,3829,3130,7558,0,1545,2284,"[604, 101, 282, 311, 122, 365, 712, 217, 160, 627, 340, 571, 465, 590, 28, 248, 489, 328, 10, 634, 562, 95, 561, 0, 11, 173, 754]"
43,24,4338,6669,5227,0,3196,1142,"[330, 377, 71, 166, 74, 190, 10, 31, 28, 144, 249, 157, 297, 325, 148, 338, 94, 31, 303, 207, 95, 149, 97, 0, 319, 55, 222]"
44,24,4561,2804,6984,0,2908,1653,"[144, 195, 334, 72, 238, 524, 146, 279, 11, 280, 288, 280, 67, 246, 53, 265, 83, 9, 147, 293, 436, 524, 408, 0, 533, 435, 299]"
45,24,4143,6868,4259,0,2551,1592,"[237, 83, 58, 482, 187, 185, 202, 75, 515, 317, 361, 480, 352, 368, 176, 418, 190, 260, 528, 300, 300, 422, 331, 0, 253, 283, 343]"
46,24,3965,1272,6952,0,2739,1226,"[302, 79, 17, 375, 293, 396, 143, 270, 4, 372, 72, 270, 137, 42, 182, 149, 309, 9, 158, 298, 137, 286, 41, 0, 385, 376, 136]"
47,24,3242,1839,8355,0,770,2472,"[647, 97, 1, 648, 111, 422, 151, 423, 755, 119, 275, 482, 65, 625, 633, 386, 672, 581, 574, 442, 145, 546, 235, 0, 418, 540, 706]"
48,24,4250,6572,6033,0,3285,965,"[27, 229, 81, 56, 107, 252, 78, 318, 71, 151, 248, 237, 54, 17, 9, 65, 73, 73, 126, 72, 286, 25, 131, 0, 133, 20, 77]"
49,24,3277,2839,6471,0,1806,1471,"[244, 301, 95, 453, 272, 395, 205, 230, 105, 333, 145, 478, 57, 437, 442, 48, 81, 71, 221, 156, 147, 279, 110, 0, 147, 326, 138]"
50,24,4718,6790,4399,0,4221,497,"[96, 138, 122, 98, 53, 134, 34, 66, 0, 50, 35, 133, 153, 71, 90, 149, 112, 90, 14, 41, 90, 122, 146, 0, 137, 131, 35]"
51,24,3136,1961,5574,0,2141,995,"[54, 67, 102, 317, 5, 163, 165, 204, 131, 103, 218, 222, 18, 119, 233, 12, 150, 282, 151, 155, 171, 240, 153, 0, 278, 89, 112]"
52,24,3295,3023,5846,0,2624,671,"[32, 114, 90, 166, 200, 32, 99, 147, 96, 154, 194, 180, 129, 84, 186, 217, 139, 37, 34, 17, 99, 159, 201, 0, 174, 48, 64]"
53,24,3498,619,8725,0,2831,667,"[136, 79, 141, 3, 126, 220, 92, 178, 159, 155, 116, 62, 102, 181, 96, 48, 103, 164, 86, 138, 185, 35, 84, 0, 188, 162, 179]"
54,24,4012,5724,7013,0,1727,2285,"[691, 383, 578, 500, 433, 159, 528, 26, 26, 3, 292, 293, 575, 652, 35, 355, 41, 147, 131, 499, 546, 709, 324, 0, 667, 745, 647]"
55,24,4156,6015,5154,0,1291,2865,"[740, 463, 811, 942, 834, 467, 354, 745, 155, 862, 654, 717, 163, 372, 724, 739, 267, 265, 135, 434, 210, 931, 636, 0, 864, 273, 184]"
56,24,4091,2498,6747,0,2907,1184,"[272, 30, 133, 264, 250, 295, 187, 316, 44, 204, 105, 259, 269, 371, 241, 170, 116, 120, 215, 211, 62, 277, 352, 0, 67, 123, 235]"
57,24,4915,5939,5723,0,2599,2316,"[6, 345, 323, 87, 557, 103, 464, 662, 409, 515, 457, 697, 599, 129, 579, 728, 580, 592, 525, 569, 293, 315, 151, 0, 678, 442, 174]"
58,24,4316,3180,6859,0,3979,337,"[6, 28, 6, 79, 42, 60, 72, 14, 84, 108, 20, 13, 18, 53, 78, 66, 14, 10, 5, 81, 99, 26, 34, 0, 59, 96, 96]"
59,24,3149,2622,7386,0,1776,1373,"[217, 421, 76, 49, 449, 259, 75, 162, 68, 37, 257, 190, 189, 202, 271, 328, 165, 8, 98, 251, 289, 419, 301, 0, 262, 41, 284]"
60,24,3964,6589,4761,0,1500,2464,"[81, 285, 132, 137, 322, 658, 535, 102, 0, 619, 702, 765, 43, 484, 750, 138, 256, 705, 400, 199, 446, 597, 384, 0, 768, 133, 5]"
61,24,4514,1482,7793,0,839,3675,"[119, 305, 774, 1110, 416, 102, 1212, 581, 134, 960, 781, 447, 472, 913, 805, 38, 940, 154, 544, 201, 197, 696, 1047, 0, 441, 341, 882]"
62,24,4358,6711,5440,0,1299,3059,"[244, 583, 508, 997, 391, 195, 456, 294, 202, 390, 702, 846, 230, 131, 638, 203, 291, 792, 717, 1013, 12, 957, 867, 0, 874, 512, 711]"
63,24,3098,1097,7441,0,951,2147,"[584, 111, 333, 215, 195, 43, 217, 404, 710, 704, 238, 675, 380, 149, 9, 130, 259, 190, 521, 253, 410, 493, 100, 0, 90, 0, 714]"
64,24,4732,5381,6792,0,1246,3486,"[259, 245, 819, 531, 393, 81, 1049, 576, 731, 1053, 780, 181, 865, 566, 307, 351, 546, 771, 459, 702, 175, 475, 26, 0, 864, 687, 648]"
65,24,3094,709,9177,0,1177,1917,"[382, 66, 218, 13, 110, 440, 4, 122, 607, 388, 23, 207, 161, 570, 207, 80, 242, 578, 164, 574, 265, 191, 50, 0, 32, 27, 391]"
66,24,3349,7186,5340,0,1110,2239,"[476, 471, 134, 384, 191, 201, 638, 379, 62, 36, 310, 125, 198, 421, 506, 524, 517, 296, 675, 559, 511, 687, 162, 0, 617, 251, 157]"
67,24,3233,1082,7491,0,968,2265,"[152, 508, 68, 403, 60, 21, 490, 738, 92, 220, 504, 335, 551, 105, 44, 642, 11, 371, 46, 454, 412, 48, 122, 0, 486, 656, 430]"
68,24,3286,901,9876,0,485,2801,"[138, 427, 310, 898, 506, 197, 410, 824, 14, 330, 489, 230, 153, 298, 689, 286, 327, 625, 181, 95, 60, 236, 163, 0, 734, 774, 371]"
69,24,3158,6711,6323,0,2305,853,"[210, 124, 284, 56, 254, 269, 258, 57, 62, 272, 155, 259, 73, 24, 130, 284, 71, 95, 91, 202, 168, 190, 239, 0, 98, 61, 32]"
70,24,3172,2802,6693,0,2254,918,"[101, 300, 73, 259, 237, 62, 30, 276, 263, 258, 54, 276, 147, 298, 165, 73, 59, 73, 231, 110, 222, 58, 176, 0, 90, 290, 77]"
71,24,4650,6227,5116,0,3956,694,"[180, 193, 213, 52, 203, 188, 122, 180, 0, 211, 58, 38, 109, 184, 56, 168, 120, 130, 66, 67, 68, 149, 46, 0, 81, 105, 151]"
72,24,4679,1238,8557,0,3149,1530,"[77, 17, 387, 308, 176, 92, 318, 80, 76, 329, 358, 109, 240, 223, 320, 276, 259, 338, 329, 377, 328, 182, 410, 0, 175, 195, 46]"
73,24,4065,6030,6592,0,1882,2183,"[112, 433, 85, 190, 345, 558, 575, 131, 516, 500, 705, 187, 537, 11, 65, 562, 232, 476, 510, 702, 153, 427, 661, 0, 544, 503, 580]"
74,24,3959,1810,8741,0,9,3950,"[734, 1128, 59, 513, 61, 698, 922, 876, 340, 62, 1128, 980, 33, 103, 1298, 556, 316, 1283, 384, 430, 481, 729, 676, 0, 1091, 875, 1072]"
75,24,3519,7406,4854,0,1317,2202,"[79, 100, 571, 201, 461, 107, 263, 546, 204, 195, 20, 87, 272, 377, 150, 491, 685, 354, 240, 408, 353, 519, 116, 0, 35, 183, 654]"
76,24,3149,2420,5583,0,1404,1745,"[394, 323, 29, 58, 139, 112, 517, 406, 309, 329, 95, 380, 66, 247, 281, 373, 250, 40, 97, 299, 148, 58, 298, 0, 140, 165, 420]"
77,24,3278,94,8767,0,2263,1015,"[336, 25, 122, 250, 133, 212, 2, 4, 319, 252, 51, 80, 257, 159, 155, 133, 12, 35, 123, 188, 137, 82, 234, 0, 45, 307, 52]"
78,24,3858,5335,7290,0,2283,1575,"[22, 252, 225, 282, 369, 340, 8, 152, 348, 102, 498, 87, 363, 264, 323, 30, 143, 338, 172, 278, 196, 451, 130, 0, 361, 265, 382]"
79,24,4535,5358,6467,0,1935,2600,"[446, 591, 863, 856, 114, 357, 8, 861, 123, 454, 845, 480, 665, 692, 185, 256, 522, 643, 410, 284, 353, 622, 290, 0, 619, 538, 596]"
80,24,3544,2339,7672,0,2928,616,"[19, 22, 113, 144, 93, 89, 154, 53, 184, 154, 32, 45, 99, 204, 4, 104, 6, 104, 187, 86, 3, 157, 198, 0, 75, 197, 151]"
81,24,4990,7126,5536,0,2523,2467,"[287, 379, 120, 583, 766, 305, 219, 431, 542, 711, 315, 426, 183, 681, 138, 507, 526, 235, 66, 108, 34, 696, 491, 0, 676, 486, 276]"
82,24,4419,2128,7827,0,2232,2187,"[26, 525, 548, 275, 186, 21, 380, 487, 186, 219, 119, 259, 696, 64, 359, 54, 86, 401, 284, 569, 344, 62, 269, 0, 477, 263, 280]"
83,24,3182,5668,5341,0,3109,73,"[3, 15, 0, 24, 2, 13, 9, 13, 6, 22, 3, 10, 0, 1, 22, 4, 23, 0, 15, 4, 16, 0, 3, 0, 14, 19, 9]"
84,24,4570,1216,8695,0,3072,1498,"[333, 341, 157, 206, 101, 10, 415, 177, 356, 89, 131, 75, 375, 462, 434, 275, 175, 350, 389, 125, 240, 203, 375, 0, 227, 23, 200]"
85,24,3278,6098,5875,0,1821,1457,"[203, 86, 262, 322, 149, 125, 349, 333, 398, 479, 345, 118, 268, 291, 162, 92, 371, 234, 409, 107, 87, 262, 83, 0, 317, 404, 475]"
86,24,4205,1369,8711,0,2877,1328,"[378, 15, 231, 27, 409, 313, 176, 238, 252, 264, 285, 23, 43, 391, 101, 285, 133, 180, 84, 286, 207, 21, 61, 0, 163, 302, 64]"
87,24,4021,5356,7376,0,2533,1488,"[257, 6, 465, 246, 385, 198, 241, 10, 72, 245, 385, 442, 110, 208, 39, 328, 489, 160, 391, 221, 352, 289, 195, 0, 28, 375, 105]"
88,24,3441,1221,9596,0,782,2659,"[436, 267, 202, 837, 360, 435, 117, 835, 197, 796, 312, 300, 251, 681, 805, 187, 194, 439, 797, 601, 775, 135, 262, 0, 719, 500, 529]"
89,24,4957,7098,7455,0,165,4792,"[231, 1005, 528, 528, 1129, 296, 473, 892, 637, 1561, 895, 1563, 802, 868, 1508, 1456, 489, 907, 898, 1516, 1410, 972, 1293, 0, 854, 749, 1421]"
90,24,4275,6442,5288,0,3121,1154,"[256, 135, 278, 270, 276, 30, 239, 31, 214, 259, 340, 293, 293, 90, 234, 294, 234, 287, 353, 132, 205, 178, 63, 0, 135, 93, 374]"
91,24,3547,2732,6103,0,305,3242,"[85, 1075, 1039, 173, 564, 1049, 123, 586, 328, 1074, 613, 548, 492, 19, 528, 635, 661, 189, 1068, 840, 669, 51, 250, 0, 178, 174, 973]"
92,24,3350,879,8574,0,1924,1426,"[310, 262, 8, 59, 197, 10, 276, 262, 434, 262, 81, 66, 71, 67, 251, 299, 466, 321, 173, 145, 251, 42, 317, 0, 208, 55, 73]"
93,24,4844,5775,7643,0,2410,2434,"[3, 693, 482, 251, 346, 767, 774, 453, 791, 69, 566, 470, 796, 99, 83, 316, 37, 618, 784, 396, 496, 4, 711, 0, 291, 162, 618]"
94,24,4912,5984,6571,0,958,3954,"[1289, 415, 769, 487, 650, 593, 499, 861, 467, 948, 616, 515, 169, 1028, 612, 829, 132, 755, 872, 889, 1108, 121, 495, 0, 1136, 1027, 667]"
95,24,4898,7104,4365,0,2804,2094,"[566, 25, 415, 254, 250, 308, 528, 72, 402, 607, 307, 486, 295, 136, 154, 7, 170, 131, 84, 199, 207, 268, 356, 0, 442, 561, 274]"
96,24,4412,2237,6540,0,3671,741,"[103, 242, 72, 131, 244, 38, 110, 94, 28, 132, 147, 205, 26, 199, 18, 194, 36, 183, 140, 13, 79, 221, 175, 0, 37, 46, 48]"
97,24,4590,6841,4289,0,4570,20,"[1, 3, 4, 4, 0, 0, 1, 2, 2, 1, 3, 6, 3, 5, 4, 4, 0, 1, 0, 1, 2, 3, 3, 0, 6, 5, 4]"
98,24,4462,4338,4413,0,2421,2041,"[319, 276, 0, 445, 303, 290, 473, 600, 371, 152, 437, 85, 547, 548, 488, 394, 117, 442, 121, 509, 210, 504, 448, 0, 266, 565, 77]"
99,24,4949,2265,7097,0,547,4402,"[967, 677, 515, 557, 792, 611, 1152, 124, 645, 294, 396, 752, 558, 440, 34, 786, 598, 404, 121, 367, 633, 621, 1405, 0, 78, 342, 1391]"
100,24,3597,3510,7184,0,1407,2190,"[717, 49, 599, 10, 191, 395, 324, 18, 277, 165, 77, 700, 264, 356, 33, 538, 296, 158, 493, 79, 160, 669, 479, 0, 507, 602, 459]"
101,24,4643,7007,4820,0,4118,525,"[122, 5, 86, 124, 15, 21, 133, 162, 52, 161, 169, 171, 94, 147, 103, 75, 62, 88, 167, 21, 55, 72, 85, 0, 24, 108, 173]"
102,24,4526,1221,8125,0,1315,3211,"[267, 913, 829, 150, 832, 474, 587, 456, 193, 592, 942, 803, 36, 19, 417, 539, 620, 675, 679, 459, 627, 603, 193, 0, 786, 990, 974]"
103,24,3665,5356,6434,0,2559,1106,"[8, 50, 292, 41, 213, 286, 342, 343, 49, 189, 214, 60, 321, 348, 5, 2, 312, 15, 71, 53, 51, 349, 337, 0, 141, 260, 338]"
104,24,3271,1559,8146,0,1434,1837,"[569, 295, 102, 608, 460, 185, 324, 200, 537, 152, 432, 439, 370, 91, 7, 26, 551, 298, 317, 382, 56, 506, 303, 0, 214, 282, 556]"
105,24,3331,6697,4780,0,1131,2200,"[389, 10, 261, 224, 606, 589, 73, 456, 708, 324, 160, 332, 718, 211, 419, 671, 303, 345, 176, 91, 110, 93, 259, 0, 699, 89, 47]"
106,24,4533,990,8323,0,1894,2639,"[69, 170, 644, 335, 507, 198, 374, 54, 720, 849, 522, 200, 245, 330, 668, 829, 0, 339, 753, 569, 246, 426, 105, 0, 51, 389, 476]"
107,24,3810,7442,4691,0,1960,1850,"[600, 607, 465, 289, 253, 50, 615, 53, 294, 286, 398, 318, 131, 497, 321, 464, 274, 429, 163, 400, 533, 610, 327, 0, 427, 309, 22]"
108,24,4437,2316,6812,0,26,4411,"[51, 1067, 478, 1334, 1466, 300, 568, 1185, 457, 1012, 1018, 1426, 155, 733, 775, 100, 616, 1305, 1066, 983, 1294, 966, 1309, 0, 650, 833, 569]"
109,24,3873,561,10000,124,689,3184,"[658, 518, 626, 571, 62, 648, 44, 834, 974, 363, 569, 929, 1025, 192, 751, 743, 951, 980, 901, 256, 855, 179, 787, 0, 885, 151, 590]"
110,24,3389,6842,6547,0,749,2640,"[663, 706, 558, 309, 259, 443, 554, 471, 77, 525, 665, 759, 3, 207, 593, 525, 558, 95, 540, 152, 512, 503, 508, 0, 771, 549, 560]"
111,24,3520,939,9128,0,1462,2058,"[38, 206, 478, 172, 542, 399, 67, 225, 538, 680, 501, 269, 668, 505, 340, 435, 216, 244, 176, 241, 520, 657, 179, 0, 91, 231, 154]"
112,24,4954,6192,7890,0,726,4228,"[1111, 14, 509, 692, 1359, 55, 281, 915, 536, 620, 872, 577, 48, 1100, 468, 814, 1281, 313, 1033, 1088, 231, 949, 354, 0, 1407, 114, 630]"
113,24,3176,7162,3904,0,1929,1247,"[281, 263, 411, 110, 251, 206, 333, 257, 84, 95, 277, 311, 184, 283, 15, 181, 410, 176, 259, 378, 389, 392, 118, 0, 206, 14, 342]"
114,24,3389,605,6688,0,1725,1664,"[154, 99, 382, 228, 540, 429, 381, 110, 456, 16, 521, 402, 71, 447, 35, 90, 481, 62, 300, 246, 237, 552, 463, 0, 10, 361, 374]"
115,24,4503,6444,4747,0,2154,2349,"[366, 773, 407, 640, 10, 89, 287, 273, 317, 497, 315, 62, 577, 255, 0, 8, 425, 159, 686, 60, 676, 3, 692, 0, 28, 432, 491]"
116,24,3378,2767,5358,0,711,2667,"[403, 192, 701, 510, 492, 39, 426, 457, 31, 562, 610, 238, 742, 710, 159, 681, 354, 21, 463, 583, 687, 861, 418, 0, 46, 180, 427]"
117,24,4017,1629,7746,0,2226,1791,"[217, 566, 44, 252, 225, 132, 169, 83, 94, 569, 363, 100, 494, 96, 268, 169, 432, 294, 484, 552, 414, 388, 160, 0, 512, 522, 143]"
118,24,4673,6289,6130,0,2681,1992,"[80, 14, 220, 486, 19, 409, 604, 67, 552, 133, 443, 29, 375, 248, 420, 502, 558, 413, 536, 207, 112, 45, 641, 0, 450, 160, 188]"
119,24,4265,2451,7944,0,3277,988,"[77, 188, 276, 123, 142, 133, 317, 255, 98, 56, 284, 110, 322, 96, 160, 221, 26, 239, 53, 106, 95, 227, 291, 0, 282, 12, 262]"
120,24,4018,7139,4823,0,3910,108,"[23, 13, 31, 4, 12, 29, 36, 28, 35, 29, 7, 20, 6, 17, 32, 36, 30, 0, 31, 36, 28, 10, 13, 0, 19, 12, 36]"
121,24,3585,380,8028,0,303,3282,"[643, 46, 714, 890, 468, 1059, 645, 672, 849, 740, 525, 558, 875, 1069, 888, 1054, 258, 501, 281, 259, 814, 783, 514, 0, 894, 477, 204]"
122,24,3206,6191,5043,0,1378,1828,"[209, 301, 501, 12, 488, 258, 45, 458, 47, 156, 465, 430, 410, 40, 159, 408, 359, 132, 218, 340, 229, 389, 456, 0, 395, 68, 325]"
123,24,3227,741,7529,0,2611,616,"[6, 155, 204, 200, 145, 22, 0, 66, 199, 96, 15, 135, 191, 181, 174, 46, 191, 82, 91, 10, 162, 79, 29, 0, 163, 63, 106]"
124,24,3249,2470,8308,0,1805,1444,"[77, 352, 179, 87, 9, 86, 319, 467, 192, 237, 304, 278, 309, 91, 402, 35, 445, 466, 73, 174, 180, 232, 345, 0, 235, 220, 283]"
125,24,4628,5454,7482,0,4132,496,"[4, 158, 74, 95, 154, 75, 75, 2, 122, 71, 150, 165, 34, 99, 125, 164, 71, 49, 86, 22, 71, 151, 9, 0, 118, 78, 52]"
126,24,3941,5098,6325,0,3149,792,"[108, 128, 64, 71, 45, 165, 248, 210, 81, 158, 21, 234, 50, 201, 238, 211, 244, 114, 190, 101, 32, 17, 222, 0, 47, 87, 139]"
127,24,3305,3302,6328,0,1058,2247,"[653, 466, 379, 622, 39, 242, 733, 67, 423, 533, 114, 416, 499, 426, 340, 70, 84, 277, 516, 392, 488, 142, 582, 0, 656, 651, 296]"
128,24,3019,294,9053,0,671,2348,"[466, 368, 608, 149, 507, 184, 360, 281, 72, 394, 221, 346, 479, 64, 72, 460, 222, 237, 396, 425, 778, 441, 119, 0, 676, 37, 421]"
129,24,3889,6956,5986,0,473,3416,"[657, 218, 866, 468, 1075, 803, 210, 286, 454, 79, 134, 481, 990, 67, 1049, 503, 1067, 1081, 1027, 928, 804, 883, 995, 0, 71, 833, 168]"
130,24,4170,1648,8508,0,1966,2204,"[330, 729, 687, 599, 251, 609, 383, 317, 290, 125, 405, 327, 725, 545, 679, 159, 208, 150, 692, 547, 164, 706, 449, 0, 87, 565, 478]"
131,24,4643,6963,6188,0,272,4371,"[1183, 849, 43, 103, 469, 83, 184, 1049, 635, 1165, 96, 1213, 920, 249, 1358, 1293, 1332, 424, 877, 293, 557, 1166, 233, 0, 458, 1195, 420]"
132,24,3447,1600,8035,0,2473,974,"[184, 263, 213, 195, 86, 50, 304, 122, 76, 309, 19, 42, 198, 215, 292, 302, 230, 72, 268, 255, 269, 152, 217, 0, 54, 46, 309]"
133,24,3901,5106,6830,0,2544,1357,"[444, 155, 58, 442, 148, 135, 437, 383, 34, 44, 62, 416, 191, 401, 293, 1, 452, 376, 91, 135, 206, 22, 393, 0, 24, 252, 452]"
134,24,4198,6801,4227,0,464,3734,"[683, 571, 37, 142, 1240, 934, 254, 537, 801, 216, 1052, 1242, 963, 410, 1094, 999, 941, 671, 1223, 13, 204, 795, 1172, 0, 403, 862, 461]"
135,24,3739,310,7656,0,1933,1806,"[14, 150, 315, 327, 5, 172, 227, 94, 519, 444, 439, 544, 232, 10, 259, 582, 24, 482, 48, 148, 436, 4, 585, 0, 198, 263, 139]"
136,24,4377,5608,6425,0,3159,1218,"[259, 286, 235, 48, 36, 148, 271, 356, 288, 361, 141, 370, 301, 187, 317, 4, 33, 192, 404, 179, 45, 174, 46, 0, 85, 352, 346]"
137,24,3915,3565,6775,0,2411,1504,"[470, 83, 458, 147, 484, 131, 418, 339, 141, 180, 179, 493, 29, 291, 110, 500, 354, 338, 74, 474, 28, 177, 112, 0, 395, 329, 391]"
138,24,4679,7302,4152,0,3141,1538,"[46, 202, 10, 265, 381, 185, 246, 306, 237, 413, 479, 484, 23, 416, 174, 455, 293, 196, 392, 323, 61, 198, 236, 0, 275, 47, 58]"
139,24,3802,2215,5739,0,3499,303,"[17, 18, 52, 4, 30, 47, 75, 57, 33, 64, 78, 55, 62, 27, 97, 0, 12, 17, 77, 42, 45, 28, 66, 0, 50, 0, 73]"
140,24,4500,535,9704,0,431,4069,"[1332, 1048, 1001, 570, 946, 386, 1268, 997, 688, 52, 13, 1289, 770, 124, 137, 990, 985, 1094, 508, 652, 1080, 1069, 630, 0, 618, 16, 1006]"
141,24,4002,6225,7481,0,505,3497,"[520, 817, 164, 289, 792, 122, 894, 213, 11, 1100, 307, 906, 410, 971, 372, 66, 943, 799, 1102, 408, 42, 0, 603, 0, 1075, 282, 872]"
142,24,4982,5296,7167,0,3426,1556,"[131, 28, 510, 361, 192, 170, 128, 19, 266, 98, 450, 53, 429, 475, 4, 388, 243, 503, 425, 425, 343, 336, 238, 0, 406, 469, 465]"
143,24,4084,5201,6050,0,884,3200,"[872, 718, 846, 586, 374, 597, 584, 846, 1016, 145, 735, 168, 705, 613, 961, 1016, 528, 309, 311, 789, 689, 629, 556, 0, 903, 862, 713]"
144,24,3474,3319,6205,0,743,2731,"[70, 556, 43, 252, 786, 740, 136, 561, 895, 578, 552, 881, 302, 220, 541, 28, 792, 372, 704, 688, 10, 231, 581, 0, 373, 36, 529]"
145,24,3831,2504,7532,0,3110,721,"[77, 110, 175, 8, 233, 51, 198, 157, 141, 123, 216, 40, 106, 188, 135, 196, 210, 38, 95, 173, 59, 110, 207, 0, 221, 127, 184]"
146,24,3496,6849,4179,0,306,3190,"[428, 213, 42, 187, 1017, 376, 645, 986, 624, 645, 1063, 1009, 672, 596, 601, 844, 860, 16, 896, 252, 715, 988, 981, 0, 364, 614, 978]"
147,24,4197,4026,4350,0,2124,2073,"[521, 392, 275, 465, 72, 255, 86, 166, 189, 238, 528, 610, 426, 173, 308, 590, 662, 403, 382, 632, 340, 357, 535, 0, 46, 478, 631]"
148,24,4100,2129,6321,0,3489,611,"[175, 65, 55, 9, 85, 102, 40, 202, 146, 112, 132, 127, 173, 84, 201, 131, 185, 140, 22, 162, 56, 94, 200, 0, 69, 46, 84]"
149,24,4102,132,10000,291,3575,527,"[99, 82, 77, 137, 83, 159, 8, 163, 148, 74, 99, 110, 110, 171, 121, 111, 32, 46, 13, 47, 116, 94, 46, 0, 158, 86, 2]"
150,24,3260,6401,6859,0,2162,1098,"[83, 88, 346, 210, 246, 152, 30, 350, 62, 239, 259, 107, 170, 98, 136, 229, 300, 161, 173, 36, 183, 174, 27, 0, 303, 290, 140]"
151,24,4051,3463,7447,0,789,3262,"[308, 760, 597, 141, 1075, 435, 421, 780, 1042, 151, 787, 386, 902, 52, 514, 838, 299, 639, 135, 156, 986, 286, 387, 0, 870, 172, 263]"
152,24,3820,6186,5081,0,1490,2330,"[379, 61, 49, 540, 161, 767, 144, 310, 382, 452, 184, 272, 505, 265, 219, 339, 310, 751, 365, 233, 661, 298, 372, 0, 619, 672, 9]"
153,24,3450,691,7840,0,2021,1429,"[303, 363, 351, 453, 343, 440, 64, 337, 298, 103, 28, 334, 187, 146, 190, 54, 169, 15, 341, 454, 360, 225, 419, 0, 225, 390, 195]"
154,24,4829,6476,6193,0,3604,1225,"[166, 136, 382, 140, 257, 144, 51, 292, 153, 270, 33, 142, 77, 132, 382, 40, 400, 185, 65, 314, 222, 102, 277, 0, 139, 202, 90]"
155,24,4096,3574,6715,0,164,3932,"[285, 777, 877, 256, 348, 1267, 666, 935, 601, 803, 907, 81, 17, 38, 774, 876, 611, 386, 1178, 520, 135, 1241, 1131, 0, 15, 285, 1239]"
156,24,3287,3007,6995,0,482,2805,"[747, 534, 857, 811, 609, 93, 748, 132, 443, 152, 45, 814, 22, 568, 721, 440, 208, 398, 485, 534, 363, 397, 583, 0, 844, 775, 530]"
157,24,4758,6822,4931,0,3445,1313,"[200, 115, 179, 317, 204, 233, 53, 347, 252, 292, 190, 25, 132, 60, 418, 62, 66, 336, 290, 330, 197, 113, 336, 0, 387, 85, 114]"
158,24,4235,2198,6968,0,1181,3054,"[849, 74, 157, 149, 836, 825, 174, 396, 158, 16, 477, 207, 653, 257, 1009, 732, 21, 552, 584, 921, 821, 706, 460, 0, 873, 144, 161]"
159,24,4637,5010,6595,0,4254,383,"[58, 4, 112, 101, 42, 90, 56, 53, 43, 52, 65, 30, 58, 94, 66, 73, 4, 75, 77, 123, 8, 124, 36, 0, 34, 74, 46]"
160,24,3905,273,10000,227,772,3133,"[564, 382, 199, 68, 670, 720, 495, 448, 747, 189, 898, 688, 637, 285, 256, 6, 190, 927, 794, 484, 989, 234, 311, 0, 101, 600, 993]"
161,24,4403,6036,8367,0,3759,644,"[95, 196, 206, 6, 13, 122, 103, 116, 188, 192, 190, 5, 192, 51, 138, 94, 191, 204, 183, 56, 192, 75, 0, 0, 132, 49, 115]"
162,24,4601,5674,7294,0,2218,2383,"[247, 609, 678, 62, 443, 238, 45, 227, 126, 592, 465, 487, 117, 243, 151, 762, 355, 237, 635, 13, 746, 209, 561, 0, 437, 95, 685]"
163,24,4533,5349,6478,0,4361,172,"[36, 22, 20, 8, 39, 23, 11, 37, 26, 57, 23, 16, 16, 40, 9, 32, 51, 9, 34, 29, 28, 35, 53, 0, 51, 29, 29]"
164,24,3378,1372,8484,0,2898,480,"[59, 5, 89, 153, 97, 153, 27, 62, 94, 157, 142, 76, 81, 119, 16, 89, 80, 94, 35, 44, 109, 127, 112, 0, 135, 149, 26]"
165,24,4706,5473,7717,0,4100,606,"[159, 161, 165, 67, 102, 167, 6, 171, 102, 192, 16, 96, 7, 190, 99, 36, 57, 164, 35, 23, 152, 49, 38, 0, 0, 155, 91]"
166,24,3871,7242,4346,0,1716,2155,"[423, 124, 54, 356, 370, 189, 262, 340, 466, 562, 423, 308, 355, 490, 306, 543, 427, 241, 375, 632, 214, 135, 647, 0, 296, 292, 351]"
167,24,3434,2754,5026,0,1469,1965,"[57, 275, 291, 224, 320, 331, 6, 418, 523, 142, 271, 410, 336, 205, 449, 654, 242, 523, 193, 448, 138, 183, 637, 0, 165, 448, 616]"
168,24,3958,731,8253,0,1940,2018,"[391, 64, 582, 128, 206, 2, 30, 434, 452, 38, 244, 229, 46, 317, 167, 651, 325, 315, 291, 246, 136, 260, 444, 0, 34, 358, 671]"
169,24,4645,6632,6266,0,2879,1766,"[437, 43, 268, 255, 154, 330, 326, 248, 215, 191, 496, 269, 257, 451, 221, 432, 305, 435, 89, 343, 121, 526, 550, 0, 454, 204, 341]"
170,24,4526,3071,7721,0,2291,2235,"[35, 51, 525, 579, 259, 389, 218, 570, 445, 124, 298, 403, 582, 496, 153, 75, 575, 3, 583, 296, 542, 247, 363, 0, 410, 238, 740]"
171,24,3106,1992,8835,0,2985,121,"[26, 40, 23, 32, 36, 18, 9, 23, 26, 21, 16, 36, 2, 9, 24, 17, 9, 40, 28, 10, 37, 7, 23, 0, 6, 18, 21]"
172,24,4822,7316,6341,0,4391,431,"[116, 114, 70, 39, 108, 142, 135, 91, 46, 78, 98, 88, 136, 140, 131, 116, 77, 129, 87, 88, 0, 90, 95, 0, 6, 78, 112]"
173,24,3148,3124,6365,0,815,2333,"[627, 480, 284, 161, 246, 577, 601, 534, 395, 71, 524, 40, 412, 94, 607, 665, 648, 137, 434, 492, 696, 389, 572, 0, 518, 162, 437]"
174,24,4921,5240,6046,0,1241,3680,"[582, 649, 314, 1095, 466, 41, 558, 444, 2, 1215, 108, 297, 669, 402, 529, 699, 17, 375, 174, 217, 816, 925, 805, 0, 1173, 1175, 278]"
175,24,4021,2993,7074,0,3560,461,"[12, 96, 151, 65, 104, 22, 85, 144, 0, 8, 15, 56, 9, 46, 4, 54, 153, 3, 0, 87, 96, 23, 1, 0, 58, 77, 73]"
176,24,4759,6250,5583,0,1785,2974,"[70, 832, 552, 473, 163, 974, 315, 775, 572, 835, 620, 24, 904, 804, 428, 639, 458, 981, 114, 784, 241, 217, 23, 0, 628, 941, 847]"
177,24,4335,3362,6556,0,2381,1954,"[202, 517, 160, 641, 640, 616, 267, 550, 70, 227, 396, 345, 412, 389, 251, 77, 322, 313, 391, 49, 266, 389, 435, 0, 188, 125, 171]"
178,24,3225,1013,8768,0,777,2448,"[605, 281, 573, 41, 593, 44, 620, 254, 72, 107, 190, 252, 330, 482, 625, 782, 719, 5, 474, 345, 139, 660, 317, 0, 257, 570, 724]"
179,24,3402,7121,5049,0,1784,1618,"[416, 389, 66, 51, 188, 328, 104, 539, 196, 388, 335, 67, 110, 447, 234, 359, 81, 447, 354, 197, 318, 234, 441, 0, 71, 495, 525]"
180,24,4702,3567,6184,0,2071,2631,"[595, 110, 871, 210, 279, 290, 593, 677, 813, 824, 795, 447, 566, 187, 328, 682, 83, 583, 461, 38, 118, 522, 455, 0, 687, 225, 260]"
181,24,4769,4481,6472,0,247,4522,"[1481, 594, 1419, 962, 1301, 1481, 400, 434, 167, 235, 1488, 217, 698, 843, 847, 355, 98, 291, 1140, 230, 662, 1191, 661, 0, 996, 570, 1302]"
182,24,4715,6074,5113,0,188,4527,"[913, 438, 585, 788, 740, 205, 144, 184, 772, 150, 424, 219, 387, 282, 1000, 394, 183, 510, 489, 414, 357, 685, 455, 0, 1131, 1391, 1196]"
183,24,4332,3222,6223,0,3061,1271,"[183, 156, 170, 376, 131, 400, 77, 325, 356, 176, 343, 1, 64, 61, 313, 15, 245, 219, 386, 300, 182, 217, 258, 0, 118, 117, 294]"
184,24,3566,149,9640,0,8,3558,"[180, 1078, 272, 887, 581, 400, 1005, 561, 981, 570, 1132, 24, 717, 50, 795, 324, 47, 970, 649, 770, 721, 98, 443, 0, 532, 804, 394]"
185,24,4061,7387,6314,0,774,3287,"[85, 639, 518, 67, 111, 322, 147, 522, 104, 278, 505, 37, 711, 320, 664, 107, 118, 746, 1045, 129, 115, 707, 262, 0, 261, 666, 897]"
186,24,3406,2540,7180,0,932,2474,"[794, 774, 385, 188, 553, 162, 327, 251, 280, 614, 231, 820, 451, 427, 104, 452, 526, 771, 127, 307, 700, 196, 436, 0, 645, 402, 434]"
187,24,4120,5967,5333,0,2627,1493,"[297, 16, 381, 163, 125, 28, 432, 181, 172, 174, 226, 297, 173, 368, 386, 260, 446, 488, 341, 161, 418, 288, 399, 0, 355, 48, 288]"
188,24,4149,3893,5589,0,2327,1822,"[473, 587, 409, 252, 141, 449, 161, 323, 466, 466, 583, 124, 385, 319, 508, 24, 503, 256, 149, 77, 480, 602, 283, 0, 584, 593, 94]"
189,24,4907,2393,8103,0,2848,2059,"[340, 626, 499, 396, 529, 523, 67, 526, 130, 326, 640, 299, 554, 478, 133, 538, 64, 336, 226, 156, 261, 589, 589, 0, 333, 49, 499]"
190,24,3343,6887,4559,0,1785,1558,"[127, 319, 118, 343, 286, 229, 59, 235, 172, 141, 476, 288, 268, 438, 383, 499, 252, 61, 125, 217, 14, 131, 137, 0, 163, 100, 479]"
191,24,4622,3168,6013,0,950,3672,"[958, 693, 854, 1080, 420, 875, 507, 698, 902, 717, 222, 612, 260, 842, 44, 323, 195, 36, 600, 526, 753, 1038, 785, 0, 333, 192, 280]"
192,24,3078,1824,7267,0,966,2112,"[240, 342, 27, 106, 630, 447, 393, 426, 537, 227, 313, 79, 498, 504, 247, 167, 680, 562, 188, 202, 125, 259, 360, 0, 32, 689, 178]"
193,24,4812,7234,4845,0,4675,137,"[22, 1, 30, 18, 11, 15, 38, 28, 2, 1, 2, 4, 1, 16, 42, 1, 33, 20, 15, 5, 42, 37, 40, 0, 41, 25, 45]"
194,24,3088,3042,4891,0,3072,16,"[0, 2, 0, 1, 5, 3, 2, 3, 0, 5, 5, 3, 0, 0, 0, 2, 2, 4, 0, 3, 3, 3, 1, 0, 5, 2, 0]"
195,24,3708,1449,7150,0,2710,998,"[304, 10, 210, 65, 326, 58, 189, 151, 279, 119, 270, 124, 40, 182, 75, 306, 330, 29, 81, 252, 92, 309, 165, 0, 91, 75, 254]"
196,24,3828,2945,8033,0,951,2877,"[551, 929, 847, 29, 361, 556, 922, 123, 852, 184, 948, 210, 647, 378, 167, 419, 363, 436, 937, 514, 535, 190, 628, 0, 401, 779, 336]"
197,24,4765,5132,7666,0,2070,2695,"[267, 521, 340, 751, 745, 422, 709, 556, 169, 31, 595, 828, 142, 759, 422, 682, 149, 227, 163, 833, 127, 376, 718, 0, 367, 308, 264]"
198,24,4778,5788,6656,0,2144,2634,"[572, 377, 642, 78, 104, 256, 208, 299, 187, 665, 192, 802, 500, 64, 224, 863, 742, 560, 553, 843, 661, 869, 717, 0, 385, 812, 223]"
199,24,4017,3290,7383,0,185,3832,"[1094, 13, 1128, 155, 565, 347, 1139, 448, 543, 752, 1157, 237, 1170, 1193, 637, 329, 504, 766, 797, 526, 553, 1157, 671, 0, 1270, 1265, 878]"
200,24,4446,5326,6503,0,1424,3022,"[837, 919, 672, 71, 744, 205, 52, 146, 245, 596, 633, 98, 395, 397, 354, 249, 71, 170, 53, 789, 67, 940, 693, 0, 299, 197, 362]"
201,24,4679,7320,3862,0,4032,647,"[190, 97, 214, 5, 211, 99, 201, 33, 208, 204, 131, 128, 156, 146, 134, 85, 133, 137, 159, 100, 124, 123, 139, 0, 171, 190, 66]"
202,24,3704,1662,5904,0,1751,1953,"[371, 219, 328, 363, 34, 256, 539, 564, 7, 128, 614, 44, 217, 133, 179, 372, 138, 285, 65, 193, 14, 309, 552, 0, 263, 345, 230]"
203,24,4434,3715,6623,0,2757,1677,"[291, 500, 554, 243, 486, 166, 71, 434, 80, 9, 507, 230, 133, 237, 353, 79, 415, 420, 510, 129, 119, 420, 11, 0, 395, 96, 233]"
204,24,3213,2857,6979,0,2525,688,"[160, 161, 18, 158, 18, 166, 37, 115, 182, 29, 39, 85, 207, 47, 57, 124, 48, 132, 75, 27, 65, 86, 27, 0, 84, 203, 187]"
205,24,4422,6755,4646,0,2365,2057,"[605, 146, 674, 390, 379, 65, 661, 86, 174, 611, 261, 629, 170, 62, 455, 627, 475, 160, 566, 108, 303, 6, 313, 0, 415, 49, 285]"
206,24,4288,15,8919,0,4268,20,"[2, 3, 6, 3, 0, 0, 3, 3, 2, 0, 1, 3, 6, 6, 1, 2, 2, 4, 6, 1, 4, 5, 1, 0, 3, 1, 5]"
207,24,4510,5980,7449,0,1193,3317,"[1100, 623, 409, 950, 372, 220, 765, 727, 275, 68, 257, 87, 861, 352, 156, 509, 1051, 56, 361, 169, 611, 883, 78, 0, 698, 913, 636]"
208,24,3401,705,10000,145,757,2644,"[322, 589, 736, 240, 276, 310, 415, 855, 827, 312, 281, 768, 443, 653, 285, 99, 407, 261, 400, 607, 139, 847, 84, 0, 843, 814, 470]"
209,24,4537,6502,8035,0,1463,3074,"[567, 667, 400, 129, 237, 42, 373, 328, 72, 186, 904, 529, 954, 938, 322, 168, 569, 34, 313, 542, 94, 577, 108, 0, 622, 811, 477]"
210,24,3776,5998,5813,0,2868,908,"[231, 86, 34, 101, 54, 256, 196, 206, 113, 97, 287, 187, 114, 260, 213, 109, 285, 187, 193, 76, 282, 57, 293, 0, 39, 213, 206]"
211,24,4449,2322,7940,0,2292,2157,"[563, 545, 640, 441, 35, 131, 293, 138, 541, 701, 277, 227, 183, 168, 59, 338, 44, 561, 237, 353, 260, 14, 313, 0, 382, 367, 636]"
212,24,3669,6238,5371,0,690,2979,"[935, 900, 372, 786, 301, 76, 714, 46, 469, 760, 880, 24, 579, 658, 23, 546, 343, 838, 949, 396, 886, 943, 987, 0, 723, 498, 918]"
213,24,3261,2381,6251,0,2344,917,"[25, 231, 159, 172, 278, 143, 87, 9, 28, 147, 276, 299, 40, 178, 24, 59, 128, 230, 97, 156, 84, 98, 44, 0, 3, 93, 84]"
214,24,4198,4064,6385,0,2320,1878,"[288, 8, 502, 422, 90, 92, 164, 235, 418, 470, 459, 167, 347, 310, 469, 480, 490, 312, 526, 592, 86, 495, 497, 0, 505, 582, 224]"
215,24,3398,2138,7645,0,108,3290,"[334, 596, 114, 502, 866, 477, 695, 1061, 592, 451, 877, 63, 456, 374, 1087, 728, 633, 224, 693, 507, 986, 108, 369, 0, 84, 750, 725]"
216,24,3912,5859,5698,0,478,3434,"[499, 365, 496, 939, 1011, 431, 419, 468, 107, 1142, 581, 473, 837, 398, 266, 826, 912, 1002, 408, 622, 1009, 151, 5, 0, 4, 1103, 1085]"
217,24,3289,769,8218,0,406,2883,"[636, 527, 752, 96, 870, 605, 365, 85, 361, 501, 830, 14, 399, 279, 546, 409, 579, 60, 29, 891, 285, 162, 280, 0, 161, 403, 16]"
218,24,3391,7385,4224,0,1181,2210,"[473, 382, 222, 578, 363, 218, 164, 155, 447, 105, 64, 605, 423, 524, 262, 219, 721, 67, 149, 41, 612, 362, 193, 0, 471, 7, 38]"
219,24,4765,769,8220,0,1124,3641,"[386, 962, 1064, 817, 912, 852, 17, 677, 206, 476, 752, 961, 1165, 1090, 981, 860, 600, 343, 43, 761, 244, 562, 57, 0, 587, 252, 372]"
220,24,3292,6366,5146,0,589,2703,"[740, 247, 663, 862, 895, 706, 839, 148, 834, 749, 170, 589, 586, 343, 338, 655, 488, 687, 658, 261, 69, 648, 692, 0, 131, 250, 165]"
221,24,4562,1938,7770,0,1624,2938,"[703, 738, 930, 523, 192, 555, 955, 695, 793, 105, 358, 411, 121, 474, 3, 38, 682, 148, 827, 601, 512, 855, 859, 0, 848, 954, 259]"
222,24,4659,5603,6826,0,1784,2875,"[293, 732, 86, 889, 534, 659, 332, 383, 356, 176, 101, 500, 391, 549, 785, 728, 667, 401, 10, 805, 578, 384, 958, 0, 568, 154, 554]"
223,24,3022,2781,7067,0,1728,1294,"[379, 76, 104, 86, 74, 316, 321, 281, 143, 50, 359, 140, 129, 236, 354, 170, 112, 89, 324, 206, 338, 377, 208, 0, 325, 390, 159]"
224,24,4941,6719,5289,0,2015,2926,"[802, 15, 98, 215, 707, 164, 147, 227, 490, 725, 414, 3, 369, 866, 483, 218, 803, 859, 113, 763, 432, 785, 753, 0, 106, 269, 886]"
225,24,4385,24,9650,0,2524,1861,"[469, 601, 78, 479, 468, 369, 82, 281, 268, 382, 424, 327, 561, 15, 226, 266, 420, 282, 427, 541, 367, 248, 407, 0, 267, 217, 2]"
226,24,4513,7415,6748,0,462,4051,"[910, 1144, 860, 421, 1016, 1166, 503, 691, 1052, 260, 147, 794, 383, 109, 111, 1326, 469, 299, 1255, 557, 868, 406, 84, 0, 1230, 1318, 699]"
227,24,3224,2047,7925,0,2310,914,"[283, 293, 243, 8, 299, 128, 125, 183, 225, 280, 186, 117, 237, 256, 76, 277, 110, 236, 301, 262, 21, 266, 270, 0, 143, 98, 83]"
228,24,3885,5365,6445,0,2063,1822,"[249, 249, 505, 212, 307, 195, 524, 427, 125, 405, 150, 142, 576, 179, 495, 187, 182, 95, 354, 544, 36, 246, 103, 0, 402, 420, 454]"
229,24,4027,4026,6446,0,3335,692,"[39, 103, 102, 163, 89, 151, 12, 131, 13, 206, 193, 193, 178, 90, 27, 109, 110, 90, 184, 46, 217, 181, 205, 0, 16, 168, 75]"
230,24,4579,7008,4017,0,3163,1416,"[282, 471, 371, 120, 156, 380, 402, 255, 239, 249, 87, 28, 233, 100, 203, 175, 466, 417, 455, 97, 253, 349, 463, 0, 46, 86, 172]"
231,24,4979,2221,6775,0,1526,3453,"[325, 214, 73, 1061, 658, 1075, 377, 70, 994, 957, 619, 1015, 884, 1071, 854, 280, 152, 537, 958, 414, 94, 903, 743, 0, 134, 615, 387]"
232,24,4595,5975,5395,0,462,4133,"[1069, 1215, 900, 588, 631, 116, 732, 978, 451, 731, 558, 127, 901, 20, 1262, 1272, 604, 1375, 393, 407, 798, 395, 121, 0, 664, 889, 610]"
233,24,3862,1555,7702,0,2583,1279,"[272, 393, 52, 43, 190, 22, 62, 340, 378, 410, 136, 335, 129, 14, 282, 302, 121, 190, 352, 218, 300, 64, 285, 0, 206, 332, 424]"
234,24,3837,6279,5260,0,1312,2525,"[721, 822, 41, 708, 603, 437, 416, 5, 201, 389, 661, 107, 584, 188, 12, 616, 575, 479, 358, 7, 275, 38, 330, 0, 824, 468, 103]"
235,24,4167,112,9315,0,845,3322,"[786, 32, 604, 113, 720, 912, 946, 872, 837, 886, 206, 366, 1027, 633, 649, 245, 1103, 588, 143, 936, 435, 687, 416, 0, 373, 152, 848]"
236,24,3046,5556,6805,0,2722,324,"[67, 38, 1, 31, 75, 4, 9, 58, 88, 81, 43, 8, 59, 38, 18, 48, 15, 52, 28, 77, 83, 40, 29, 0, 91, 96, 37]"
237,24,3069,1113,8761,0,228,2841,"[633, 770, 776, 142, 717, 241, 850, 900, 678, 663, 287, 567, 362, 289, 359, 773, 256, 814, 208, 797, 919, 822, 879, 0, 585, 201, 282]"
238,24,4507,5311,7957,0,4059,448,"[57, 23, 22, 62, 140, 101, 76, 141, 124, 54, 57, 28, 92, 12, 3, 52, 54, 112, 27, 147, 15, 102, 96, 0, 101, 78, 38]"
239,24,4984,5134,7807,0,1018,3966,"[718, 1141, 448, 857, 950, 1319, 1163, 399, 339, 1028, 1285, 511, 1207, 829, 900, 212, 435, 771, 241, 263, 275, 478, 558, 0, 284, 382, 944]"
240,24,3112,530,10000,389,1094,2018,"[61, 424, 628, 328, 463, 285, 233, 395, 315, 92, 633, 580, 80, 641, 241, 638, 546, 360, 81, 502, 336, 12, 504, 0, 99, 236, 508]"
241,24,3787,7408,6379,0,941,2846,"[820, 497, 503, 356, 166, 445, 597, 285, 506, 166, 55, 22, 378, 920, 937, 328, 901, 599, 293, 911, 95, 14, 78, 0, 182, 96, 554]"
242,24,3300,3295,6384,0,316,2984,"[589, 397, 185, 854, 787, 738, 451, 599, 239, 519, 48, 231, 401, 542, 528, 244, 506, 811, 837, 645, 957, 420, 79, 0, 702, 730, 5]"
243,24,4589,4223,6750,0,4510,79,"[19, 22, 13, 21, 26, 19, 26, 4, 20, 9, 0, 10, 4, 21, 5, 23, 7, 2, 26, 10, 21, 14, 11, 0, 19, 13, 20]"
244,24,4249,377,10000,622,993,3256,"[580, 650, 1068, 889, 394, 941, 97, 960, 336, 429, 361, 479, 1032, 120, 801, 714, 744, 968, 427, 538, 88, 951, 793, 0, 954, 203, 331]"
245,24,3767,5408,8359,0,3363,404,"[83, 110, 133, 14, 131, 68, 16, 120, 48, 6, 51, 22, 49, 100, 53, 118, 51, 65, 94, 3, 99, 24, 50, 0, 42, 33, 20]"
246,24,4476,5660,7175,0,935,3541,"[1155, 124, 1009, 36, 175, 1004, 924, 580, 1087, 586, 592, 327, 103, 127, 741, 1035, 485, 112, 652, 395, 691, 928, 1083, 0, 715, 1107, 98]"
247,24,3763,665,10000,273,220,3543,"[210, 1030, 203, 452, 751, 712, 32, 386, 656, 447, 546, 995, 540, 352, 579, 403, 283, 462, 914, 18, 817, 18, 1117, 0, 850, 635, 1117]"
248,24,4833,6384,8449,0,1567,3266,"[195, 438, 890, 893, 669, 956, 757, 188, 815, 1032, 794, 773, 97, 611, 996, 629, 965, 229, 891, 747, 367, 16, 546, 0, 595, 163, 524]"
249,24,3798,7469,4778,0,3542,256,"[45, 4, 12, 85, 35, 47, 0, 5, 28, 2, 55, 10, 58, 69, 21, 48, 81, 15, 34, 78, 21, 37, 75, 0, 72, 84, 45]"
250,24,3655,3107,5326,0,1610,2045,"[359, 414, 185, 74, 319, 256, 197, 81, 240, 160, 350, 147, 419, 139, 439, 500, 435, 540, 365, 12, 133, 589, 338, 0, 455, 610, 382]"
251,24,4538,3474,6390,0,3087,1451,"[311, 212, 462, 451, 453, 240, 62, 326, 220, 107, 464, 11, 47, 0, 376, 302, 411, 227, 207, 46, 315, 72, 405, 0, 6, 315, 24]"
252,24,4732,6315,4807,0,2586,2146,"[253, 445, 697, 113, 71, 576, 97, 416, 391, 522, 692, 265, 261, 369, 648, 251, 553, 647, 361, 508, 484, 621, 201, 0, 191, 490, 423]"
253,24,4846,1195,8458,0,420,4426,"[876, 189, 1260, 924, 623, 506, 1309, 354, 1067, 162, 485, 1020, 531, 1286, 555, 1054, 418, 419, 625, 543, 1391, 14, 227, 0, 1407, 128, 518]"
254,24,4254,6993,5719,0,1025,3229,"[271, 884, 462, 257, 1041, 503, 845, 348, 885, 142, 785, 16, 1039, 207, 758, 346, 888, 748, 412, 800, 313, 634, 159, 0, 558, 274, 679]"
255,24,3577,2419,6877,0,487,3090,"[613, 352, 229, 304, 380, 183, 874, 695, 623, 914, 59, 246, 521, 692, 853, 485, 48, 770, 414, 822, 341, 979, 124, 0, 200, 460, 397]"
256,24,3749,60,10000,566,3622,127,"[16, 33, 34, 26, 13, 32, 27, 0, 27, 2, 39, 33, 19, 8, 0, 16, 2, 39, 36, 20, 38, 14, 31, 0, 0, 22, 21]"
257,24,4811,5833,8978,0,3079,1732,"[375, 440, 331, 508, 267, 40, 31, 527, 564, 169, 48, 565, 93, 575, 105, 167, 159, 273, 392, 198, 265, 553, 571, 0, 542, 76, 494]"
258,24,4034,6218,6794,0,3366,668,"[123, 5, 11, 211, 12, 159, 114, 12, 190, 144, 73, 80, 143, 179, 170, 123, 96, 110, 135, 44, 199, 104, 48, 0, 21, 26, 29]"
259,24,3131,3065,6860,0,1985,1146,"[39, 260, 41, 173, 330, 117, 330, 374, 264, 249, 108, 340, 359, 327, 114, 15, 189, 337, 216, 263, 300, 147, 266, 0, 301, 48, 249]"
260,24,4380,6877,4363,0,2801,1579,"[467, 88, 70, 369, 245, 128, 432, 6, 100, 432, 395, 436, 223, 387, 384, 471, 390, 64, 36, 63, 88, 401, 519, 0, 192, 193, 465]"
261,24,4293,1197,7459,0,4177,116,"[4, 12, 25, 31, 9, 11, 13, 27, 4, 31, 36, 35, 23, 31, 37, 9, 24, 21, 20, 36, 10, 18, 24, 0, 33, 10, 23]"
262,24,3121,1253,9327,0,2902,219,"[57, 39, 29, 41, 48, 56, 41, 10, 38, 19, 37, 6, 1, 27, 62, 47, 24, 53, 46, 71, 68, 3, 52, 0, 0, 19, 72]"
263,24,3467,5123,7671,0,10,3457,"[1042, 923, 739, 538, 170, 1119, 482, 927, 896, 812, 249, 583, 968, 561, 1023, 797, 288, 64, 340, 666, 686, 821, 565, 0, 296, 559, 705]"
264,24,3837,5916,5592,0,1949,1888,"[371, 373, 361, 31, 202, 225, 20, 469, 376, 532, 105, 122, 215, 194, 523, 97, 52, 15, 55, 501, 332, 588, 584, 0, 54, 521, 165]"
265,24,3522,2045,7069,0,3075,447,"[140, 43, 145, 133, 115, 13, 28, 7, 147, 20, 130, 91, 15, 149, 110, 134, 16, 30, 61, 103, 136, 84, 33, 0, 123, 125, 126]"
266,24,4587,6128,5528,0,2155,2432,"[777, 349, 726, 211, 514, 237, 177, 185, 423, 621, 336, 331, 284, 658, 452, 71, 367, 462, 27, 531, 496, 287, 720, 0, 533, 720, 485]"
267,24,3113,666,7975,0,61,3052,"[768, 240, 337, 467, 53, 272, 879, 701, 787, 311, 130, 610, 741, 355, 531, 626, 128, 336, 370, 377, 499, 510, 836, 0, 261, 366, 692]"
268,24,3918,5716,6177,0,1957,1961,"[86, 376, 186, 74, 642, 190, 151, 374, 69, 2, 62, 80, 218, 213, 427, 213, 401, 15, 87, 527, 365, 278, 607, 0, 336, 339, 209]"
269,24,4020,3191,7006,0,1890,2130,"[555, 278, 619, 6, 499, 677, 161, 366, 335, 549, 555, 392, 72, 154, 442, 292, 267, 599, 520, 454, 535, 191, 594, 0, 112, 558, 420]"
270,24,3490,459,10000,37,64,3426,"[177, 576, 981, 583, 404, 177, 747, 353, 846, 878, 339, 585, 930, 436, 948, 702, 554, 587, 209, 246, 213, 253, 562, 0, 1073, 534, 50]"
271,24,4310,5733,8577,0,3879,431,"[66, 39, 67, 2, 128, 79, 116, 55, 47, 53, 118, 138, 39, 137, 16, 26, 140, 53, 49, 121, 23, 119, 71, 0, 15, 102, 104]"
272,24,3549,5250,6876,0,792,2757,"[560, 332, 159, 439, 521, 670, 50, 124, 276, 271, 121, 740, 438, 549, 542, 887, 395, 372, 226, 119, 786, 760, 152, 0, 406, 336, 592]"
273,24,3016,638,9254,0,2335,681,"[193, 80, 215, 70, 81, 43, 187, 116, 98, 156, 107, 34, 81, 178, 150, 109, 55, 54, 96, 1, 177, 162, 98, 0, 122, 111, 224]"
274,24,4450,5094,8610,0,4090,360,"[17, 96, 15, 53, 38, 52, 114, 66, 19, 82, 8, 26, 61, 67, 9, 5, 17, 23, 12, 56, 102, 30, 75, 0, 56, 77, 53]"
275,24,3000,7118,4492,0,2537,463,"[65, 128, 86, 128, 11, 110, 68, 55, 49, 38, 134, 21, 138, 12, 6, 94, 6, 32, 32, 130, 119, 147, 18, 0, 62, 141, 96]"
276,24,3044,2477,5059,0,761,2283,"[85, 227, 587, 118, 554, 584, 163, 730, 5, 292, 140, 306, 511, 40, 53, 755, 118, 735, 667, 549, 471, 672, 650, 0, 646, 153, 723]"
277,24,4238,3396,5901,0,2202,2036,"[225, 478, 604, 498, 286, 678, 653, 382, 409, 552, 629, 614, 91, 349, 430, 57, 185, 68, 670, 260, 323, 375, 139, 0, 157, 160, 465]"
278,24,3196,551,8546,0,1232,1964,"[30, 366, 237, 298, 580, 264, 599, 335, 602, 486, 395, 362, 8, 488, 452, 141, 266, 478, 360, 86, 213, 482, 281, 0, 399, 463, 134]"
279,24,3019,5420,6145,0,1088,1931,"[459, 442, 360, 614, 574, 13, 377, 222, 415, 347, 233, 347, 556, 497, 270, 467, 470, 526, 260, 314, 215, 401, 436, 0, 268, 466, 603]"
280,24,4034,3148,7031,0,1064,2970,"[891, 215, 753, 877, 250, 197, 783, 966, 918, 542, 280, 583, 844, 820, 83, 208, 382, 760, 752, 681, 520, 417, 629, 0, 548, 931, 99]"
281,24,3473,48,10000,456,2533,940,"[263, 14, 10, 2, 162, 192, 283, 83, 58, 10, 117, 75, 12, 95, 108, 291, 280, 276, 69, 246, 93, 307, 181, 0, 245, 295, 187]"
282,24,4187,5401,8786,0,1807,2380,"[686, 223, 130, 673, 450, 362, 233, 328, 561, 377, 396, 622, 248, 117, 272, 267, 722, 526, 716, 339, 675, 770, 447, 0, 75, 681, 710]"
283,24,4679,6548,6917,0,1015,3664,"[377, 924, 1174, 103, 127, 306, 859, 306, 828, 85, 444, 839, 621, 598, 894, 219, 115, 188, 1119, 315, 790, 1199, 118, 0, 492, 438, 600]"
284,24,4820,7416,4321,0,69,4751,"[425, 1122, 1416, 1583, 504, 79, 1246, 1155, 1434, 544, 582, 148, 201, 512, 1571, 667, 1391, 581, 57, 636, 955, 670, 205, 0, 1402, 662, 402]"
285,24,3417,2441,5297,0,2811,606,"[37, 138, 91, 192, 127, 2, 171, 115, 28, 17, 200, 116, 196, 105, 109, 200, 195, 9, 59, 5, 109, 73, 95, 0, 55, 200, 123]"
286,24,3105,253,8149,0,350,2755,"[905, 11, 713, 65, 754, 275, 463, 752, 278, 172, 411, 608, 848, 442, 296, 187, 232, 599, 234, 736, 665, 101, 835, 0, 123, 676, 607]"
287,24,3122,6704,4567,0,568,2554,"[625, 99, 92, 218, 706, 464, 465, 509, 809, 584, 616, 65, 357, 835, 669, 224, 810, 29, 443, 84, 343, 370, 737, 0, 483, 736, 646]"
288,24,4741,4376,4932,0,2499,2242,"[107, 40, 529, 91, 711, 642, 406, 372, 248, 119, 313, 301, 96, 183, 158, 592, 313, 574, 385, 339, 598, 86, 446, 0, 430, 522, 223]"
289,24,4299,4237,4994,0,3148,1151,"[147, 128, 11, 3, 338, 248, 279, 133, 255, 251, 374, 181, 111, 130, 175, 195, 341, 227, 250, 82, 120, 216, 335, 0, 159, 365, 150]"
290,24,4513,2153,7354,0,557,3956,"[526, 477, 1022, 934, 933, 436, 1047, 979, 1276, 292, 392, 1291, 618, 1229, 760, 167, 232, 1193, 1091, 1168, 531, 1, 78, 0, 400, 660, 325]"
291,24,4404,5534,6224,0,2430,1974,"[449, 139, 306, 535, 512, 430, 219, 487, 314, 354, 636, 199, 379, 370, 372, 9, 557, 49, 552, 574, 216, 246, 308, 0, 297, 217, 285]"
292,24,3485,656,9053,0,3085,400,"[109, 91, 113, 16, 75, 41, 2, 16, 115, 81, 36, 116, 53, 75, 42, 2, 107, 84, 56, 113, 33, 82, 5, 0, 130, 74, 38]"
293,24,3711,5336,7428,0,659,3052,"[999, 726, 216, 873, 321, 160, 120, 618, 154, 163, 744, 238, 568, 695, 383, 649, 946, 79, 220, 831, 281, 925, 969, 0, 203, 23, 757]"
294,24,4908,6636,5700,0,3832,1076,"[164, 292, 288, 358, 304, 180, 173, 76, 300, 225, 223, 278, 161, 321, 125, 218, 192, 355, 18, 262, 56, 163, 309, 0, 195, 138, 278]"
295,24,4393,1312,8781,0,1888,2505,"[98, 406, 569, 768, 788, 733, 87, 231, 375, 497, 676, 496, 492, 655, 726, 395, 54, 165, 452, 85, 506, 739, 79, 0, 771, 33, 432]"
296,24,4736,6952,6565,0,1523,3213,"[109, 717, 271, 746, 738, 848, 437, 791, 870, 873, 564, 1069, 477, 832, 428, 485, 449, 573, 525, 6, 439, 583, 994, 0, 19, 130, 769]"
297,24,3488,801,9252,0,2647,841,"[107, 247, 59, 38, 80, 95, 65, 235, 176, 11, 206, 262, 129, 190, 135, 210, 83, 55, 157, 224, 129, 230, 174, 0, 276, 214, 18]"
298,24,4207,5214,8245,0,2548,1659,"[42, 153, 226, 198, 199, 98, 159, 409, 19, 504, 483, 476, 444, 31, 316, 441, 345, 548, 475, 478, 141, 320, 95, 0, 529, 413, 256]"
299,24,3698,5640,6303,0,2266,1432,"[212, 62, 297, 236, 56, 309, 184, 416, 174, 433, 99, 351, 202, 107, 231, 247, 389, 47, 163, 359, 344, 279, 119, 0, 249, 48, 2]"
0,25,89,0,89,0,54,35,"[2, 5, 0, 9, 1, 3, 1, 1, 0, 0, 7, 3, 2, 10, 5, 9, 2, 11, 6, 2, 10, 6, 1, 0, 4, 6, 8]"
1,25,43,2,130,0,30,13,"[1, 4, 0, 4, 2, 1, 1, 0, 3, 4, 4, 3, 1, 1, 1, 1, 1, 3, 3, 1, 4, 3, 0, 0, 4, 0, 3]"
2,25,39,29,140,0,10,29,"[1, 7, 1, 5, 4, 1, 8, 8, 9, 7, 8, 8, 2, 5, 8, 8, 8, 6, 4, 8, 5, 5, 5, 0, 7, 7, 7]"
3,25,53,40,153,0,18,35,"[0, 9, 11, 4, 10, 9, 6, 1, 9, 3, 5, 11, 10, 3, 6, 5, 4, 8, 5, 6, 11, 1, 0, 0, 11, 4, 9]"
4,25,46,39,160,0,27,19,"[4, 1, 3, 2, 5, 0, 6, 5, 5, 4, 3, 6, 0, 1, 4, 5, 0, 6, 4, 5, 1, 1, 4, 0, 6, 3, 3]"
5,25,86,36,210,0,11,75,"[11, 14, 11, 19, 22, 3, 13, 6, 19, 19, 5, 14, 1, 11, 14, 23, 3, 5, 19, 6, 3, 0, 12, 0, 4, 17, 19]"
6,25,90,44,256,0,33,57,"[5, 6, 0, 19, 17, 0, 11, 13, 13, 10, 1, 17, 4, 19, 14, 1, 4, 2, 5, 17, 19, 17, 5, 0, 12, 13, 4]"
7,25,65,61,260,0,59,6,"[1, 2, 1, 2, 0, 2, 2, 0, 0, 2, 2, 0, 1, 0, 1, 2, 1, 1, 1, 0, 2, 0, 2, 0, 0, 2, 2]"
8,25,62,32,290,0,60,2,"[0, 0, 0, 0, 0, 0, 0, 0, 0, 0, 0, 0, 0, 0, 0, 0, 0, 0, 0, 0, 0, 0, 0, 0, 0, 0, 0]"
9,25,94,59,325,0,50,44,"[10, 2, 0, 10, 3, 8, 0, 12, 0, 9, 2, 13, 7, 8, 4, 2, 3, 14, 11, 11, 14, 9, 10, 0, 10, 4, 9]"
10,25,51,47,329,0,25,26,"[4, 7, 0, 8, 1, 5, 5, 3, 8, 3, 3, 8, 4, 7, 4, 2, 2, 2, 2, 1, 2, 1, 7, 0, 5, 6, 2]"
11,25,69,33,365,0,57,12,"[3, 3, 3, 2, 4, 1, 3, 0, 2, 1, 0, 4, 1, 3, 3, 2, 1, 1, 2, 4, 0, 4, 1, 0, 2, 0, 3]"
12,25,86,32,419,0,50,36,"[1, 0, 7, 9, 8, 6, 11, 0, 4, 12, 3, 9, 12, 5, 10, 8, 0, 2, 4, 2, 3, 10, 2, 0, 4, 7, 4]"
13,25,78,71,426,0,27,51,"[14, 10, 14, 13, 5, 17, 8, 4, 15, 11, 8, 14, 5, 14, 11, 4, 4, 7, 16, 8, 0, 10, 2, 0, 15, 1, 11]"
14,25,68,6,488,0,22,46,"[0, 1, 0, 7, 12, 6, 11, 2, 11, 15, 1, 11, 5, 2, 15, 2, 4, 0, 2, 0, 7, 13, 3, 0, 0, 15, 5]"
15,25,17,5,500,0,3,14,"[1, 0, 0, 0, 1, 0, 0, 0, 3, 3, 0, 0, 0, 3, 4, 1, 0, 1, 4, 3, 3, 1, 2, 0, 4, 1, 1]"
16,25,91,74,517,0,80,11,"[2, 0, 2, 2, 3, 2, 3, 3, 0, 1, 2, 1, 3, 3, 1, 1, 2, 1, 1, 0, 3, 2, 3, 0, 3, 1, 3]"
17,25,52,10,559,0,15,37,"[0, 1, 2, 7, 3, 12, 3, 0, 3, 12, 12, 4, 2, 10, 8, 12, 4, 4, 2, 2, 10, 4, 8, 0, 4, 6, 3]"
18,25,3,0,562,0,0,3,"[0, 0, 1, 1, 1, 0, 1, 0, 1, 1, 1, 0, 0, 0, 1, 0, 1, 0, 1, 1, 0, 0, 0, 0, 1, 0, 0]"
19,25,70,23,609,0,18,52,"[2, 7, 12, 2, 12, 12, 7, 6, 7, 8, 0, 16, 6, 0, 6, 12, 7, 4, 3, 1, 7, 8, 9, 0, 5, 7, 0]"
20,25,12,11,610,0,2,10,"[0, 0, 1, 1, 1, 2, 3, 3, 0, 2, 1, 0, 2, 3, 2, 2, 0, 0, 0, 2, 1, 2, 1, 0, 2, 0, 2]"
21,25,5,2,613,0,1,4,"[0, 0, 0, 0, 0, 1, 0, 1, 1, 0, 1, 1, 0, 1, 0, 0, 0, 1, 0, 1, 0, 0, 0, 0, 0, 0, 0]"
22,25,71,33,651,0,70,1,"[0, 0, 0, 0, 0, 0, 0, 0, 0, 0, 0, 0, 0, 0, 0, 0, 0, 0, 0, 0, 0, 0, 0, 0, 0, 0, 0]"
23,25,62,21,692,0,4,58,"[17, 6, 2, 12, 2, 7, 17, 14, 8, 16, 8, 16, 6, 9, 6, 4, 12, 16, 0, 6, 8, 4, 8, 0, 14, 15, 9]"
24,25,82,41,733,0,62,20,"[0, 0, 5, 1, 1, 2, 3, 2, 2, 2, 6, 3, 2, 4, 5, 6, 1, 4, 3, 0, 5, 3, 1, 0, 6, 1, 0]"
25,25,54,52,735,0,26,28,"[0, 4, 0, 7, 8, 0, 0, 8, 6, 2, 2, 7, 2, 7, 2, 1, 3, 9, 1, 7, 6, 5, 5, 0, 7, 1, 9]"
26,25,33,10,758,0,0,33,"[5, 3, 10, 4, 2, 6, 4, 7, 10, 9, 9, 9, 5, 1, 7, 3, 0, 9, 10, 8, 5, 6, 1, 0, 2, 9, 10]"
27,25,84,4,838,0,68,16,"[5, 1, 1, 3, 1, 4, 2, 0, 3, 4, 0, 1, 5, 3, 4, 2, 5, 1, 2, 1, 5, 0, 0, 0, 5, 3, 2]"
28,25,23,8,853,0,16,7,"[2, 1, 2, 0, 1, 0, 0, 1, 2, 0, 2, 0, 2, 0, 0, 2, 2, 2, 2, 0, 1, 1, 2, 0, 2, 0, 1]"
29,25,97,69,881,0,19,78,"[20, 5, 17, 8, 0, 14, 14, 20, 25, 4, 1, 0, 25, 13, 21, 26, 25, 2, 23, 7, 15, 19, 3, 0, 1, 12, 22]"
30,25,42,26,897,0,16,26,"[1, 5, 8, 4, 4, 5, 3, 4, 0, 8, 3, 5, 5, 2, 4, 2, 8, 3, 7, 8, 3, 1, 8, 0, 5, 2, 5]"
31,25,55,0,952,0,52,3,"[1, 1, 1, 0, 1, 1, 0, 0, 1, 1, 1, 1, 1, 1, 0, 0, 0, 0, 1, 0, 1, 1, 0, 0, 0, 0, 1]"
32,25,30,24,958,0,19,11,"[0, 2, 0, 0, 3, 3, 3, 1, 1, 1, 0, 2, 0, 1, 1, 0, 1, 3, 1, 3, 0, 1, 1, 0, 2, 2, 3]"
33,25,4,3,959,0,3,1,"[0, 0, 0, 0, 0, 0, 0, 0, 0, 0, 0, 0, 0, 0, 0, 0, 0, 0, 0, 0, 0, 0, 0, 0, 0, 0, 0]"
34,25,22,11,970,0,9,13,"[2, 1, 1, 0, 4, 1, 0, 4, 1, 2, 1, 0, 4, 0, 1, 4, 3, 2, 1, 4, 3, 2, 2, 0, 4, 1, 4]"
35,25,65,33,1002,0,18,47,"[2, 8, 12, 6, 15, 5, 4, 1, 9, 0, 11, 3, 15, 9, 5, 3, 0, 12, 12, 4, 14, 9, 11, 0, 9, 7, 12]"
36,25,70,0,1072,0,50,20,"[3, 2, 5, 2, 2, 5, 6, 3, 3, 0, 2, 6, 0, 5, 4, 2, 6, 0, 0, 5, 5, 4, 1, 0, 5, 3, 2]"
37,25,63,4,1131,0,20,43,"[11, 5, 1, 1, 1, 12, 1, 6, 13, 3, 7, 0, 0, 2, 14, 5, 12, 7, 1, 8, 7, 7, 5, 0, 1, 10, 5]"
38,25,28,21,1138,0,20,8,"[1, 1, 0, 1, 0, 2, 1, 2, 1, 2, 1, 1, 2, 2, 2, 1, 2, 0, 1, 0, 0, 1, 2, 0, 1, 2, 2]"
39,25,29,21,1146,0,10,19,"[5, 4, 3, 5, 2, 5, 4, 6, 3, 1, 0, 3, 1, 5, 3, 2, 5, 2, 4, 1, 5, 2, 1, 0, 6, 3, 1]"
40,25,5,5,1146,0,1,4,"[1, 1, 1, 1, 0, 0, 0, 0, 1, 1, 0, 0, 1, 1, 1, 0, 0, 0, 0, 1, 1, 1, 1, 0, 0, 0, 1]"
41,25,20,0,1166,0,7,13,"[4, 3, 2, 0, 1, 0, 1, 2, 3, 2, 2, 1, 4, 3, 0, 0, 4, 0, 0, 1, 3, 2, 4, 0, 2, 3, 3]"
42,25,19,1,1184,0,12,7,"[1, 1, 1, 2, 2, 1, 2, 0, 1, 0, 2, 0, 2, 1, 2, 2, 2, 1, 1, 0, 2, 1, 0, 0, 2, 1, 1]"
43,25,92,36,1240,0,63,29,"[3, 1, 5, 9, 3, 7, 6, 7, 5, 2, 4, 7, 8, 4, 5, 5, 8, 3, 4, 1, 0, 3, 1, 0, 0, 0, 8]"
44,25,6,1,1245,0,6,0,"[0, 0, 0, 0, 0, 0, 0, 0, 0, 0, 0, 0, 0, 0, 0, 0, 0, 0, 0, 0, 0, 0, 0, 0, 0, 0, 0]"
45,25,27,19,1253,0,27,0,"[0, 0, 0, 0, 0, 0, 0, 0, 0, 0, 0, 0, 0, 0, 0, 0, 0, 0, 0, 0, 0, 0, 0, 0, 0, 0, 0]"
46,25,85,62,1276,0,5,80,"[5, 17, 20, 13, 10, 13, 21, 12, 3, 7, 9, 16, 14, 14, 4, 0, 3, 1, 14, 22, 20, 0, 11, 0, 0, 15, 8]"
47,25,48,11,1313,0,3,45,"[8, 12, 12, 13, 0, 6, 5, 15, 9, 1, 2, 13, 14, 7, 12, 5, 12, 4, 6, 15, 12, 9, 9, 0, 14, 10, 11]"
48,25,1,0,1277,0,0,1,"[0, 0, 0, 0, 0, 0, 0, 0, 0, 0, 0, 0, 0, 0, 0, 0, 0, 0, 0, 0, 0, 0, 0, 0, 0, 0, 0]"
49,25,90,83,1284,0,53,37,"[3, 4, 0, 3, 2, 12, 9, 5, 0, 6, 1, 2, 11, 11, 10, 3, 4, 11, 1, 0, 3, 10, 2, 0, 3, 12, 2]"
50,25,44,40,1288,0,28,16,"[5, 5, 4, 0, 3, 2, 4, 2, 4, 3, 4, 0, 0, 3, 3, 5, 2, 1, 0, 4, 3, 2, 1, 0, 5, 3, 2]"
51,25,68,14,1342,0,22,46,"[11, 1, 12, 15, 8, 14, 11, 7, 12, 7, 10, 4, 5, 1, 13, 6, 9, 10, 13, 10, 12, 15, 9, 0, 9, 4, 13]"
52,25,6,1,1347,0,2,4,"[1, 1, 1, 1, 1, 0, 0, 0, 1, 0, 0, 0, 1, 1, 1, 0, 0, 0, 0, 0, 1, 1, 1, 0, 0, 0, 1]"
53,25,80,64,1363,0,54,26,"[5, 5, 1, 0, 6, 1, 3, 0, 5, 8, 3, 8, 0, 1, 3, 0, 5, 3, 6, 1, 1, 6, 0, 0, 3, 1, 6]"
54,25,100,4,1459,0,18,82,"[10, 10, 1, 9, 26, 26, 17, 19, 10, 1, 6, 18, 9, 19, 21, 21, 26, 18, 11, 18, 20, 19, 6, 0, 6, 7, 7]"
55,25,48,45,1462,0,42,6,"[1, 2, 0, 2, 1, 1, 2, 0, 0, 2, 2, 0, 2, 2, 2, 0, 0, 2, 1, 2, 1, 2, 1, 0, 0, 0, 1]"
56,25,80,9,1533,0,60,20,"[5, 0, 5, 6, 0, 0, 0, 2, 5, 3, 2, 5, 0, 5, 0, 3, 0, 2, 3, 3, 2, 2, 5, 0, 1, 4, 6]"
57,25,86,56,1563,0,66,20,"[0, 3, 2, 2, 2, 1, 2, 1, 3, 3, 5, 3, 3, 6, 3, 3, 0, 3, 6, 1, 4, 5, 0, 0, 3, 1, 4]"
58,25,47,21,1589,0,36,11,"[3, 3, 3, 1, 1, 3, 2, 3, 3, 3, 1, 2, 2, 0, 1, 1, 0, 0, 0, 0, 3, 2, 2, 0, 1, 1, 3]"
59,25,86,40,1635,0,42,44,"[3, 13, 10, 0, 7, 2, 12, 10, 2, 4, 11, 14, 14, 4, 10, 1, 1, 11, 13, 0, 5, 1, 13, 0, 10, 12, 7]"
60,25,58,20,1673,0,23,35,"[10, 9, 9, 10, 6, 5, 10, 1, 10, 11, 4, 0, 4, 6, 2, 6, 1, 1, 9, 5, 1, 3, 9, 0, 3, 0, 7]"
61,25,62,32,1703,0,5,57,"[6, 14, 5, 16, 7, 0, 17, 19, 5, 7, 13, 18, 17, 16, 6, 11, 18, 8, 1, 16, 12, 19, 6, 0, 16, 8, 4]"
62,25,95,48,1750,0,7,88,"[10, 8, 26, 9, 27, 10, 3, 19, 29, 13, 24, 10, 25, 24, 19, 1, 15, 23, 23, 4, 13, 15, 3, 0, 0, 26, 16]"
63,25,48,37,1761,0,36,12,"[1, 2, 3, 3, 4, 2, 1, 4, 0, 0, 1, 4, 2, 1, 3, 0, 0, 0, 3, 0, 2, 0, 2, 0, 0, 2, 0]"
64,25,2,2,1761,0,2,0,"[0, 0, 0, 0, 0, 0, 0, 0, 0, 0, 0, 0, 0, 0, 0, 0, 0, 0, 0, 0, 0, 0, 0, 0, 0, 0, 0]"
65,25,80,79,1762,0,71,9,"[1, 0, 3, 1, 3, 0, 3, 1, 3, 0, 0, 2, 1, 2, 3, 2, 0, 3, 2, 0, 2, 3, 3, 0, 0, 2, 2]"
66,25,79,63,1778,0,72,7,"[0, 1, 2, 1, 2, 2, 2, 1, 2, 1, 1, 2, 2, 0, 1, 0, 1, 2, 1, 2, 0, 0, 0, 0, 2, 2, 1]"
67,25,34,21,1791,0,34,0,"[0, 0, 0, 0, 0, 0, 0, 0, 0, 0, 0, 0, 0, 0, 0, 0, 0, 0, 0, 0, 0, 0, 0, 0, 0, 0, 0]"
68,25,25,17,1799,0,24,1,"[0, 0, 0, 0, 0, 0, 0, 0, 0, 0, 0, 0, 0, 0, 0, 0, 0, 0, 0, 0, 0, 0, 0, 0, 0, 0, 0]"
69,25,16,13,1802,0,5,11,"[3, 1, 3, 0, 0, 1, 1, 0, 3, 1, 3, 2, 2, 1, 1, 3, 1, 0, 3, 1, 0, 0, 1, 0, 1, 0, 0]"
70,25,27,1,1828,0,5,22,"[5, 5, 0, 0, 3, 2, 7, 4, 2, 3, 3, 3, 5, 7, 0, 3, 5, 7, 4, 5, 0, 2, 0, 0, 2, 3, 4]"
71,25,90,78,1840,0,80,10,"[2, 1, 1, 1, 0, 0, 3, 0, 0, 0, 3, 1, 1, 0, 1, 3, 1, 1, 2, 1, 3, 1, 1, 0, 1, 0, 1]"
72,25,45,45,1840,0,43,2,"[0, 0, 0, 0, 0, 0, 0, 0, 0, 0, 0, 0, 0, 0, 0, 0, 0, 0, 0, 0, 0, 0, 0, 0, 0, 0, 0]"
73,25,81,63,1858,0,65,16,"[3, 2, 0, 2, 4, 4, 5, 0, 1, 2, 4, 2, 3, 4, 1, 0, 1, 1, 1, 5, 5, 3, 1, 0, 1, 5, 0]"
74,25,37,30,1865,0,26,11,"[0, 3, 3, 3, 3, 2, 0, 3, 1, 3, 3, 1, 3, 2, 1, 1, 3, 1, 3, 1, 1, 3, 2, 0, 0, 3, 3]"
75,25,16,16,1865,0,16,0,"[0, 0, 0, 0, 0, 0, 0, 0, 0, 0, 0, 0, 0, 0, 0, 0, 0, 0, 0, 0, 0, 0, 0, 0, 0, 0, 0]"
76,25,15,10,1870,0,1,14,"[4, 0, 3, 4, 1, 0, 4, 3, 3, 4, 4, 3, 0, 2, 2, 2, 0, 0, 1, 1, 0, 1, 1, 0, 2, 4, 4]"
77,25,24,16,1878,0,24,0,"[0, 0, 0, 0, 0, 0, 0, 0, 0, 0, 0, 0, 0, 0, 0, 0, 0, 0, 0, 0, 0, 0, 0, 0, 0, 0, 0]"
78,25,56,13,1921,0,13,43,"[3, 11, 3, 14, 0, 4, 8, 11, 6, 11, 3, 11, 4, 10, 9, 3, 7, 4, 0, 8, 3, 9, 6, 0, 9, 8, 10]"
79,25,73,58,1936,0,25,48,"[15, 11, 15, 8, 6, 8, 14, 16, 5, 5, 13, 10, 7, 7, 12, 7, 1, 12, 15, 1, 15, 13, 4, 0, 2, 0, 14]"
80,25,81,51,1966,0,62,19,"[4, 3, 5, 3, 4, 3, 1, 6, 3, 0, 1, 4, 1, 4, 0, 3, 5, 2, 0, 4, 6, 4, 4, 0, 6, 6, 3]"
81,25,29,24,1971,0,21,8,"[2, 1, 0, 2, 2, 0, 2, 2, 0, 0, 2, 0, 1, 0, 2, 1, 0, 2, 0, 0, 2, 0, 2, 0, 1, 2, 1]"
82,25,65,4,2032,0,50,15,"[3, 5, 1, 3, 4, 3, 4, 1, 0, 0, 1, 0, 1, 2, 2, 4, 3, 0, 3, 2, 3, 1, 0, 0, 5, 5, 4]"
83,25,72,7,2097,0,51,21,"[3, 2, 7, 7, 2, 0, 5, 6, 7, 1, 5, 1, 5, 6, 1, 6, 2, 0, 4, 3, 6, 5, 5, 0, 6, 4, 2]"
84,25,14,13,2098,0,5,9,"[1, 0, 0, 2, 3, 0, 1, 1, 1, 1, 3, 1, 0, 2, 2, 2, 2, 0, 2, 1, 2, 3, 3, 0, 3, 2, 2]"
85,25,64,7,2155,0,4,60,"[17, 18, 16, 13, 19, 20, 19, 5, 3, 8, 18, 1, 11, 15, 10, 11, 2, 15, 7, 3, 8, 0, 0, 0, 15, 10, 1]"
86,25,69,25,2199,0,63,6,"[1, 2, 0, 2, 1, 2, 2, 2, 1, 0, 2, 1, 2, 1, 0, 2, 0, 0, 2, 2, 1, 2, 0, 0, 2, 0, 1]"
87,25,25,15,2209,0,24,1,"[0, 0, 0, 0, 0, 0, 0, 0, 0, 0, 0, 0, 0, 0, 0, 0, 0, 0, 0, 0, 0, 0, 0, 0, 0, 0, 0]"
88,25,57,16,2250,0,18,39,"[2, 8, 10, 9, 12, 1, 10, 5, 4, 3, 2, 1, 5, 5, 8, 11, 6, 7, 5, 9, 4, 13, 10, 0, 8, 0, 2]"
89,25,75,66,2259,0,59,16,"[0, 5, 2, 3, 2, 0, 5, 0, 4, 5, 1, 0, 1, 2, 0, 4, 3, 2, 3, 4, 2, 4, 4, 0, 4, 5, 5]"
90,25,7,3,2263,0,2,5,"[0, 1, 1, 0, 1, 0, 1, 1, 1, 0, 0, 1, 0, 1, 1, 0, 1, 0, 0, 1, 0, 0, 0, 0, 0, 0, 0]"
91,25,83,4,2342,0,35,48,"[10, 7, 11, 10, 14, 11, 2, 11, 0, 11, 0, 1, 3, 11, 15, 3, 1, 10, 14, 6, 7, 9, 13, 0, 13, 6, 2]"
92,25,7,4,2345,0,6,1,"[0, 0, 0, 0, 0, 0, 0, 0, 0, 0, 0, 0, 0, 0, 0, 0, 0, 0, 0, 0, 0, 0, 0, 0, 0, 0, 0]"
93,25,61,14,2392,0,22,39,"[10, 8, 12, 2, 12, 12, 6, 5, 5, 12, 7, 13, 10, 13, 11, 7, 13, 1, 8, 4, 6, 4, 10, 0, 7, 7, 7]"
94,25,50,26,2416,0,40,10,"[1, 2, 0, 3, 3, 0, 2, 3, 2, 0, 2, 2, 1, 0, 1, 0, 2, 2, 2, 2, 3, 0, 2, 0, 2, 1, 3]"
95,25,56,26,2446,0,27,29,"[1, 3, 3, 3, 1, 3, 9, 0, 3, 6, 9, 8, 9, 2, 0, 7, 6, 8, 9, 8, 4, 5, 8, 0, 1, 2, 8]"
96,25,92,86,2452,0,27,65,"[3, 11, 14, 6, 1, 6, 18, 2, 6, 10, 3, 0, 12, 14, 2, 21, 16, 6, 17, 4, 1, 10, 6, 0, 5, 10, 18]"
97,25,17,3,2466,0,0,17,"[2, 2, 4, 5, 0, 0, 5, 0, 3, 4, 5, 1, 0, 1, 5, 1, 1, 3, 5, 1, 2, 1, 5, 0, 2, 1, 4]"
98,25,19,6,2479,0,10,9,"[0, 1, 1, 2, 3, 0, 1, 2, 2, 1, 3, 3, 0, 2, 1, 2, 1, 2, 2, 1, 3, 1, 0, 0, 2, 3, 0]"
99,25,57,52,2484,0,43,14,"[2, 0, 3, 4, 0, 4, 4, 0, 2, 0, 1, 0, 3, 2, 4, 4, 3, 4, 4, 2, 4, 2, 3, 0, 1, 3, 2]"
100,25,6,1,2489,0,0,6,"[2, 2, 1, 0, 2, 0, 1, 2, 2, 1, 0, 1, 0, 0, 1, 0, 2, 2, 0, 2, 1, 0, 0, 0, 2, 0, 1]"
101,25,93,27,2555,0,77,16,"[4, 0, 2, 4, 0, 3, 5, 2, 2, 0, 1, 4, 2, 4, 3, 1, 0, 2, 4, 3, 1, 1, 0, 0, 3, 2, 3]"
102,25,84,24,2615,0,48,36,"[1, 3, 4, 4, 2, 5, 8, 8, 12, 8, 9, 6, 3, 3, 5, 2, 9, 2, 6, 9, 12, 5, 11, 0, 11, 11, 7]"
103,25,29,6,2638,0,15,14,"[4, 3, 0, 2, 1, 4, 0, 3, 1, 1, 2, 3, 4, 2, 4, 4, 1, 0, 2, 1, 2, 3, 2, 0, 3, 0, 1]"
104,25,87,9,2716,0,7,80,"[14, 4, 15, 15, 23, 22, 1, 23, 24, 21, 16, 8, 12, 23, 19, 10, 1, 20, 13, 8, 3, 13, 11, 0, 4, 9, 26]"
105,25,79,18,2777,0,3,76,"[21, 18, 14, 7, 5, 13, 23, 17, 17, 23, 22, 22, 13, 4, 5, 14, 23, 23, 22, 6, 4, 5, 4, 0, 5, 20, 23]"
106,25,18,14,2781,0,3,15,"[0, 1, 1, 4, 3, 1, 0, 0, 0, 5, 5, 3, 0, 2, 3, 3, 2, 2, 4, 2, 2, 0, 3, 0, 3, 1, 0]"
107,25,29,22,2788,0,21,8,"[0, 1, 0, 2, 2, 2, 1, 1, 1, 2, 1, 1, 1, 1, 2, 0, 0, 0, 0, 2, 0, 2, 2, 0, 2, 0, 2]"
108,25,38,38,2788,0,30,8,"[1, 2, 1, 0, 0, 2, 1, 0, 1, 0, 1, 0, 1, 2, 1, 0, 1, 0, 2, 1, 0, 2, 2, 0, 2, 0, 0]"
109,25,74,5,2857,0,30,44,"[10, 3, 2, 14, 6, 12, 6, 13, 12, 3, 7, 10, 11, 14, 7, 3, 0, 4, 14, 2, 7, 4, 10, 0, 5, 6, 8]"
110,25,46,41,2862,0,42,4,"[1, 1, 0, 0, 1, 0, 1, 1, 1, 0, 1, 1, 1, 0, 1, 0, 1, 1, 0, 1, 1, 1, 1, 0, 0, 0, 1]"
111,25,21,4,2879,0,19,2,"[0, 0, 0, 0, 0, 0, 0, 0, 0, 0, 0, 0, 0, 0, 0, 0, 0, 0, 0, 0, 0, 0, 0, 0, 0, 0, 0]"
112,25,72,56,2895,0,17,55,"[14, 15, 13, 11, 17, 1, 12, 10, 11, 7, 0, 6, 13, 1, 15, 3, 7, 14, 0, 18, 12, 16, 13, 0, 5, 5, 8]"
113,25,8,8,2895,0,4,4,"[0, 0, 1, 0, 0, 1, 1, 0, 1, 0, 1, 0, 1, 1, 1, 0, 0, 1, 1, 0, 1, 0, 0, 0, 1, 1, 0]"
114,25,87,46,2936,0,31,56,"[17, 14, 10, 13, 14, 17, 15, 13, 4, 13, 11, 16, 13, 0, 9, 11, 7, 8, 4, 10, 14, 11, 3, 0, 2, 0, 8]"
115,25,30,27,2939,0,29,1,"[0, 0, 0, 0, 0, 0, 0, 0, 0, 0, 0, 0, 0, 0, 0, 0, 0, 0, 0, 0, 0, 0, 0, 0, 0, 0, 0]"
116,25,53,6,2986,0,21,32,"[8, 6, 2, 6, 0, 0, 5, 0, 9, 3, 1, 6, 9, 0, 4, 3, 10, 0, 8, 0, 1, 5, 1, 0, 0, 3, 7]"
117,25,96,19,3063,0,35,61,"[12, 12, 7, 19, 12, 3, 16, 15, 11, 4, 3, 5, 17, 14, 11, 13, 8, 4, 5, 2, 6, 9, 7, 0, 4, 9, 11]"
118,25,42,2,3103,0,27,15,"[5, 1, 3, 1, 0, 2, 1, 3, 5, 4, 2, 4, 5, 1, 1, 3, 4, 4, 1, 2, 5, 5, 1, 0, 5, 2, 2]"
119,25,86,48,3141,0,71,15,"[4, 4, 2, 2, 4, 5, 1, 2, 0, 4, 2, 2, 0, 4, 5, 3, 1, 1, 5, 0, 2, 4, 4, 0, 3, 3, 5]"
120,25,62,26,3177,0,1,61,"[19, 20, 13, 18, 20, 5, 18, 11, 17, 16, 9, 1, 12, 1, 0, 1, 15, 20, 9, 18, 20, 9, 0, 0, 3, 10, 20]"
121,25,34,8,3203,0,32,2,"[0, 0, 0, 0, 0, 0, 0, 0, 0, 0, 0, 0, 0, 0, 0, 0, 0, 0, 0, 0, 0, 0, 0, 0, 0, 0, 0]"
122,25,88,34,3257,0,56,32,"[0, 3, 7, 3, 6, 10, 10, 6, 1, 10, 5, 0, 10, 2, 10, 0, 5, 2, 9, 10, 8, 3, 1, 0, 8, 6, 10]"
123,25,93,42,3308,0,48,45,"[12, 12, 2, 3, 3, 4, 5, 4, 13, 4, 1, 14, 0, 5, 6, 11, 2, 1, 8, 14, 2, 4, 11, 0, 1, 12, 2]"
124,25,96,58,3346,0,85,11,"[0, 2, 1, 3, 3, 1, 1, 1, 2, 3, 3, 3, 1, 0, 0, 2, 2, 3, 0, 3, 1, 0, 1, 0, 3, 1, 2]"
125,25,20,14,3352,0,10,10,"[2, 0, 0, 1, 2, 2, 0, 1, 1, 0, 3, 1, 2, 2, 1, 0, 2, 0, 0, 0, 1, 3, 1, 0, 2, 3, 0]"
126,25,84,0,3436,0,36,48,"[6, 8, 2, 2, 15, 5, 4, 4, 11, 4, 1, 16, 4, 14, 10, 9, 6, 9, 3, 3, 2, 3, 1, 0, 1, 7, 7]"
127,25,79,47,3468,0,67,12,"[2, 2, 3, 1, 3, 1, 0, 4, 3, 4, 1, 0, 1, 1, 3, 0, 3, 0, 3, 3, 2, 2, 3, 0, 4, 3, 1]"
128,25,13,7,3474,0,10,3,"[1, 0, 0, 0, 1, 0, 0, 0, 1, 0, 1, 1, 0, 1, 0, 1, 0, 0, 0, 0, 1, 0, 1, 0, 1, 0, 1]"
129,25,27,27,3474,0,25,2,"[0, 0, 0, 0, 0, 0, 0, 0, 0, 0, 0, 0, 0, 0, 0, 0, 0, 0, 0, 0, 0, 0, 0, 0, 0, 0, 0]"
130,25,14,0,3488,0,14,0,"[0, 0, 0, 0, 0, 0, 0, 0, 0, 0, 0, 0, 0, 0, 0, 0, 0, 0, 0, 0, 0, 0, 0, 0, 0, 0, 0]"
131,25,38,5,3521,0,37,1,"[0, 0, 0, 0, 0, 0, 0, 0, 0, 0, 0, 0, 0, 0, 0, 0, 0, 0, 0, 0, 0, 0, 0, 0, 0, 0, 0]"
132,25,8,3,3526,0,6,2,"[0, 0, 0, 0, 0, 0, 0, 0, 0, 0, 0, 0, 0, 0, 0, 0, 0, 0, 0, 0, 0, 0, 0, 0, 0, 0, 0]"
133,25,7,1,3532,0,2,5,"[1, 1, 1, 1, 0, 1, 1, 0, 1, 0, 0, 0, 0, 0, 1, 1, 1, 1, 1, 1, 1, 0, 1, 0, 0, 0, 1]"
134,25,38,31,3539,0,37,1,"[0, 0, 0, 0, 0, 0, 0, 0, 0, 0, 0, 0, 0, 0, 0, 0, 0, 0, 0, 0, 0, 0, 0, 0, 0, 0, 0]"
135,25,40,4,3575,0,31,9,"[1, 1, 3, 2, 0, 1, 3, 2, 0, 2, 0, 0, 2, 1, 2, 3, 0, 0, 0, 3, 0, 1, 0, 0, 0, 0, 0]"
136,25,0,0,3575,0,0,0,"[0, 0, 0, 0, 0, 0, 0, 0, 0, 0, 0, 0, 0, 0, 0, 0, 0, 0, 0, 0, 0, 0, 0, 0, 0, 0, 0]"
137,25,64,15,3624,0,1,63,"[2, 7, 5, 5, 14, 19, 2, 0, 0, 10, 18, 20, 20, 20, 10, 20, 6, 10, 4, 16, 8, 3, 12, 0, 1, 17, 9]"
138,25,41,13,3652,0,16,25,"[2, 1, 7, 2, 2, 3, 8, 2, 1, 7, 7, 6, 1, 3, 6, 7, 8, 4, 8, 8, 6, 6, 6, 0, 5, 3, 6]"
139,25,20,3,3669,0,9,11,"[2, 2, 0, 1, 3, 0, 0, 1, 3, 3, 1, 2, 3, 2, 1, 3, 3, 3, 3, 3, 2, 1, 3, 0, 1, 0, 0]"
140,25,69,22,3716,0,4,65,"[2, 17, 6, 19, 11, 1, 13, 19, 4, 5, 14, 16, 21, 21, 4, 1, 19, 12, 14, 7, 19, 6, 3, 0, 5, 6, 14]"
141,25,44,19,3741,0,19,25,"[2, 5, 3, 2, 8, 0, 1, 7, 7, 7, 5, 1, 8, 6, 6, 1, 1, 8, 8, 2, 8, 7, 6, 0, 7, 2, 3]"
142,25,23,2,3762,0,13,10,"[0, 3, 0, 1, 1, 1, 3, 2, 1, 0, 1, 3, 2, 2, 1, 0, 1, 2, 1, 0, 1, 2, 2, 0, 3, 3, 0]"
143,25,31,0,3793,0,30,1,"[0, 0, 0, 0, 0, 0, 0, 0, 0, 0, 0, 0, 0, 0, 0, 0, 0, 0, 0, 0, 0, 0, 0, 0, 0, 0, 0]"
144,25,41,15,3819,0,39,2,"[0, 0, 0, 0, 0, 0, 0, 0, 0, 0, 0, 0, 0, 0, 0, 0, 0, 0, 0, 0, 0, 0, 0, 0, 0, 0, 0]"
145,25,34,0,3853,0,23,11,"[1, 3, 1, 0, 1, 0, 2, 0, 1, 3, 1, 1, 0, 0, 3, 2, 0, 2, 1, 1, 0, 1, 2, 0, 2, 2, 2]"
146,25,6,5,3854,0,5,1,"[0, 0, 0, 0, 0, 0, 0, 0, 0, 0, 0, 0, 0, 0, 0, 0, 0, 0, 0, 0, 0, 0, 0, 0, 0, 0, 0]"
147,25,30,7,3877,0,20,10,"[3, 2, 3, 3, 0, 2, 2, 1, 0, 0, 1, 2, 1, 2, 0, 2, 3, 1, 0, 1, 1, 0, 2, 0, 0, 0, 2]"
148,25,100,77,3900,0,68,32,"[3, 8, 6, 3, 7, 9, 10, 5, 10, 5, 6, 2, 2, 1, 9, 2, 10, 4, 3, 4, 4, 7, 0, 0, 1, 3, 0]"
149,25,63,37,3926,0,2,61,"[13, 15, 17, 12, 5, 18, 17, 7, 18, 9, 20, 20, 18, 12, 14, 19, 4, 8, 17, 5, 20, 5, 5, 0, 0, 0, 4]"
150,25,1,0,3901,0,0,1,"[0, 0, 0, 0, 0, 0, 0, 0, 0, 0, 0, 0, 0, 0, 0, 0, 0, 0, 0, 0, 0, 0, 0, 0, 0, 0, 0]"
151,25,2,0,3903,0,1,1,"[0, 0, 0, 0, 0, 0, 0, 0, 0, 0, 0, 0, 0, 0, 0, 0, 0, 0, 0, 0, 0, 0, 0, 0, 0, 0, 0]"
152,25,97,67,3933,0,20,77,"[1, 24, 20, 16, 5, 20, 14, 11, 6, 3, 12, 16, 11, 4, 8, 17, 10, 24, 5, 1, 20, 19, 21, 0, 14, 4, 16]"
153,25,27,13,3947,0,2,25,"[7, 5, 4, 0, 1, 4, 6, 2, 2, 8, 6, 7, 1, 0, 1, 3, 7, 8, 7, 4, 6, 6, 7, 0, 8, 0, 3]"
154,25,35,14,3968,0,19,16,"[3, 5, 5, 5, 3, 1, 0, 2, 0, 5, 3, 1, 0, 3, 5, 3, 3, 1, 2, 2, 2, 3, 0, 0, 5, 2, 4]"
155,25,48,23,3993,0,23,25,"[4, 3, 2, 5, 2, 1, 6, 0, 4, 8, 7, 2, 0, 8, 3, 1, 7, 3, 5, 5, 5, 6, 0, 0, 6, 0, 6]"
156,25,31,2,4022,0,19,12,"[3, 3, 3, 2, 3, 0, 0, 0, 0, 3, 3, 4, 0, 1, 3, 1, 0, 2, 1, 1, 2, 3, 4, 0, 4, 0, 2]"
157,25,19,16,4025,0,3,16,"[3, 1, 2, 5, 4, 1, 0, 5, 3, 2, 0, 0, 4, 2, 5, 1, 1, 3, 2, 0, 1, 5, 1, 0, 4, 5, 1]"
158,25,45,24,4046,0,25,20,"[5, 2, 1, 0, 6, 1, 1, 3, 4, 1, 5, 2, 4, 4, 4, 1, 3, 1, 3, 2, 6, 0, 3, 0, 5, 0, 2]"
159,25,2,2,4046,0,0,2,"[0, 0, 0, 0, 0, 0, 0, 0, 0, 0, 0, 0, 0, 0, 0, 0, 0, 0, 0, 0, 0, 0, 0, 0, 0, 0, 0]"
160,25,46,13,4079,0,38,8,"[0, 1, 1, 0, 1, 0, 1, 1, 0, 1, 2, 0, 0, 0, 2, 1, 0, 1, 1, 1, 1, 0, 1, 0, 2, 2, 2]"
161,25,40,38,4081,0,20,20,"[5, 6, 6, 0, 5, 3, 0, 4, 5, 6, 1, 4, 4, 0, 1, 1, 4, 1, 5, 4, 5, 0, 6, 0, 1, 2, 6]"
162,25,67,22,4126,0,60,7,"[1, 1, 2, 2, 2, 2, 1, 1, 0, 0, 0, 2, 2, 0, 2, 0, 1, 0, 2, 2, 1, 0, 2, 0, 1, 2, 0]"
163,25,60,26,4160,0,8,52,"[10, 12, 5, 15, 7, 15, 14, 3, 13, 17, 5, 0, 6, 7, 2, 14, 10, 14, 15, 15, 7, 16, 4, 0, 12, 5, 11]"
164,25,47,29,4178,0,17,30,"[6, 3, 10, 0, 4, 0, 7, 0, 6, 0, 0, 1, 7, 5, 0, 2, 5, 2, 0, 1, 4, 4, 5, 0, 10, 3, 1]"
165,25,80,45,4213,0,17,63,"[20, 10, 21, 3, 7, 18, 11, 12, 11, 9, 17, 4, 5, 14, 9, 13, 10, 14, 17, 5, 21, 12, 8, 0, 9, 8, 0]"
166,25,44,9,4248,0,7,37,"[10, 12, 4, 10, 11, 1, 5, 0, 4, 11, 3, 10, 7, 8, 7, 3, 1, 12, 12, 8, 2, 3, 1, 0, 6, 0, 6]"
167,25,49,10,4287,0,20,29,"[3, 4, 9, 3, 7, 3, 0, 0, 8, 7, 3, 6, 4, 0, 9, 6, 5, 7, 3, 1, 5, 1, 5, 0, 0, 8, 8]"
168,25,7,2,4292,0,7,0,"[0, 0, 0, 0, 0, 0, 0, 0, 0, 0, 0, 0, 0, 0, 0, 0, 0, 0, 0, 0, 0, 0, 0, 0, 0, 0, 0]"
169,25,7,5,4294,0,2,5,"[0, 0, 0, 1, 0, 0, 1, 1, 0, 1, 0, 0, 0, 0, 1, 0, 1, 0, 0, 1, 0, 0, 0, 0, 1, 1, 0]"
170,25,68,48,4314,0,34,34,"[8, 7, 6, 9, 7, 0, 10, 10, 7, 5, 2, 4, 8, 10, 2, 6, 9, 7, 2, 6, 4, 3, 10, 0, 1, 0, 8]"
171,25,37,9,4342,0,8,29,"[1, 5, 3, 5, 7, 0, 9, 4, 4, 4, 4, 6, 6, 8, 9, 2, 4, 3, 7, 6, 4, 4, 1, 0, 9, 4, 8]"
172,25,96,92,4346,0,35,61,"[12, 11, 4, 8, 13, 8, 15, 1, 5, 5, 17, 18, 10, 0, 12, 5, 3, 16, 4, 19, 9, 4, 18, 0, 1, 3, 6]"
173,25,46,14,4378,0,26,20,"[0, 3, 5, 6, 2, 5, 4, 4, 6, 6, 0, 0, 2, 0, 3, 0, 0, 6, 1, 0, 0, 1, 0, 0, 0, 2, 5]"
174,25,21,10,4389,0,13,8,"[1, 0, 0, 1, 2, 1, 1, 0, 0, 2, 2, 1, 0, 2, 1, 0, 2, 2, 0, 0, 2, 0, 2, 0, 0, 2, 2]"
175,25,32,14,4407,0,17,15,"[1, 3, 4, 0, 1, 0, 5, 2, 5, 5, 5, 4, 3, 5, 1, 5, 3, 1, 1, 2, 2, 5, 1, 0, 0, 1, 0]"
176,25,42,10,4439,0,22,20,"[1, 2, 6, 2, 1, 5, 5, 1, 0, 3, 4, 3, 4, 1, 6, 3, 2, 0, 4, 5, 0, 2, 4, 0, 6, 1, 0]"
177,25,64,49,4454,0,23,41,"[1, 4, 4, 7, 7, 9, 3, 13, 5, 11, 0, 5, 3, 2, 0, 10, 1, 9, 2, 9, 1, 4, 4, 0, 1, 6, 0]"
178,25,32,14,4472,0,3,29,"[5, 0, 6, 4, 3, 7, 1, 7, 7, 0, 3, 9, 2, 7, 3, 1, 4, 6, 9, 7, 3, 5, 9, 0, 4, 8, 0]"
179,25,80,32,4520,0,3,77,"[8, 10, 4, 10, 2, 13, 18, 23, 22, 22, 14, 18, 13, 3, 14, 20, 3, 21, 9, 15, 25, 3, 5, 0, 14, 6, 1]"
180,25,46,21,4545,0,45,1,"[0, 0, 0, 0, 0, 0, 0, 0, 0, 0, 0, 0, 0, 0, 0, 0, 0, 0, 0, 0, 0, 0, 0, 0, 0, 0, 0]"
181,25,55,10,4590,0,17,38,"[9, 7, 9, 6, 12, 12, 5, 9, 3, 11, 2, 7, 4, 7, 8, 12, 1, 6, 10, 8, 2, 1, 8, 0, 5, 8, 1]"
182,25,36,0,4626,0,3,33,"[11, 9, 9, 0, 6, 1, 10, 5, 7, 6, 11, 7, 0, 10, 8, 8, 1, 3, 9, 11, 8, 0, 2, 0, 11, 7, 4]"
183,25,15,3,4638,0,8,7,"[2, 0, 0, 2, 1, 2, 1, 2, 0, 1, 0, 2, 2, 1, 1, 1, 1, 1, 0, 0, 2, 0, 2, 0, 0, 1, 2]"
184,25,50,15,4673,0,21,29,"[7, 1, 0, 5, 1, 6, 1, 9, 9, 2, 3, 4, 0, 3, 2, 0, 3, 4, 0, 7, 7, 0, 8, 0, 5, 4, 6]"
185,25,70,65,4678,0,49,21,"[3, 1, 3, 5, 1, 0, 6, 7, 6, 6, 0, 7, 0, 1, 4, 7, 2, 7, 5, 1, 1, 3, 4, 0, 3, 2, 7]"
186,25,26,22,4682,0,14,12,"[2, 3, 3, 3, 2, 1, 1, 2, 1, 2, 0, 1, 0, 0, 1, 3, 2, 4, 1, 1, 4, 1, 1, 0, 1, 0, 0]"
187,25,43,28,4697,0,30,13,"[1, 4, 2, 4, 2, 4, 3, 4, 3, 3, 2, 0, 4, 1, 2, 2, 1, 0, 0, 1, 0, 3, 1, 0, 2, 3, 1]"
188,25,51,51,4697,0,9,42,"[1, 14, 10, 12, 14, 3, 6, 4, 0, 14, 8, 2, 9, 3, 8, 9, 7, 3, 10, 13, 12, 6, 9, 0, 8, 10, 10]"
189,25,58,10,4745,0,9,49,"[15, 7, 6, 1, 1, 6, 1, 0, 2, 1, 9, 13, 1, 12, 12, 12, 11, 15, 9, 15, 9, 6, 11, 0, 1, 10, 10]"
190,25,69,63,4751,0,63,6,"[0, 2, 2, 1, 2, 0, 1, 1, 2, 1, 0, 2, 1, 1, 2, 1, 2, 0, 2, 1, 0, 0, 1, 0, 1, 1, 1]"
191,25,53,52,4752,0,37,16,"[3, 5, 0, 4, 5, 1, 4, 2, 3, 5, 5, 3, 3, 1, 0, 0, 3, 4, 3, 1, 3, 5, 4, 0, 1, 2, 1]"
192,25,79,34,4797,0,60,19,"[6, 1, 5, 6, 3, 1, 1, 0, 5, 1, 1, 2, 2, 6, 6, 4, 5, 5, 2, 2, 4, 0, 6, 0, 4, 1, 2]"
193,25,53,35,4815,0,46,7,"[1, 0, 1, 1, 2, 0, 2, 2, 0, 2, 0, 0, 2, 0, 2, 1, 1, 2, 0, 0, 2, 2, 0, 0, 1, 2, 1]"
194,25,87,66,4836,0,56,31,"[0, 9, 10, 2, 3, 5, 9, 0, 9, 9, 6, 7, 1, 3, 2, 0, 2, 0, 0, 4, 1, 10, 7, 0, 1, 4, 9]"
195,25,25,7,4854,0,23,2,"[0, 0, 0, 0, 0, 0, 0, 0, 0, 0, 0, 0, 0, 0, 0, 0, 0, 0, 0, 0, 0, 0, 0, 0, 0, 0, 0]"
196,25,29,18,4865,0,23,6,"[1, 1, 0, 0, 1, 0, 1, 0, 1, 0, 1, 2, 0, 0, 1, 2, 1, 2, 0, 2, 2, 0, 1, 0, 0, 1, 1]"
197,25,14,10,4869,0,11,3,"[0, 0, 0, 1, 0, 1, 1, 0, 1, 0, 0, 0, 1, 0, 1, 0, 1, 0, 1, 0, 0, 0, 1, 0, 1, 0, 1]"
198,25,44,5,4908,0,12,32,"[0, 3, 0, 0, 1, 9, 10, 0, 8, 6, 6, 7, 5, 9, 3, 8, 1, 3, 8, 2, 3, 7, 8, 0, 6, 3, 7]"
199,25,50,45,4913,0,11,39,"[7, 1, 6, 3, 8, 9, 12, 3, 8, 4, 2, 6, 2, 8, 1, 10, 9, 2, 5, 8, 1, 4, 9, 0, 8, 3, 8]"
200,25,83,13,4983,0,15,68,"[0, 7, 11, 1, 2, 1, 22, 17, 18, 10, 9, 16, 7, 7, 8, 13, 2, 3, 3, 12, 5, 11, 22, 0, 19, 11, 15]"
201,25,7,7,4983,0,3,4,"[0, 1, 0, 0, 0, 0, 1, 0, 1, 0, 0, 1, 1, 0, 1, 1, 0, 0, 1, 0, 1, 1, 0, 0, 0, 1, 0]"
202,25,49,17,5015,0,43,6,"[1, 1, 0, 2, 2, 2, 0, 2, 2, 2, 1, 0, 1, 0, 0, 0, 2, 2, 0, 1, 2, 1, 2, 0, 0, 1, 1]"
203,25,88,35,5068,0,84,4,"[0, 1, 0, 0, 0, 0, 1, 1, 1, 1, 1, 1, 1, 1, 1, 1, 0, 0, 0, 1, 1, 0, 1, 0, 1, 0, 0]"
204,25,66,63,5071,0,15,51,"[6, 1, 16, 11, 0, 2, 4, 7, 17, 10, 17, 2, 6, 8, 6, 2, 10, 9, 4, 12, 16, 6, 5, 0, 4, 13, 8]"
205,25,31,25,5077,0,21,10,"[2, 1, 0, 1, 1, 2, 1, 3, 3, 2, 2, 3, 3, 3, 3, 0, 1, 2, 1, 2, 3, 3, 3, 0, 3, 0, 3]"
206,25,77,54,5100,0,0,77,"[22, 18, 7, 0, 10, 22, 6, 15, 18, 21, 25, 14, 12, 3, 18, 3, 1, 13, 10, 11, 24, 3, 10, 0, 10, 11, 21]"
207,25,36,33,5103,0,30,6,"[1, 0, 1, 2, 1, 0, 1, 0, 0, 1, 1, 1, 2, 0, 0, 0, 0, 1, 2, 2, 2, 2, 1, 0, 0, 2, 2]"
208,25,0,0,5103,0,0,0,"[0, 0, 0, 0, 0, 0, 0, 0, 0, 0, 0, 0, 0, 0, 0, 0, 0, 0, 0, 0, 0, 0, 0, 0, 0, 0, 0]"
209,25,95,78,5120,0,34,61,"[6, 12, 7, 1, 9, 12, 13, 13, 4, 0, 18, 4, 3, 18, 9, 0, 5, 13, 3, 18, 7, 14, 18, 0, 0, 7, 20]"
210,25,96,19,5197,0,7,89,"[17, 0, 24, 10, 6, 9, 8, 20, 27, 13, 16, 20, 24, 18, 15, 29, 18, 26, 5, 9, 8, 7, 9, 0, 28, 27, 6]"
211,25,46,22,5221,0,21,25,"[0, 8, 7, 2, 8, 8, 7, 4, 0, 2, 2, 8, 2, 6, 7, 4, 5, 2, 6, 2, 5, 1, 4, 0, 0, 4, 1]"
212,25,8,2,5227,0,2,6,"[0, 0, 0, 1, 0, 1, 1, 1, 2, 0, 0, 1, 0, 2, 2, 2, 1, 0, 1, 1, 0, 0, 2, 0, 2, 0, 1]"
213,25,98,21,5304,0,40,58,"[18, 5, 6, 10, 16, 4, 14, 14, 14, 9, 1, 12, 13, 9, 10, 16, 10, 7, 1, 16, 17, 14, 8, 0, 10, 11, 1]"
214,25,30,11,5323,0,10,20,"[0, 6, 2, 1, 5, 5, 1, 0, 6, 1, 4, 1, 1, 4, 2, 4, 5, 4, 6, 3, 4, 4, 4, 0, 6, 5, 6]"
215,25,91,74,5340,0,20,71,"[21, 6, 15, 5, 22, 2, 12, 23, 12, 18, 13, 5, 20, 12, 9, 10, 3, 7, 3, 23, 4, 19, 13, 0, 0, 10, 15]"
216,25,60,11,5389,0,48,12,"[4, 0, 3, 1, 4, 2, 0, 1, 3, 4, 4, 1, 1, 3, 4, 1, 3, 3, 3, 1, 3, 0, 3, 0, 4, 3, 2]"
217,25,74,27,5436,0,53,21,"[7, 7, 0, 5, 2, 1, 5, 7, 5, 6, 2, 5, 4, 3, 4, 6, 1, 3, 3, 5, 0, 2, 4, 0, 0, 2, 1]"
218,25,39,6,5469,0,12,27,"[9, 8, 6, 6, 6, 3, 0, 8, 6, 6, 1, 4, 4, 6, 9, 8, 3, 0, 2, 7, 7, 2, 4, 0, 2, 9, 9]"
219,25,77,52,5494,0,28,49,"[15, 1, 3, 4, 11, 14, 12, 2, 10, 1, 11, 12, 14, 12, 3, 10, 13, 5, 15, 16, 3, 7, 2, 0, 4, 5, 4]"
220,25,55,28,5521,0,10,45,"[9, 11, 14, 3, 4, 14, 5, 5, 14, 15, 11, 5, 2, 1, 10, 5, 15, 6, 7, 15, 15, 7, 9, 0, 10, 12, 2]"
221,25,96,7,5610,0,55,41,"[3, 0, 3, 1, 0, 4, 11, 12, 1, 1, 1, 11, 1, 1, 12, 4, 2, 1, 1, 4, 1, 8, 7, 0, 12, 12, 2]"
222,25,34,0,5644,0,25,9,"[3, 0, 0, 0, 1, 3, 1, 3, 3, 0, 2, 2, 3, 0, 1, 3, 0, 0, 1, 3, 1, 2, 0, 0, 0, 1, 1]"
223,25,8,5,5647,0,7,1,"[0, 0, 0, 0, 0, 0, 0, 0, 0, 0, 0, 0, 0, 0, 0, 0, 0, 0, 0, 0, 0, 0, 0, 0, 0, 0, 0]"
224,25,64,17,5694,0,8,56,"[2, 5, 10, 14, 1, 0, 14, 8, 9, 9, 6, 5, 14, 17, 12, 4, 10, 6, 3, 5, 15, 5, 5, 0, 7, 16, 0]"
225,25,84,52,5726,0,28,56,"[16, 13, 17, 18, 17, 11, 17, 0, 18, 2, 5, 4, 3, 0, 15, 16, 12, 9, 9, 12, 11, 8, 16, 0, 17, 11, 17]"
226,25,39,16,5749,0,27,12,"[3, 1, 0, 2, 4, 4, 0, 0, 0, 4, 0, 2, 3, 3, 1, 2, 1, 1, 1, 4, 3, 1, 0, 0, 1, 2, 1]"
227,25,4,3,5750,0,0,4,"[0, 0, 1, 1, 0, 1, 0, 0, 0, 1, 0, 0, 0, 0, 0, 1, 1, 0, 0, 0, 0, 0, 0, 0, 1, 1, 0]"
228,25,86,25,5811,0,31,55,"[1, 5, 5, 3, 10, 10, 18, 0, 16, 15, 13, 5, 17, 15, 11, 0, 8, 4, 11, 8, 6, 15, 15, 0, 12, 17, 10]"
229,25,63,56,5818,0,23,40,"[6, 0, 2, 12, 0, 11, 3, 0, 3, 2, 2, 6, 6, 5, 12, 4, 5, 4, 6, 12, 7, 2, 5, 0, 6, 5, 11]"
230,25,13,10,5821,0,4,9,"[3, 0, 3, 3, 1, 0, 2, 0, 0, 1, 3, 0, 0, 0, 1, 1, 0, 1, 0, 2, 0, 2, 0, 0, 0, 3, 0]"
231,25,86,23,5884,0,73,13,"[3, 0, 4, 0, 0, 2, 2, 4, 3, 1, 2, 2, 4, 1, 3, 1, 4, 4, 2, 3, 1, 4, 0, 0, 1, 4, 3]"
232,25,92,75,5901,0,90,2,"[0, 0, 0, 0, 0, 0, 0, 0, 0, 0, 0, 0, 0, 0, 0, 0, 0, 0, 0, 0, 0, 0, 0, 0, 0, 0, 0]"
233,25,27,3,5925,0,14,13,"[0, 1, 1, 0, 4, 1, 0, 4, 1, 4, 3, 4, 4, 1, 3, 4, 3, 2, 1, 1, 2, 4, 1, 0, 4, 2, 0]"
234,25,96,87,5934,0,92,4,"[1, 1, 0, 1, 1, 1, 1, 1, 1, 0, 1, 1, 0, 1, 1, 0, 1, 0, 1, 0, 0, 0, 0, 0, 1, 0, 0]"
235,25,74,56,5952,0,11,63,"[1, 11, 14, 6, 12, 5, 6, 11, 2, 21, 18, 18, 9, 11, 3, 21, 2, 18, 3, 11, 9, 3, 2, 0, 6, 20, 20]"
236,25,58,3,6007,0,58,0,"[0, 0, 0, 0, 0, 0, 0, 0, 0, 0, 0, 0, 0, 0, 0, 0, 0, 0, 0, 0, 0, 0, 0, 0, 0, 0, 0]"
237,25,41,29,6019,0,27,14,"[1, 2, 2, 1, 1, 1, 3, 1, 1, 1, 3, 0, 2, 2, 3, 2, 3, 3, 0, 1, 2, 2, 0, 0, 2, 3, 2]"
238,25,6,4,6021,0,1,5,"[1, 0, 0, 1, 0, 0, 0, 0, 0, 1, 0, 0, 0, 0, 0, 1, 0, 0, 1, 0, 1, 1, 0, 0, 0, 1, 1]"
239,25,65,49,6037,0,57,8,"[2, 1, 2, 0, 2, 0, 0, 2, 0, 2, 2, 2, 2, 1, 1, 1, 1, 0, 0, 2, 2, 1, 1, 0, 2, 0, 2]"
240,25,6,5,6038,0,0,6,"[0, 2, 1, 2, 0, 1, 0, 0, 1, 1, 1, 0, 0, 2, 1, 1, 2, 1, 2, 0, 0, 0, 2, 0, 0, 0, 0]"
241,25,86,76,6048,0,52,34,"[7, 8, 8, 7, 4, 4, 3, 2, 0, 7, 3, 8, 7, 6, 0, 3, 11, 9, 3, 11, 8, 3, 1, 0, 10, 2, 2]"
242,25,5,2,6051,0,5,0,"[0, 0, 0, 0, 0, 0, 0, 0, 0, 0, 0, 0, 0, 0, 0, 0, 0, 0, 0, 0, 0, 0, 0, 0, 0, 0, 0]"
243,25,9,9,6051,0,2,7,"[2, 1, 1, 0, 2, 2, 0, 2, 0, 0, 1, 0, 1, 1, 0, 2, 0, 0, 2, 2, 2, 2, 1, 0, 2, 2, 0]"
244,25,67,39,6079,0,44,23,"[6, 6, 3, 0, 0, 5, 5, 3, 2, 3, 1, 6, 3, 4, 0, 6, 4, 0, 7, 4, 2, 1, 1, 0, 3, 4, 7]"
245,25,40,8,6111,0,33,7,"[0, 0, 2, 1, 1, 0, 2, 0, 2, 2, 0, 1, 2, 2, 0, 0, 2, 0, 0, 2, 0, 2, 1, 0, 2, 2, 2]"
246,25,48,26,6133,0,16,32,"[9, 5, 9, 0, 10, 4, 2, 1, 9, 3, 4, 4, 7, 8, 6, 2, 7, 10, 6, 3, 2, 10, 4, 0, 1, 9, 8]"
247,25,67,14,6186,0,14,53,"[1, 10, 12, 5, 4, 9, 0, 16, 7, 13, 14, 7, 5, 16, 10, 6, 17, 4, 4, 10, 10, 16, 3, 0, 12, 15, 4]"
248,25,32,26,6192,0,13,19,"[3, 1, 6, 4, 0, 6, 1, 0, 6, 3, 0, 6, 3, 4, 0, 2, 2, 1, 3, 5, 1, 6, 2, 0, 3, 6, 3]"
249,25,43,23,6212,0,30,13,"[3, 1, 4, 3, 4, 0, 1, 4, 1, 4, 1, 1, 0, 2, 3, 2, 3, 3, 2, 3, 0, 4, 3, 0, 2, 1, 0]"
250,25,39,12,6239,0,39,0,"[0, 0, 0, 0, 0, 0, 0, 0, 0, 0, 0, 0, 0, 0, 0, 0, 0, 0, 0, 0, 0, 0, 0, 0, 0, 0, 0]"
251,25,69,37,6271,0,67,2,"[0, 0, 0, 0, 0, 0, 0, 0, 0, 0, 0, 0, 0, 0, 0, 0, 0, 0, 0, 0, 0, 0, 0, 0, 0, 0, 0]"
252,25,37,33,6275,0,6,31,"[7, 2, 7, 10, 1, 9, 8, 7, 10, 9, 5, 6, 10, 2, 2, 7, 0, 5, 3, 2, 8, 0, 5, 0, 6, 4, 1]"
253,25,62,59,6278,0,3,59,"[1, 11, 16, 11, 11, 9, 11, 1, 15, 6, 18, 0, 14, 15, 12, 4, 5, 4, 19, 2, 12, 14, 14, 0, 7, 10, 5]"
254,25,29,15,6292,0,15,14,"[4, 4, 1, 3, 1, 2, 0, 0, 1, 0, 2, 1, 2, 3, 4, 4, 3, 4, 4, 1, 1, 3, 4, 0, 1, 2, 0]"
255,25,93,54,6331,0,6,87,"[24, 1, 10, 23, 10, 26, 3, 3, 17, 10, 16, 29, 23, 20, 11, 23, 12, 15, 4, 17, 17, 17, 27, 0, 12, 6, 1]"
256,25,4,0,6335,0,0,4,"[1, 1, 0, 1, 1, 1, 1, 1, 0, 0, 1, 0, 1, 1, 1, 0, 1, 1, 1, 1, 0, 0, 0, 0, 1, 0, 0]"
257,25,18,0,6353,0,9,9,"[3, 2, 0, 2, 1, 0, 3, 3, 0, 3, 0, 0, 1, 2, 1, 3, 1, 0, 1, 1, 0, 3, 1, 0, 3, 2, 0]"
258,25,47,23,6377,0,33,14,"[4, 0, 2, 0, 0, 4, 0, 2, 2, 1, 3, 4, 3, 0, 2, 4, 4, 4, 1, 2, 4, 1, 4, 0, 0, 2, 4]"
259,25,56,5,6428,0,0,56,"[6, 18, 15, 6, 18, 1, 6, 16, 12, 10, 11, 4, 13, 17, 17, 1, 5, 8, 12, 1, 12, 16, 13, 0, 2, 17, 6]"
260,25,50,30,6448,0,41,9,"[0, 2, 1, 2, 0, 0, 0, 2, 0, 1, 1, 0, 2, 0, 0, 0, 0, 2, 1, 1, 0, 3, 1, 0, 1, 3, 2]"
261,25,29,27,6450,0,10,19,"[6, 3, 6, 6, 5, 3, 0, 5, 3, 5, 0, 3, 4, 1, 0, 3, 2, 4, 4, 0, 6, 0, 1, 0, 3, 6, 1]"
262,25,47,23,6474,0,40,7,"[0, 0, 2, 2, 0, 0, 0, 2, 2, 2, 2, 0, 1, 1, 1, 1, 0, 2, 2, 2, 1, 0, 0, 0, 1, 2, 1]"
263,25,6,5,6475,0,3,3,"[1, 0, 0, 1, 1, 0, 1, 1, 1, 0, 0, 0, 0, 1, 0, 0, 0, 1, 1, 0, 1, 0, 0, 0, 0, 1, 1]"
264,25,18,4,6489,0,3,15,"[0, 1, 5, 2, 0, 4, 0, 1, 4, 1, 4, 4, 2, 3, 2, 4, 4, 5, 2, 4, 4, 4, 3, 0, 5, 4, 5]"
265,25,48,15,6522,0,25,23,"[2, 0, 4, 1, 6, 6, 1, 7, 4, 4, 1, 0, 7, 1, 3, 7, 5, 4, 0, 1, 0, 7, 0, 0, 6, 1, 1]"
266,25,97,2,6617,0,3,94,"[6, 24, 31, 29, 5, 31, 24, 1, 22, 2, 16, 7, 9, 13, 25, 21, 28, 30, 25, 7, 11, 0, 25, 0, 18, 3, 18]"
267,25,82,49,6650,0,22,60,"[3, 5, 2, 16, 7, 17, 14, 0, 9, 7, 19, 20, 19, 18, 2, 5, 11, 10, 20, 17, 15, 17, 13, 0, 19, 14, 8]"
268,25,42,18,6674,0,26,16,"[1, 4, 1, 0, 1, 2, 4, 5, 2, 2, 2, 0, 5, 4, 4, 0, 4, 3, 2, 2, 0, 3, 0, 0, 4, 2, 1]"
269,25,59,31,6702,0,39,20,"[5, 3, 1, 2, 5, 4, 5, 0, 3, 2, 1, 1, 6, 4, 5, 4, 6, 5, 3, 4, 6, 5, 5, 0, 5, 3, 5]"
270,25,23,11,6714,0,21,2,"[0, 0, 0, 0, 0, 0, 0, 0, 0, 0, 0, 0, 0, 0, 0, 0, 0, 0, 0, 0, 0, 0, 0, 0, 0, 0, 0]"
271,25,19,11,6722,0,1,18,"[0, 2, 0, 5, 1, 3, 1, 1, 4, 2, 4, 6, 1, 1, 6, 2, 1, 2, 4, 2, 3, 2, 4, 0, 0, 4, 3]"
272,25,99,10,6811,0,28,71,"[1, 5, 20, 9, 16, 10, 17, 23, 2, 22, 19, 19, 11, 17, 19, 15, 9, 20, 7, 16, 18, 0, 7, 0, 20, 17, 22]"
273,25,76,45,6842,0,41,35,"[3, 7, 10, 4, 0, 3, 7, 9, 6, 7, 10, 9, 2, 0, 8, 11, 9, 6, 11, 5, 6, 2, 5, 0, 10, 0, 5]"
274,25,93,32,6903,0,10,83,"[24, 6, 14, 13, 25, 23, 8, 26, 22, 12, 8, 13, 16, 9, 3, 27, 2, 24, 25, 17, 10, 19, 26, 0, 5, 22, 14]"
275,25,61,53,6911,0,7,54,"[5, 12, 16, 5, 18, 8, 11, 0, 12, 2, 15, 2, 15, 12, 9, 8, 6, 5, 5, 17, 17, 15, 16, 0, 14, 17, 11]"
276,25,6,1,6916,0,4,2,"[0, 0, 0, 0, 0, 0, 0, 0, 0, 0, 0, 0, 0, 0, 0, 0, 0, 0, 0, 0, 0, 0, 0, 0, 0, 0, 0]"
277,25,27,9,6934,0,1,26,"[6, 3, 1, 7, 2, 4, 4, 6, 7, 3, 1, 5, 1, 3, 7, 3, 2, 7, 2, 3, 5, 4, 3, 0, 6, 7, 5]"
278,25,36,36,6934,0,11,25,"[7, 7, 4, 8, 2, 4, 3, 4, 4, 1, 4, 8, 4, 5, 4, 2, 4, 5, 6, 6, 4, 2, 6, 0, 4, 5, 4]"
279,25,74,9,6999,0,56,18,"[1, 1, 3, 6, 1, 0, 0, 0, 1, 4, 4, 0, 3, 1, 5, 4, 3, 5, 3, 3, 2, 4, 2, 0, 3, 6, 1]"
280,25,72,31,7040,0,15,57,"[0, 6, 4, 8, 2, 16, 11, 14, 13, 18, 17, 12, 17, 13, 19, 13, 14, 7, 0, 0, 17, 12, 4, 0, 7, 3, 8]"
281,25,37,10,7067,0,31,6,"[1, 2, 2, 2, 2, 1, 2, 0, 0, 1, 1, 2, 2, 2, 1, 0, 2, 1, 0, 2, 2, 2, 1, 0, 0, 1, 2]"
282,25,35,5,7097,0,3,32,"[2, 0, 8, 0, 5, 7, 0, 8, 2, 10, 4, 4, 8, 2, 7, 2, 1, 2, 4, 10, 3, 1, 8, 0, 0, 8, 2]"
283,25,83,7,7173,0,22,61,"[0, 10, 4, 19, 4, 14, 11, 12, 13, 18, 8, 15, 6, 2, 20, 4, 9, 3, 6, 3, 20, 7, 9, 0, 3, 14, 4]"
284,25,17,14,7176,0,12,5,"[1, 0, 1, 0, 0, 1, 0, 1, 0, 0, 1, 0, 1, 0, 0, 1, 1, 1, 1, 1, 0, 0, 0, 0, 0, 0, 0]"
285,25,84,76,7184,0,78,6,"[2, 1, 1, 2, 0, 2, 1, 2, 2, 0, 1, 0, 0, 2, 1, 2, 2, 0, 0, 0, 1, 0, 1, 0, 0, 0, 1]"
286,25,44,31,7197,0,1,43,"[7, 4, 12, 5, 6, 3, 13, 12, 1, 1, 10, 5, 1, 9, 8, 11, 14, 12, 7, 8, 10, 0, 9, 0, 3, 2, 8]"
287,25,32,23,7206,0,9,23,"[4, 5, 6, 0, 0, 4, 6, 2, 3, 0, 3, 6, 6, 1, 5, 3, 2, 6, 7, 2, 0, 4, 3, 0, 3, 0, 0]"
288,25,1,0,7198,0,0,1,"[0, 0, 0, 0, 0, 0, 0, 0, 0, 0, 0, 0, 0, 0, 0, 0, 0, 0, 0, 0, 0, 0, 0, 0, 0, 0, 0]"
289,25,75,48,7225,0,34,41,"[4, 1, 3, 4, 10, 5, 2, 8, 10, 11, 1, 9, 1, 0, 9, 13, 5, 6, 2, 11, 4, 1, 13, 0, 3, 1, 2]"
290,25,76,38,7263,0,71,5,"[1, 0, 0, 1, 1, 1, 1, 0, 0, 0, 0, 0, 1, 1, 0, 0, 0, 1, 1, 0, 1, 0, 1, 0, 1, 0, 0]"
291,25,51,13,7301,0,32,19,"[6, 0, 5, 3, 4, 3, 4, 3, 0, 2, 2, 4, 2, 3, 4, 4, 3, 4, 2, 2, 1, 3, 6, 0, 5, 4, 6]"
292,25,87,60,7328,0,60,27,"[0, 9, 3, 4, 2, 8, 0, 4, 1, 9, 7, 5, 2, 7, 0, 7, 1, 7, 6, 4, 8, 6, 3, 0, 3, 4, 4]"
293,25,85,35,7378,0,43,42,"[1, 1, 12, 9, 12, 7, 6, 4, 5, 0, 8, 7, 4, 9, 2, 7, 13, 2, 14, 5, 9, 13, 3, 0, 0, 5, 10]"
294,25,30,0,7408,0,8,22,"[7, 0, 6, 2, 0, 5, 2, 5, 2, 4, 5, 2, 6, 0, 1, 2, 5, 3, 6, 3, 4, 7, 5, 0, 4, 2, 4]"
295,25,56,42,7422,0,25,31,"[0, 9, 5, 5, 6, 0, 8, 10, 6, 5, 2, 3, 7, 7, 1, 5, 2, 3, 4, 0, 9, 2, 8, 0, 8, 3, 8]"
296,25,36,18,7440,0,13,23,"[6, 4, 2, 3, 6, 4, 2, 3, 7, 4, 5, 1, 6, 1, 6, 1, 1, 4, 3, 4, 4, 7, 4, 0, 2, 3, 6]"
297,25,2,0,7442,0,0,2,"[0, 0, 0, 0, 0, 0, 0, 0, 0, 0, 0, 0, 0, 0, 0, 0, 0, 0, 0, 0, 0, 0, 0, 0, 0, 0, 0]"
298,25,48,35,7455,0,48,0,"[0, 0, 0, 0, 0, 0, 0, 0, 0, 0, 0, 0, 0, 0, 0, 0, 0, 0, 0, 0, 0, 0, 0, 0, 0, 0, 0]"
299,25,29,10,7474,0,2,27,"[4, 7, 1, 4, 2, 4, 4, 7, 6, 7, 2, 9, 6, 6, 5, 9, 6, 1, 3, 5, 2, 3, 5, 0, 6, 1, 3]"
0,26,1896,0,1896,0,624,1272,"[352, 103, 47, 31, 307, 353, 216, 330, 133, 39, 60, 419, 223, 277, 129, 260, 28, 338, 92, 271, 268, 291, 169, 372, 0, 314, 357]"
1,26,2278,2223,1951,0,494,1784,"[169, 127, 302, 533, 246, 97, 437, 431, 109, 263, 244, 74, 222, 157, 553, 16, 553, 154, 397, 299, 421, 508, 224, 123, 0, 289, 577]"
2,26,1322,163,3110,0,530,792,"[8, 163, 29, 49, 205, 3, 162, 217, 89, 4, 246, 195, 176, 45, 221, 149, 102, 138, 234, 256, 61, 184, 45, 147, 0, 45, 202]"
3,26,2590,1086,4614,0,192,2398,"[119, 795, 61, 394, 380, 361, 87, 732, 668, 427, 705, 652, 277, 269, 456, 783, 504, 469, 446, 442, 311, 230, 772, 573, 0, 539, 360]"
4,26,1097,881,4830,0,431,666,"[202, 4, 12, 218, 116, 136, 28, 25, 21, 175, 52, 75, 101, 89, 217, 209, 214, 16, 127, 148, 185, 212, 32, 162, 0, 2, 180]"
5,26,1777,1435,5172,0,1519,258,"[60, 10, 76, 29, 81, 55, 31, 17, 82, 40, 69, 15, 25, 26, 29, 39, 26, 32, 63, 42, 32, 49, 20, 12, 0, 38, 8]"
6,26,2690,803,7059,0,248,2442,"[716, 364, 265, 8, 693, 685, 754, 608, 294, 48, 683, 213, 28, 465, 203, 675, 661, 572, 498, 656, 697, 758, 641, 180, 0, 513, 276]"
7,26,2540,969,8630,0,486,2054,"[172, 654, 303, 664, 366, 459, 613, 496, 254, 82, 573, 126, 384, 638, 253, 249, 212, 89, 431, 74, 656, 313, 408, 358, 0, 436, 676]"
8,26,2549,6023,5156,0,1765,784,"[126, 150, 100, 101, 194, 134, 195, 13, 245, 231, 83, 58, 90, 67, 123, 242, 41, 193, 41, 246, 71, 220, 230, 58, 0, 24, 257]"
9,26,1150,672,5634,0,448,702,"[83, 139, 82, 233, 118, 216, 192, 31, 225, 75, 171, 157, 200, 6, 3, 174, 198, 28, 110, 149, 128, 48, 64, 23, 0, 44, 151]"
10,26,2143,1890,5887,0,1257,886,"[241, 103, 67, 129, 101, 64, 261, 36, 258, 200, 7, 6, 7, 24, 200, 124, 121, 201, 227, 272, 0, 109, 186, 200, 0, 282, 12]"
11,26,1441,120,7208,0,819,622,"[198, 108, 182, 39, 92, 168, 22, 78, 182, 138, 136, 48, 185, 86, 151, 159, 38, 40, 73, 83, 23, 108, 153, 1, 0, 160, 73]"
12,26,1079,439,7848,0,798,281,"[0, 72, 46, 56, 87, 93, 64, 10, 39, 88, 34, 81, 48, 67, 85, 40, 43, 79, 63, 5, 92, 59, 36, 61, 0, 82, 6]"
13,26,2264,2228,7884,0,248,2016,"[552, 16, 603, 266, 589, 570, 2, 5, 192, 113, 199, 456, 150, 394, 486, 39, 167, 607, 618, 647, 166, 646, 423, 429, 0, 497, 317]"
14,26,2593,1953,8524,0,48,2545,"[468, 375, 526, 817, 297, 512, 819, 1, 129, 763, 666, 223, 843, 652, 97, 474, 662, 289, 477, 387, 452, 610, 277, 67, 0, 68, 695]"
15,26,1305,1195,8634,0,710,595,"[20, 122, 129, 66, 56, 77, 152, 22, 158, 55, 136, 38, 189, 137, 55, 188, 161, 57, 173, 18, 84, 28, 55, 67, 0, 7, 52]"
16,26,1887,570,9951,0,1395,492,"[59, 86, 54, 13, 164, 42, 101, 31, 148, 0, 1, 60, 24, 62, 31, 146, 83, 40, 116, 152, 32, 152, 70, 42, 0, 142, 49]"
17,26,1351,5395,5907,0,935,416,"[80, 88, 104, 69, 55, 3, 131, 98, 119, 86, 90, 75, 121, 72, 135, 94, 87, 25, 67, 112, 23, 24, 93, 28, 0, 92, 53]"
18,26,2846,796,7957,0,144,2702,"[344, 102, 772, 829, 81, 613, 249, 331, 524, 626, 221, 596, 241, 300, 570, 497, 478, 254, 883, 503, 1, 578, 740, 35, 0, 441, 408]"
19,26,1128,432,8653,0,329,799,"[46, 156, 166, 178, 238, 194, 192, 150, 4, 138, 121, 57, 262, 139, 166, 232, 201, 83, 63, 120, 102, 64, 30, 37, 0, 91, 257]"
20,26,2238,341,10000,550,2178,60,"[6, 18, 9, 0, 4, 11, 12, 10, 15, 7, 6, 9, 19, 10, 9, 13, 17, 16, 19, 16, 15, 10, 18, 4, 0, 3, 12]"
21,26,1032,7209,3823,0,828,204,"[35, 48, 41, 21, 32, 66, 0, 31, 21, 39, 31, 61, 47, 58, 52, 35, 2, 53, 15, 13, 35, 45, 0, 64, 0, 63, 40]"
22,26,2360,2038,4145,0,1595,765,"[214, 158, 113, 227, 27, 75, 189, 0, 179, 86, 198, 65, 15, 48, 233, 5, 254, 177, 115, 162, 246, 29, 124, 225, 0, 228, 53]"
23,26,1630,1359,4416,0,653,977,"[85, 281, 131, 19, 127, 254, 203, 283, 300, 179, 323, 246, 268, 157, 154, 258, 297, 228, 207, 23, 203, 304, 43, 322, 0, 307, 161]"
24,26,2021,317,6120,0,1629,392,"[72, 128, 19, 51, 121, 76, 93, 107, 9, 13, 104, 41, 41, 17, 102, 63, 124, 114, 125, 58, 99, 88, 93, 123, 0, 2, 23]"
25,26,2934,2924,6130,0,1759,1175,"[269, 373, 194, 209, 11, 30, 45, 145, 144, 388, 377, 192, 261, 16, 309, 314, 74, 36, 351, 211, 108, 327, 67, 102, 0, 98, 216]"
26,26,1231,106,7255,0,841,390,"[71, 95, 123, 38, 78, 106, 95, 55, 114, 2, 11, 95, 49, 61, 30, 11, 3, 102, 63, 119, 64, 101, 104, 104, 0, 23, 91]"
27,26,2643,1776,8122,0,868,1775,"[229, 254, 456, 537, 49, 381, 113, 209, 304, 197, 91, 101, 401, 246, 219, 163, 318, 189, 532, 435, 364, 538, 227, 113, 0, 210, 181]"
28,26,2831,819,10000,134,1761,1070,"[284, 88, 183, 298, 329, 299, 157, 330, 38, 106, 80, 20, 338, 186, 294, 67, 135, 228, 42, 144, 284, 138, 227, 12, 0, 154, 203]"
29,26,2912,7055,5857,0,1322,1590,"[423, 84, 234, 52, 477, 62, 119, 431, 258, 40, 372, 80, 377, 1, 80, 74, 427, 217, 487, 186, 499, 361, 105, 242, 0, 310, 210]"
30,26,2498,1222,7133,0,1852,646,"[154, 41, 130, 68, 92, 171, 150, 199, 121, 141, 5, 183, 102, 147, 0, 175, 183, 105, 180, 17, 122, 92, 55, 82, 0, 55, 202]"
31,26,2728,1193,8668,0,2122,606,"[91, 197, 109, 66, 3, 75, 64, 159, 154, 42, 15, 71, 82, 45, 12, 201, 81, 96, 134, 58, 129, 15, 28, 142, 0, 192, 81]"
32,26,1871,1506,9033,0,336,1535,"[450, 442, 387, 236, 66, 67, 341, 401, 50, 496, 200, 197, 53, 217, 165, 394, 210, 223, 220, 115, 491, 234, 162, 498, 0, 102, 314]"
33,26,2920,5517,6436,0,2337,583,"[17, 68, 37, 70, 167, 68, 13, 192, 139, 69, 114, 163, 72, 153, 155, 62, 100, 3, 176, 138, 164, 186, 101, 80, 0, 185, 8]"
34,26,2335,778,7993,0,881,1454,"[346, 391, 353, 318, 29, 224, 246, 271, 50, 31, 444, 409, 143, 216, 253, 223, 383, 21, 293, 473, 241, 268, 273, 417, 0, 102, 39]"
35,26,1614,212,9395,0,296,1318,"[25, 302, 92, 348, 243, 422, 55, 434, 168, 44, 321, 195, 273, 212, 172, 21, 264, 25, 38, 222, 35, 323, 101, 26, 0, 353, 59]"
36,26,1240,705,9930,0,469,771,"[52, 219, 142, 50, 154, 87, 78, 223, 105, 148, 171, 172, 33, 173, 113, 116, 120, 200, 119, 25, 254, 63, 176, 156, 0, 96, 45]"
37,26,1629,5191,6368,0,1066,563,"[35, 86, 92, 36, 50, 141, 184, 122, 42, 73, 97, 36, 8, 38, 70, 47, 95, 140, 157, 158, 4, 68, 67, 99, 0, 155, 89]"
38,26,2729,1370,7727,0,926,1803,"[160, 335, 504, 210, 167, 572, 7, 461, 450, 466, 370, 45, 487, 185, 519, 260, 150, 313, 316, 542, 88, 397, 386, 464, 0, 360, 357]"
39,26,1306,106,8927,0,903,403,"[77, 110, 68, 70, 38, 57, 37, 44, 121, 21, 47, 104, 57, 119, 53, 110, 30, 6, 6, 107, 64, 100, 73, 6, 0, 39, 127]"
40,26,1763,1701,8989,0,91,1672,"[347, 369, 133, 44, 507, 237, 72, 335, 267, 448, 51, 538, 11, 459, 258, 270, 435, 93, 56, 151, 376, 175, 278, 495, 0, 269, 79]"
41,26,2579,6594,4974,0,2193,386,"[25, 11, 82, 96, 114, 39, 115, 108, 8, 103, 117, 30, 77, 30, 128, 110, 70, 125, 48, 51, 20, 94, 108, 44, 0, 13, 23]"
42,26,2010,375,6609,0,1941,69,"[20, 23, 18, 14, 14, 16, 6, 12, 23, 16, 22, 20, 12, 19, 9, 6, 18, 22, 22, 8, 6, 21, 9, 14, 0, 7, 23]"
43,26,2678,36,9251,0,1758,920,"[164, 94, 203, 124, 137, 237, 167, 142, 119, 177, 276, 235, 246, 59, 134, 102, 268, 183, 258, 77, 278, 128, 194, 41, 0, 40, 57]"
44,26,1208,1146,9313,0,118,1090,"[87, 38, 318, 159, 166, 195, 97, 353, 88, 24, 333, 130, 100, 115, 200, 217, 213, 252, 298, 19, 166, 304, 243, 149, 0, 73, 47]"
45,26,1175,96,10000,392,934,241,"[25, 42, 74, 26, 29, 5, 21, 3, 56, 49, 14, 54, 57, 34, 12, 37, 14, 64, 76, 5, 53, 14, 30, 76, 0, 21, 2]"
46,26,2770,5744,7026,0,2519,251,"[27, 63, 22, 55, 60, 65, 10, 60, 35, 23, 8, 47, 80, 12, 70, 62, 0, 46, 11, 31, 19, 46, 4, 81, 0, 35, 46]"
47,26,1816,998,7844,0,1648,168,"[23, 37, 32, 50, 39, 18, 25, 35, 1, 35, 35, 46, 5, 31, 28, 28, 0, 33, 14, 34, 20, 5, 23, 55, 0, 38, 47]"
48,26,2275,783,9336,0,1375,900,"[10, 208, 32, 94, 201, 27, 96, 8, 42, 53, 19, 175, 246, 233, 111, 49, 245, 28, 266, 274, 205, 234, 194, 255, 0, 98, 216]"
49,26,2366,6697,5005,0,810,1556,"[296, 295, 121, 198, 170, 345, 321, 454, 131, 274, 169, 72, 25, 208, 348, 331, 155, 56, 159, 367, 454, 29, 393, 168, 0, 306, 116]"
50,26,2325,764,6566,0,820,1505,"[149, 463, 46, 138, 254, 47, 107, 367, 293, 2, 321, 212, 62, 436, 205, 29, 390, 496, 465, 476, 382, 477, 118, 333, 0, 292, 229]"
51,26,2464,1481,7549,0,1831,633,"[183, 24, 130, 127, 152, 154, 167, 38, 19, 21, 81, 113, 36, 74, 124, 101, 50, 57, 33, 145, 183, 100, 187, 44, 0, 44, 132]"
52,26,1737,37,9249,0,340,1397,"[439, 121, 146, 207, 34, 118, 10, 262, 350, 450, 350, 402, 307, 162, 94, 130, 158, 446, 145, 297, 379, 35, 324, 183, 0, 257, 350]"
53,26,2575,6964,4860,0,2452,123,"[28, 41, 37, 41, 40, 29, 41, 23, 7, 10, 30, 9, 22, 15, 30, 41, 17, 22, 20, 15, 6, 15, 16, 3, 0, 20, 26]"
54,26,1390,588,5662,0,948,442,"[58, 29, 116, 100, 123, 84, 22, 106, 11, 96, 13, 72, 73, 89, 146, 28, 5, 80, 30, 64, 46, 131, 43, 19, 0, 62, 111]"
55,26,2386,1971,6077,0,2300,86,"[0, 1, 1, 8, 27, 21, 13, 18, 14, 19, 25, 19, 19, 20, 5, 4, 15, 23, 8, 17, 6, 12, 22, 10, 0, 17, 23]"
56,26,2721,2586,6212,0,1718,1003,"[150, 118, 227, 54, 110, 89, 170, 19, 110, 323, 75, 317, 53, 5, 109, 217, 282, 14, 71, 1, 97, 287, 60, 48, 0, 119, 149]"
57,26,1324,817,6719,0,263,1061,"[154, 301, 300, 273, 32, 317, 8, 204, 83, 300, 329, 291, 154, 113, 279, 117, 199, 22, 155, 91, 188, 168, 197, 168, 0, 13, 133]"
58,26,2100,1355,7464,0,590,1510,"[416, 156, 279, 488, 355, 330, 395, 299, 262, 176, 264, 132, 384, 340, 245, 71, 335, 441, 433, 170, 307, 123, 297, 215, 0, 158, 314]"
59,26,2381,1977,7868,0,1865,516,"[164, 153, 79, 14, 117, 131, 5, 113, 5, 111, 42, 72, 88, 85, 54, 55, 91, 16, 142, 154, 32, 158, 89, 98, 0, 120, 82]"
60,26,1747,272,9343,0,107,1640,"[317, 290, 75, 517, 37, 519, 0, 205, 46, 273, 281, 313, 403, 349, 51, 56, 416, 439, 277, 545, 315, 39, 314, 445, 0, 237, 135]"
61,26,2634,6006,5971,0,353,2281,"[32, 677, 294, 460, 600, 676, 280, 364, 667, 420, 224, 329, 521, 71, 456, 426, 550, 47, 124, 211, 279, 276, 324, 635, 0, 149, 231]"
62,26,2301,846,7426,0,2236,65,"[7, 11, 1, 9, 16, 5, 13, 2, 1, 11, 9, 3, 5, 6, 15, 1, 10, 19, 2, 15, 7, 17, 19, 19, 0, 21, 18]"
63,26,1890,1762,7554,0,676,1214,"[258, 266, 53, 56, 5, 12, 306, 169, 336, 196, 353, 361, 195, 128, 35, 137, 356, 170, 310, 110, 301, 206, 208, 212, 0, 20, 20]"
64,26,1879,751,8682,0,1240,639,"[201, 10, 172, 114, 59, 188, 69, 165, 74, 49, 75, 90, 0, 145, 199, 157, 49, 60, 92, 185, 119, 206, 113, 67, 0, 189, 109]"
65,26,1098,135,9645,0,93,1005,"[75, 271, 96, 155, 20, 136, 76, 241, 204, 25, 251, 50, 0, 266, 259, 308, 28, 84, 138, 311, 305, 101, 7, 32, 0, 71, 212]"
66,26,2436,5531,6550,0,2299,137,"[28, 39, 32, 10, 25, 29, 13, 17, 13, 16, 25, 33, 8, 13, 43, 42, 0, 40, 17, 21, 35, 27, 34, 20, 0, 33, 44]"
67,26,2545,641,8454,0,683,1862,"[189, 188, 521, 563, 353, 74, 140, 451, 286, 417, 317, 74, 316, 91, 584, 136, 572, 161, 490, 4, 452, 429, 421, 335, 0, 443, 534]"
68,26,1640,1330,8764,0,325,1315,"[418, 433, 156, 221, 381, 237, 200, 154, 238, 315, 428, 92, 268, 317, 228, 93, 436, 156, 234, 282, 290, 199, 13, 306, 0, 283, 408]"
69,26,1877,1417,9224,0,57,1820,"[400, 218, 390, 298, 3, 500, 247, 463, 84, 92, 340, 28, 145, 325, 554, 79, 45, 571, 413, 247, 188, 496, 163, 495, 0, 20, 465]"
70,26,1683,315,10000,592,98,1585,"[450, 325, 27, 46, 88, 62, 528, 127, 134, 387, 420, 472, 452, 115, 167, 347, 172, 111, 187, 105, 45, 220, 113, 30, 0, 379, 336]"
71,26,1101,6005,5096,0,113,988,"[226, 204, 240, 35, 105, 266, 300, 56, 209, 146, 150, 323, 220, 16, 45, 264, 34, 221, 86, 261, 3, 217, 175, 126, 0, 68, 111]"
72,26,2851,2239,5708,0,1460,1391,"[139, 86, 188, 414, 71, 369, 393, 400, 32, 377, 348, 409, 83, 437, 185, 95, 7, 276, 358, 270, 81, 230, 415, 309, 0, 410, 20]"
73,26,2974,2432,6250,0,362,2612,"[202, 74, 226, 278, 300, 278, 314, 391, 389, 720, 299, 122, 257, 291, 842, 754, 143, 659, 36, 523, 617, 477, 213, 791, 0, 513, 188]"
74,26,2838,2286,6802,0,258,2580,"[295, 831, 49, 291, 722, 192, 402, 731, 320, 388, 717, 379, 94, 677, 245, 259, 589, 672, 202, 682, 335, 493, 849, 335, 0, 697, 616]"
75,26,1957,467,8292,0,756,1201,"[247, 397, 346, 136, 352, 284, 104, 383, 229, 218, 127, 63, 200, 196, 38, 1, 31, 156, 10, 26, 193, 19, 220, 353, 0, 136, 64]"
76,26,1407,283,9416,0,780,627,"[200, 77, 78, 49, 57, 103, 120, 25, 138, 25, 133, 187, 141, 148, 46, 188, 119, 194, 135, 153, 140, 191, 136, 67, 0, 37, 133]"
77,26,1929,6995,4350,0,724,1205,"[359, 65, 171, 272, 325, 148, 206, 134, 34, 209, 397, 304, 262, 270, 150, 293, 174, 271, 184, 243, 237, 98, 64, 362, 0, 157, 234]"
78,26,2552,399,6503,0,1167,1385,"[287, 301, 451, 127, 270, 447, 418, 325, 229, 62, 396, 132, 319, 170, 282, 200, 182, 224, 115, 151, 155, 132, 412, 43, 0, 403, 161]"
79,26,1813,185,8131,0,252,1561,"[421, 389, 395, 404, 178, 499, 261, 106, 512, 396, 202, 267, 173, 279, 367, 517, 77, 348, 131, 463, 51, 41, 112, 284, 0, 316, 123]"
80,26,2415,2355,8191,0,823,1592,"[505, 521, 34, 529, 189, 54, 6, 286, 128, 145, 229, 180, 240, 99, 176, 491, 299, 72, 357, 59, 311, 205, 175, 77, 0, 180, 220]"
81,26,1258,168,9281,0,247,1011,"[74, 48, 186, 143, 84, 120, 316, 246, 154, 23, 175, 243, 273, 218, 279, 27, 34, 181, 152, 113, 261, 116, 259, 78, 0, 24, 174]"
82,26,2650,6719,5212,0,2034,616,"[23, 90, 0, 37, 62, 21, 73, 105, 192, 31, 172, 143, 155, 44, 13, 27, 162, 168, 185, 135, 56, 179, 203, 184, 0, 100, 13]"
83,26,1815,1225,5802,0,651,1164,"[13, 256, 281, 193, 98, 34, 218, 86, 253, 170, 49, 192, 84, 378, 221, 349, 77, 118, 274, 265, 198, 7, 49, 149, 0, 101, 126]"
84,26,2415,1851,6366,0,1770,645,"[101, 176, 13, 191, 155, 40, 69, 180, 152, 90, 159, 123, 210, 150, 101, 147, 102, 88, 46, 60, 139, 49, 103, 172, 0, 46, 36]"
85,26,1668,668,7366,0,155,1513,"[240, 226, 481, 324, 244, 162, 213, 162, 193, 351, 277, 303, 19, 280, 35, 42, 186, 367, 211, 154, 378, 235, 96, 208, 0, 455, 499]"
86,26,1216,691,7891,0,381,835,"[76, 230, 53, 167, 154, 173, 54, 234, 130, 60, 229, 172, 215, 38, 237, 137, 13, 70, 1, 156, 268, 44, 137, 189, 0, 232, 184]"
87,26,1303,264,8930,0,771,532,"[1, 134, 62, 7, 90, 169, 68, 73, 111, 92, 25, 44, 31, 159, 62, 38, 82, 2, 3, 31, 111, 137, 44, 176, 0, 151, 34]"
88,26,1423,1387,8966,0,946,477,"[70, 94, 63, 137, 90, 3, 63, 96, 158, 155, 87, 67, 117, 93, 149, 70, 76, 116, 20, 40, 35, 88, 85, 42, 0, 63, 126]"
89,26,2550,7178,4338,0,2143,407,"[123, 99, 70, 100, 60, 11, 0, 56, 17, 81, 91, 58, 61, 31, 110, 70, 111, 75, 36, 25, 66, 53, 66, 82, 0, 23, 116]"
90,26,1167,282,5223,0,616,551,"[33, 59, 54, 129, 87, 138, 80, 111, 109, 5, 54, 146, 40, 105, 85, 64, 148, 170, 103, 143, 174, 148, 71, 141, 0, 75, 71]"
91,26,1315,144,6394,0,690,625,"[196, 102, 85, 80, 185, 3, 38, 65, 180, 98, 84, 154, 56, 42, 70, 144, 98, 116, 189, 146, 2, 185, 90, 29, 0, 127, 90]"
92,26,1877,786,7485,0,1584,293,"[16, 40, 78, 89, 6, 52, 16, 66, 66, 5, 8, 6, 39, 56, 37, 39, 23, 50, 24, 61, 95, 78, 67, 24, 0, 96, 0]"
93,26,1693,1161,8017,0,1006,687,"[183, 85, 119, 118, 201, 81, 117, 167, 17, 52, 138, 144, 222, 138, 123, 119, 91, 211, 182, 33, 3, 27, 49, 25, 0, 97, 147]"
94,26,2760,28,10000,749,2199,561,"[2, 14, 149, 144, 70, 91, 168, 147, 169, 106, 2, 153, 80, 33, 178, 95, 170, 81, 185, 84, 168, 47, 44, 187, 0, 80, 157]"
95,26,1530,6073,5457,0,907,623,"[104, 8, 78, 98, 177, 35, 107, 9, 95, 21, 198, 156, 158, 123, 183, 111, 56, 116, 169, 94, 55, 163, 75, 100, 0, 35, 107]"
96,26,1926,46,7337,0,1080,846,"[180, 222, 94, 214, 177, 66, 59, 48, 265, 110, 120, 215, 25, 51, 22, 214, 238, 187, 83, 28, 234, 34, 147, 83, 0, 257, 241]"
97,26,1597,234,8700,0,153,1444,"[204, 420, 455, 396, 160, 253, 375, 296, 407, 443, 117, 313, 410, 274, 359, 296, 138, 214, 215, 481, 437, 155, 108, 419, 0, 90, 174]"
98,26,1465,955,9210,0,1290,175,"[4, 47, 48, 11, 33, 42, 26, 1, 53, 9, 48, 41, 50, 47, 11, 10, 30, 46, 43, 20, 48, 55, 19, 17, 0, 1, 34]"
99,26,1646,554,10000,302,60,1586,"[202, 46, 424, 120, 157, 324, 314, 374, 189, 509, 378, 234, 495, 352, 489, 233, 363, 290, 7, 244, 30, 24, 234, 410, 0, 131, 414]"
100,26,2927,6645,6282,0,756,2171,"[643, 56, 3, 199, 314, 221, 130, 522, 246, 607, 54, 423, 696, 28, 222, 10, 671, 268, 228, 119, 79, 497, 135, 486, 0, 184, 127]"
101,26,2642,625,8299,0,245,2397,"[243, 713, 558, 765, 522, 370, 260, 128, 575, 698, 461, 278, 702, 379, 706, 227, 207, 652, 531, 463, 285, 354, 640, 734, 0, 756, 297]"
102,26,1912,204,10000,7,1614,298,"[72, 12, 81, 20, 47, 94, 40, 69, 28, 5, 62, 30, 40, 37, 53, 94, 31, 33, 52, 57, 12, 35, 83, 37, 0, 26, 63]"
103,26,1153,7104,4049,0,516,637,"[56, 101, 140, 162, 35, 73, 143, 36, 25, 159, 172, 205, 115, 134, 191, 14, 174, 2, 207, 3, 157, 32, 120, 161, 0, 15, 74]"
104,26,1791,1716,4124,0,387,1404,"[269, 210, 382, 323, 240, 418, 152, 223, 16, 184, 288, 430, 395, 373, 369, 129, 100, 290, 276, 441, 14, 452, 64, 454, 0, 168, 446]"
105,26,2511,956,5679,0,1025,1486,"[225, 316, 429, 274, 160, 406, 266, 288, 458, 267, 107, 119, 265, 164, 416, 423, 231, 167, 240, 57, 275, 58, 344, 63, 0, 400, 437]"
106,26,2660,778,7561,0,1736,924,"[49, 93, 75, 159, 114, 272, 51, 99, 163, 36, 267, 82, 137, 271, 269, 1, 188, 98, 83, 112, 212, 140, 218, 72, 0, 95, 265]"
107,26,2770,1483,8848,0,168,2602,"[52, 545, 537, 841, 274, 304, 109, 148, 841, 590, 567, 719, 263, 785, 196, 730, 173, 506, 262, 267, 849, 145, 659, 262, 0, 159, 852]"
108,26,1618,178,10000,288,1058,560,"[29, 4, 117, 105, 139, 55, 88, 139, 78, 65, 180, 164, 27, 14, 153, 41, 49, 181, 169, 28, 69, 150, 150, 164, 0, 40, 10]"
109,26,2423,6950,5473,0,1828,595,"[193, 94, 8, 58, 158, 146, 115, 96, 169, 135, 137, 198, 195, 76, 115, 123, 129, 132, 91, 139, 178, 132, 104, 168, 0, 39, 113]"
110,26,1135,423,6185,0,769,366,"[101, 28, 40, 39, 99, 59, 37, 105, 31, 33, 10, 99, 60, 76, 14, 51, 92, 37, 14, 69, 38, 78, 43, 87, 0, 91, 43]"
111,26,2969,1809,7345,0,2451,518,"[19, 72, 44, 30, 151, 18, 21, 23, 146, 78, 59, 21, 40, 120, 167, 52, 139, 50, 13, 157, 168, 157, 129, 28, 0, 126, 170]"
112,26,1383,825,7903,0,462,921,"[127, 50, 30, 210, 298, 223, 23, 183, 299, 34, 135, 248, 290, 93, 31, 10, 24, 267, 280, 79, 158, 117, 3, 2, 0, 159, 117]"
113,26,1448,1338,8013,0,674,774,"[117, 53, 130, 142, 158, 100, 210, 76, 126, 239, 58, 206, 116, 235, 195, 229, 158, 151, 2, 188, 215, 127, 132, 63, 0, 51, 73]"
114,26,1956,1570,8399,0,1470,486,"[19, 106, 127, 119, 29, 115, 149, 106, 48, 120, 118, 54, 153, 81, 157, 133, 58, 93, 147, 32, 66, 126, 7, 143, 0, 68, 98]"
115,26,2011,1635,8775,0,169,1842,"[199, 104, 208, 557, 345, 601, 102, 366, 216, 379, 370, 19, 587, 169, 299, 470, 418, 597, 517, 59, 142, 421, 58, 271, 0, 482, 429]"
116,26,2496,5789,5482,0,45,2451,"[236, 172, 484, 94, 25, 142, 506, 700, 814, 276, 595, 777, 6, 389, 777, 420, 16, 65, 431, 153, 618, 711, 675, 618, 0, 651, 111]"
117,26,2068,1728,5822,0,681,1387,"[77, 261, 384, 46, 94, 29, 388, 261, 145, 158, 41, 93, 152, 197, 260, 150, 78, 183, 237, 193, 369, 86, 23, 159, 0, 78, 298]"
118,26,1825,1590,6057,0,602,1223,"[172, 245, 68, 192, 277, 298, 150, 397, 327, 239, 26, 396, 89, 217, 290, 406, 201, 204, 222, 147, 293, 390, 175, 223, 0, 14, 58]"
119,26,2487,1221,7323,0,2040,447,"[99, 90, 16, 45, 74, 6, 51, 78, 78, 128, 132, 115, 149, 57, 122, 47, 51, 62, 66, 58, 36, 117, 147, 70, 0, 16, 56]"
120,26,1862,136,9049,0,1176,686,"[65, 130, 98, 61, 140, 193, 192, 137, 33, 170, 164, 195, 196, 173, 93, 217, 170, 117, 17, 93, 157, 131, 45, 209, 0, 1, 188]"
121,26,2824,5313,6560,0,1689,1135,"[131, 204, 363, 169, 79, 21, 141, 312, 186, 65, 56, 222, 365, 79, 17, 52, 119, 289, 78, 203, 106, 107, 136, 148, 0, 225, 273]"
122,26,2045,1249,7356,0,1903,142,"[23, 25, 10, 29, 45, 21, 40, 1, 26, 6, 1, 8, 11, 17, 27, 42, 24, 24, 30, 19, 21, 27, 41, 9, 0, 42, 27]"
123,26,1947,137,9166,0,229,1718,"[12, 423, 414, 396, 328, 542, 84, 386, 130, 403, 507, 556, 481, 185, 38, 545, 438, 474, 64, 281, 194, 489, 420, 34, 0, 226, 332]"
124,26,2075,5756,5485,0,299,1776,"[439, 549, 401, 561, 244, 396, 539, 501, 465, 145, 395, 203, 521, 119, 403, 9, 402, 385, 468, 120, 189, 197, 85, 576, 0, 25, 93]"
125,26,2281,275,7491,0,776,1505,"[19, 266, 7, 289, 438, 433, 172, 397, 345, 213, 383, 200, 282, 0, 211, 82, 144, 355, 164, 427, 397, 184, 289, 461, 0, 488, 474]"
126,26,1493,1179,7805,0,326,1167,"[298, 134, 381, 375, 312, 171, 251, 341, 13, 157, 228, 283, 174, 220, 147, 74, 386, 339, 121, 16, 96, 354, 273, 308, 0, 23, 143]"
127,26,2444,2306,7943,0,2041,403,"[105, 14, 102, 124, 57, 59, 116, 20, 33, 111, 68, 115, 133, 126, 130, 119, 114, 57, 12, 84, 116, 30, 63, 97, 0, 106, 102]"
128,26,1464,739,8668,0,66,1398,"[146, 466, 421, 209, 292, 420, 27, 289, 214, 82, 380, 234, 233, 389, 236, 293, 437, 75, 16, 86, 402, 242, 98, 242, 0, 250, 386]"
129,26,1155,1,9822,0,980,175,"[47, 49, 35, 37, 26, 25, 25, 34, 14, 11, 28, 11, 3, 31, 58, 34, 3, 56, 58, 21, 26, 8, 8, 57, 0, 48, 32]"
130,26,1124,416,10000,530,239,885,"[260, 283, 212, 16, 27, 204, 77, 271, 155, 183, 268, 72, 264, 213, 79, 51, 147, 68, 59, 127, 11, 97, 231, 30, 0, 153, 250]"
131,26,1940,5005,6935,0,943,997,"[79, 194, 255, 105, 203, 183, 162, 231, 166, 57, 67, 230, 224, 0, 50, 50, 160, 116, 305, 110, 275, 68, 273, 132, 0, 274, 154]"
132,26,2859,2644,7150,0,2829,30,"[1, 8, 10, 2, 8, 7, 10, 0, 7, 7, 9, 8, 9, 5, 10, 1, 0, 6, 5, 10, 3, 4, 3, 9, 0, 0, 1]"
133,26,1643,552,8241,0,1031,612,"[98, 97, 57, 161, 26, 196, 82, 131, 179, 155, 133, 142, 157, 147, 80, 185, 105, 29, 87, 88, 199, 83, 62, 186, 0, 81, 181]"
134,26,2454,1754,8941,0,498,1956,"[431, 160, 500, 62, 240, 295, 468, 528, 621, 630, 181, 105, 283, 18, 383, 331, 561, 369, 312, 576, 124, 433, 349, 505, 0, 572, 314]"
135,26,1944,1526,9359,0,1669,275,"[16, 18, 55, 62, 55, 26, 31, 27, 16, 74, 71, 58, 30, 46, 28, 45, 18, 21, 71, 13, 49, 17, 18, 46, 0, 49, 3]"
136,26,2926,6356,5929,0,1401,1525,"[173, 124, 294, 24, 229, 424, 150, 317, 490, 299, 178, 197, 230, 2, 21, 117, 171, 260, 262, 285, 449, 489, 387, 408, 0, 209, 292]"
137,26,1078,635,6372,0,802,276,"[78, 39, 70, 67, 66, 4, 59, 1, 0, 5, 87, 19, 30, 54, 4, 2, 1, 66, 78, 18, 83, 84, 46, 29, 0, 38, 12]"
138,26,2037,849,7560,0,377,1660,"[509, 347, 238, 414, 395, 306, 263, 134, 115, 244, 353, 62, 551, 311, 164, 96, 171, 234, 103, 506, 372, 420, 4, 411, 0, 189, 198]"
139,26,1201,779,7982,0,331,870,"[175, 20, 155, 289, 142, 106, 240, 224, 270, 146, 75, 173, 25, 94, 68, 219, 71, 82, 205, 46, 212, 94, 234, 271, 0, 141, 277]"
140,26,1928,1907,8003,0,11,1917,"[559, 376, 400, 573, 253, 208, 74, 345, 453, 373, 51, 246, 304, 336, 20, 209, 310, 624, 426, 486, 566, 373, 295, 162, 0, 631, 604]"
141,26,1324,337,8990,0,351,973,"[222, 78, 20, 19, 120, 225, 71, 196, 246, 162, 50, 11, 29, 68, 82, 144, 7, 211, 299, 211, 317, 56, 310, 216, 0, 177, 18]"
142,26,1385,1221,9154,0,1016,369,"[89, 92, 19, 83, 105, 95, 106, 57, 81, 0, 113, 10, 25, 6, 19, 109, 106, 108, 18, 111, 91, 60, 102, 41, 0, 121, 90]"
143,26,1708,717,10000,145,591,1117,"[108, 336, 170, 192, 40, 241, 208, 152, 150, 367, 366, 92, 347, 83, 278, 242, 331, 82, 181, 268, 57, 265, 63, 157, 0, 131, 200]"
144,26,2118,7204,4914,0,570,1548,"[179, 290, 190, 436, 130, 373, 395, 39, 226, 482, 191, 224, 204, 398, 296, 51, 440, 436, 203, 200, 373, 38, 212, 488, 0, 20, 422]"
145,26,1124,669,5369,0,1103,21,"[0, 4, 7, 5, 0, 2, 1, 2, 6, 7, 1, 5, 6, 3, 7, 5, 1, 7, 4, 2, 3, 6, 4, 2, 0, 4, 3]"
146,26,2895,2294,5970,0,2441,454,"[121, 72, 125, 132, 129, 5, 95, 103, 14, 64, 26, 98, 18, 101, 107, 86, 116, 70, 29, 81, 43, 33, 88, 127, 0, 103, 118]"
147,26,2475,598,7847,0,1802,673,"[66, 119, 217, 29, 86, 27, 196, 215, 143, 168, 204, 4, 162, 202, 13, 35, 93, 106, 217, 13, 82, 63, 178, 112, 0, 28, 88]"
148,26,2170,120,9897,0,121,2049,"[385, 423, 6, 242, 200, 618, 613, 180, 449, 165, 62, 422, 457, 354, 573, 266, 480, 161, 287, 583, 19, 467, 100, 589, 0, 172, 63]"
149,26,1418,6950,4365,0,956,462,"[68, 29, 33, 142, 84, 0, 17, 99, 98, 34, 66, 146, 111, 131, 106, 11, 105, 56, 89, 3, 8, 63, 35, 63, 0, 146, 118]"
150,26,1241,80,5526,0,926,315,"[97, 99, 73, 20, 9, 69, 42, 44, 67, 84, 88, 81, 13, 61, 63, 98, 64, 6, 33, 38, 28, 80, 29, 52, 0, 50, 95]"
151,26,1853,1162,6217,0,632,1221,"[389, 300, 274, 300, 35, 266, 177, 316, 93, 349, 389, 233, 381, 23, 291, 376, 237, 131, 144, 54, 195, 208, 298, 42, 0, 382, 54]"
152,26,2216,1944,6489,0,216,2000,"[174, 90, 263, 356, 311, 614, 61, 611, 346, 425, 477, 497, 281, 5, 305, 563, 5, 603, 574, 666, 529, 620, 377, 178, 0, 175, 35]"
153,26,1767,681,7575,0,1507,260,"[21, 73, 42, 11, 6, 77, 10, 41, 29, 42, 22, 38, 5, 73, 37, 5, 65, 82, 86, 78, 6, 2, 15, 55, 0, 10, 78]"
154,26,2356,2037,7894,0,724,1632,"[58, 521, 434, 389, 366, 321, 368, 153, 189, 154, 173, 3, 337, 256, 389, 359, 543, 350, 265, 515, 77, 345, 345, 475, 0, 304, 333]"
155,26,2953,866,9981,0,1602,1351,"[309, 190, 74, 129, 9, 233, 84, 284, 383, 232, 255, 259, 376, 434, 2, 76, 138, 274, 54, 331, 395, 120, 202, 82, 0, 186, 252]"
156,26,2307,5047,7241,0,1500,807,"[16, 109, 266, 165, 226, 208, 186, 17, 265, 48, 235, 160, 152, 251, 243, 51, 140, 44, 8, 157, 267, 256, 245, 168, 0, 174, 246]"
157,26,1323,616,7948,0,534,789,"[43, 148, 9, 227, 46, 252, 261, 163, 46, 98, 206, 85, 95, 255, 45, 263, 80, 52, 192, 175, 37, 105, 35, 69, 0, 212, 205]"
158,26,1255,1220,7983,0,1173,82,"[0, 4, 19, 21, 13, 19, 25, 0, 2, 7, 11, 4, 6, 16, 7, 0, 12, 18, 2, 25, 9, 18, 17, 13, 0, 17, 21]"
159,26,2068,365,9686,0,1646,422,"[29, 6, 116, 110, 69, 123, 1, 55, 104, 50, 101, 117, 82, 36, 74, 19, 129, 64, 97, 97, 30, 115, 79, 63, 0, 77, 17]"
160,26,2088,6432,5342,0,779,1309,"[378, 417, 119, 136, 198, 54, 300, 223, 299, 218, 250, 427, 428, 239, 69, 434, 328, 354, 368, 341, 209, 128, 38, 171, 0, 104, 435]"
161,26,1100,23,6419,0,512,588,"[40, 100, 110, 79, 121, 96, 178, 186, 84, 152, 130, 70, 52, 33, 50, 127, 156, 183, 72, 153, 159, 88, 40, 90, 0, 147, 73]"
162,26,2275,2065,6629,0,1693,582,"[152, 146, 104, 191, 146, 111, 180, 153, 171, 165, 151, 24, 165, 103, 23, 141, 128, 183, 88, 154, 49, 69, 170, 174, 0, 177, 39]"
163,26,1058,994,6693,0,305,753,"[251, 20, 195, 110, 51, 144, 184, 113, 25, 68, 82, 188, 251, 191, 233, 142, 210, 146, 138, 240, 232, 84, 145, 100, 0, 227, 12]"
164,26,2074,1418,7349,0,1440,634,"[61, 105, 159, 96, 176, 46, 41, 16, 12, 99, 133, 128, 26, 66, 23, 47, 201, 50, 32, 115, 4, 163, 99, 173, 0, 202, 50]"
165,26,2075,2019,7405,0,1035,1040,"[313, 110, 52, 61, 262, 159, 214, 204, 321, 157, 153, 45, 64, 112, 219, 56, 212, 94, 30, 320, 227, 183, 194, 88, 0, 346, 37]"
166,26,2993,1230,9168,0,1700,1293,"[137, 217, 218, 105, 263, 320, 413, 329, 382, 424, 152, 164, 237, 246, 198, 149, 242, 257, 424, 45, 292, 55, 52, 109, 0, 105, 397]"
167,26,2456,7304,4320,0,859,1597,"[263, 105, 487, 347, 478, 113, 200, 470, 322, 182, 298, 219, 306, 365, 308, 62, 48, 311, 340, 264, 401, 79, 102, 436, 0, 348, 164]"
168,26,1371,320,5371,0,862,509,"[32, 41, 143, 23, 85, 100, 37, 50, 126, 31, 76, 37, 164, 106, 159, 60, 84, 15, 75, 49, 151, 23, 124, 87, 0, 92, 38]"
169,26,2779,1581,6569,0,459,2320,"[197, 141, 163, 213, 89, 354, 54, 609, 107, 651, 483, 423, 637, 424, 708, 437, 115, 291, 676, 168, 504, 400, 351, 548, 0, 516, 76]"
170,26,2683,2000,7252,0,1008,1675,"[189, 102, 151, 23, 473, 32, 296, 372, 293, 308, 63, 523, 391, 143, 394, 335, 386, 4, 250, 538, 301, 542, 382, 265, 0, 206, 482]"
171,26,1574,156,8670,0,1387,187,"[33, 51, 5, 57, 8, 45, 61, 11, 61, 30, 6, 3, 16, 2, 15, 39, 28, 23, 43, 30, 18, 48, 54, 13, 0, 45, 57]"
172,26,1993,1951,8712,0,1183,810,"[7, 112, 184, 85, 13, 197, 8, 41, 140, 158, 177, 26, 77, 13, 116, 219, 97, 222, 215, 148, 192, 54, 88, 126, 0, 252, 97]"
173,26,1871,1775,8808,0,353,1518,"[501, 443, 57, 132, 267, 12, 282, 40, 259, 492, 68, 39, 486, 345, 230, 223, 388, 389, 63, 442, 241, 367, 182, 102, 0, 90, 428]"
174,26,1238,667,9379,0,273,965,"[166, 225, 194, 268, 264, 142, 145, 143, 141, 84, 319, 278, 53, 306, 148, 107, 9, 82, 261, 156, 53, 69, 310, 173, 0, 77, 124]"
175,26,2081,5956,5504,0,792,1289,"[136, 246, 388, 318, 213, 312, 337, 247, 58, 311, 369, 270, 356, 301, 330, 217, 128, 410, 4, 267, 347, 125, 287, 150, 0, 316, 383]"
176,26,2539,1909,6134,0,285,2254,"[438, 267, 89, 419, 474, 358, 536, 463, 743, 184, 247, 285, 252, 432, 145, 650, 689, 541, 150, 85, 465, 114, 458, 666, 0, 219, 355]"
177,26,2099,1925,6308,0,800,1299,"[373, 382, 278, 195, 265, 359, 223, 433, 223, 209, 343, 188, 301, 154, 83, 3, 87, 353, 112, 124, 23, 175, 279, 215, 0, 39, 148]"
178,26,2239,1709,6838,0,1947,292,"[71, 31, 49, 15, 84, 46, 72, 89, 93, 73, 9, 31, 12, 91, 72, 57, 5, 75, 20, 23, 84, 87, 22, 27, 0, 74, 90]"
179,26,1580,95,8323,0,87,1493,"[427, 255, 369, 289, 228, 300, 449, 152, 81, 197, 104, 337, 264, 289, 159, 284, 424, 233, 245, 213, 378, 127, 223, 321, 0, 83, 142]"
180,26,1714,1353,8684,0,1362,352,"[112, 11, 39, 98, 15, 34, 115, 105, 82, 91, 83, 112, 9, 20, 30, 42, 2, 41, 55, 61, 31, 66, 95, 40, 0, 64, 30]"
181,26,1618,436,9866,0,1047,571,"[183, 178, 66, 8, 84, 175, 143, 124, 42, 125, 99, 19, 36, 141, 4, 72, 172, 169, 104, 103, 122, 139, 41, 189, 0, 61, 75]"
182,26,1690,6435,5121,0,659,1031,"[202, 170, 145, 151, 12, 5, 212, 5, 149, 94, 223, 159, 302, 298, 286, 337, 220, 122, 321, 136, 231, 272, 317, 177, 0, 6, 189]"
183,26,2328,2092,5357,0,2003,325,"[82, 100, 18, 0, 91, 19, 54, 107, 11, 39, 77, 5, 87, 35, 9, 17, 73, 5, 23, 33, 84, 10, 60, 58, 0, 38, 40]"
184,26,1429,685,6101,0,203,1226,"[203, 288, 90, 155, 393, 349, 331, 228, 184, 292, 374, 333, 348, 345, 149, 331, 62, 135, 400, 291, 59, 225, 371, 142, 0, 165, 326]"
185,26,2709,529,8281,0,2106,603,"[98, 43, 110, 127, 24, 50, 71, 114, 152, 108, 100, 123, 196, 111, 70, 31, 86, 143, 41, 57, 105, 164, 60, 79, 0, 34, 108]"
186,26,1680,460,9501,0,599,1081,"[276, 335, 301, 151, 276, 212, 289, 137, 349, 292, 154, 106, 249, 266, 112, 344, 124, 142, 123, 93, 209, 124, 75, 265, 0, 96, 296]"
187,26,1324,1091,9734,0,479,845,"[10, 35, 86, 186, 269, 154, 110, 223, 45, 142, 278, 85, 5, 218, 280, 237, 85, 128, 165, 250, 271, 54, 11, 84, 0, 131, 185]"
188,26,2583,5854,6463,0,1996,587,"[137, 66, 8, 23, 46, 137, 30, 23, 53, 91, 83, 43, 127, 20, 178, 146, 159, 33, 148, 184, 83, 190, 30, 154, 0, 8, 12]"
189,26,1659,1645,6477,0,1012,647,"[99, 5, 192, 1, 152, 15, 7, 24, 183, 63, 153, 215, 160, 177, 3, 133, 54, 2, 203, 104, 125, 183, 33, 5, 0, 92, 39]"
190,26,2488,109,8856,0,690,1798,"[399, 487, 576, 528, 234, 2, 357, 500, 96, 301, 491, 175, 243, 459, 538, 317, 131, 287, 386, 261, 251, 363, 305, 402, 0, 133, 393]"
191,26,1423,475,9804,0,310,1113,"[53, 294, 268, 371, 207, 136, 146, 342, 349, 98, 349, 14, 116, 46, 27, 187, 219, 149, 101, 332, 239, 155, 217, 42, 0, 209, 238]"
192,26,2468,7392,4880,0,1822,646,"[165, 135, 144, 57, 155, 183, 133, 126, 197, 151, 118, 191, 92, 178, 9, 157, 212, 70, 145, 56, 143, 40, 189, 58, 0, 17, 177]"
193,26,2983,171,7692,0,1666,1317,"[134, 255, 110, 81, 233, 50, 76, 412, 250, 415, 324, 103, 121, 356, 315, 139, 389, 48, 260, 318, 27, 276, 234, 259, 0, 161, 23]"
194,26,2441,2198,7935,0,1005,1436,"[144, 200, 119, 78, 227, 21, 225, 125, 141, 142, 423, 262, 91, 31, 311, 197, 211, 214, 247, 33, 127, 279, 214, 147, 0, 24, 46]"
195,26,2766,1656,9045,0,2621,145,"[22, 22, 22, 9, 17, 25, 23, 47, 33, 19, 3, 35, 34, 40, 42, 13, 29, 36, 11, 5, 1, 0, 2, 9, 0, 38, 39]"
196,26,2272,5903,5414,0,41,2231,"[103, 646, 568, 381, 539, 333, 100, 362, 438, 329, 350, 641, 702, 247, 27, 366, 225, 517, 417, 454, 326, 225, 692, 314, 0, 668, 155]"
197,26,2379,328,7465,0,1373,1006,"[96, 150, 104, 7, 239, 227, 224, 165, 219, 278, 251, 30, 147, 154, 84, 287, 201, 54, 178, 146, 86, 87, 237, 292, 0, 188, 41]"
198,26,1296,46,8715,0,918,378,"[113, 97, 42, 54, 104, 28, 108, 77, 18, 61, 35, 13, 72, 78, 29, 67, 90, 78, 52, 119, 11, 47, 32, 75, 0, 92, 110]"
199,26,1556,437,9834,0,709,847,"[230, 79, 55, 189, 51, 233, 268, 82, 67, 64, 251, 273, 188, 221, 186, 243, 126, 87, 9, 181, 77, 117, 259, 96, 0, 264, 90]"
200,26,2921,6472,6283,0,820,2101,"[297, 4, 132, 36, 344, 461, 238, 642, 595, 195, 127, 219, 251, 112, 230, 143, 494, 489, 674, 171, 348, 240, 250, 111, 0, 0, 110]"
201,26,1175,659,6799,0,773,402,"[1, 64, 62, 28, 89, 13, 126, 8, 13, 3, 87, 8, 118, 48, 111, 28, 61, 13, 58, 42, 133, 35, 109, 6, 0, 67, 68]"
202,26,2846,22,9623,0,838,2008,"[228, 211, 110, 196, 290, 582, 65, 100, 82, 46, 100, 527, 71, 85, 435, 284, 35, 298, 523, 250, 50, 99, 282, 409, 0, 474, 227]"
203,26,2264,5839,6048,0,938,1326,"[386, 341, 81, 306, 12, 62, 152, 427, 151, 48, 205, 60, 361, 136, 411, 401, 275, 136, 262, 406, 47, 221, 108, 368, 0, 34, 398]"
204,26,1000,979,6069,0,708,292,"[79, 75, 7, 19, 68, 93, 41, 17, 59, 65, 88, 79, 58, 37, 17, 96, 78, 72, 94, 35, 24, 74, 96, 35, 0, 58, 60]"
205,26,2401,157,8313,0,1113,1288,"[302, 15, 340, 148, 2, 72, 232, 4, 379, 31, 186, 37, 376, 295, 310, 335, 111, 75, 220, 291, 244, 172, 158, 156, 0, 250, 224]"
206,26,1186,741,8758,0,48,1138,"[320, 315, 364, 68, 165, 34, 104, 92, 319, 121, 248, 174, 141, 0, 37, 295, 285, 222, 178, 3, 289, 118, 226, 344, 0, 225, 250]"
207,26,1904,993,9669,0,1598,306,"[86, 58, 77, 53, 50, 83, 52, 66, 75, 71, 29, 20, 36, 51, 88, 14, 83, 92, 35, 9, 25, 30, 75, 44, 0, 60, 45]"
208,26,2759,5537,6891,0,269,2490,"[246, 351, 89, 78, 199, 271, 829, 132, 148, 315, 9, 399, 734, 435, 185, 375, 789, 468, 17, 367, 412, 372, 592, 446, 0, 745, 144]"
209,26,2542,1595,7838,0,174,2368,"[725, 258, 177, 666, 521, 304, 606, 517, 729, 293, 386, 184, 368, 155, 420, 206, 215, 134, 478, 7, 530, 339, 739, 310, 0, 57, 182]"
210,26,2910,1312,9436,0,1842,1068,"[186, 198, 301, 313, 200, 219, 322, 220, 244, 93, 316, 41, 334, 224, 308, 275, 51, 331, 32, 17, 284, 15, 105, 248, 0, 338, 230]"
211,26,2241,6156,5521,0,1200,1041,"[189, 100, 292, 235, 125, 87, 242, 327, 198, 315, 26, 197, 39, 221, 94, 84, 298, 217, 100, 336, 215, 17, 95, 223, 0, 29, 63]"
212,26,1655,381,6795,0,90,1565,"[213, 333, 324, 64, 97, 239, 181, 341, 412, 360, 243, 345, 136, 130, 405, 85, 80, 477, 490, 460, 253, 458, 188, 1, 0, 443, 307]"
213,26,1555,1160,7190,0,1135,420,"[48, 35, 87, 132, 33, 40, 123, 115, 93, 121, 10, 55, 105, 30, 77, 50, 111, 10, 56, 122, 66, 66, 98, 118, 0, 61, 54]"
214,26,2650,491,9349,0,1537,1113,"[38, 224, 91, 319, 295, 184, 191, 365, 222, 113, 15, 196, 90, 350, 342, 88, 42, 174, 227, 253, 12, 260, 56, 253, 0, 223, 245]"
215,26,2415,5351,6413,0,1118,1297,"[75, 407, 260, 261, 250, 98, 176, 254, 207, 64, 4, 326, 206, 109, 40, 71, 4, 118, 368, 61, 240, 255, 340, 123, 0, 369, 318]"
216,26,1976,1451,6938,0,1862,114,"[9, 31, 26, 26, 29, 35, 30, 10, 7, 11, 14, 24, 32, 35, 7, 17, 34, 4, 19, 8, 37, 38, 25, 4, 0, 8, 34]"
217,26,1035,727,7246,0,699,336,"[96, 67, 12, 21, 107, 10, 44, 34, 27, 109, 4, 58, 1, 16, 79, 103, 111, 105, 23, 79, 92, 46, 8, 81, 0, 4, 78]"
218,26,1328,925,7649,0,48,1280,"[94, 244, 252, 306, 350, 403, 69, 371, 68, 75, 309, 339, 254, 79, 110, 274, 244, 271, 50, 321, 228, 75, 250, 424, 0, 323, 246]"
219,26,2905,1635,8919,0,890,2015,"[543, 633, 566, 357, 457, 483, 229, 600, 393, 400, 291, 290, 395, 183, 317, 122, 628, 312, 182, 156, 414, 540, 264, 330, 0, 61, 494]"
220,26,1557,898,9578,0,1075,482,"[51, 42, 151, 129, 40, 19, 24, 116, 106, 120, 98, 123, 52, 132, 105, 113, 159, 87, 0, 19, 101, 79, 43, 5, 0, 149, 90]"
221,26,2044,5238,6384,0,3,2041,"[658, 508, 193, 5, 14, 175, 503, 195, 88, 409, 23, 309, 21, 320, 547, 393, 500, 315, 469, 266, 118, 55, 111, 134, 0, 504, 10]"
222,26,2329,1506,7207,0,128,2201,"[635, 274, 513, 225, 731, 655, 156, 607, 598, 686, 354, 388, 385, 108, 394, 445, 180, 460, 365, 489, 543, 651, 274, 413, 0, 537, 582]"
223,26,1869,818,8258,0,899,970,"[202, 316, 269, 270, 161, 22, 275, 4, 244, 35, 110, 53, 127, 280, 126, 290, 266, 149, 28, 204, 61, 310, 186, 65, 0, 306, 183]"
224,26,2968,5879,5347,0,1695,1273,"[310, 397, 10, 69, 297, 10, 46, 117, 17, 144, 322, 410, 245, 103, 139, 400, 221, 395, 385, 104, 317, 258, 366, 172, 0, 156, 73]"
225,26,1986,1786,5547,0,161,1825,"[396, 41, 304, 145, 140, 435, 449, 142, 490, 587, 542, 240, 427, 369, 153, 70, 411, 431, 335, 378, 261, 201, 557, 265, 0, 27, 58]"
226,26,2853,886,7514,0,876,1977,"[633, 340, 637, 494, 480, 307, 639, 458, 330, 93, 439, 284, 368, 441, 61, 394, 151, 625, 502, 454, 299, 486, 487, 71, 0, 479, 486]"
227,26,2659,2007,8166,0,745,1914,"[94, 508, 130, 434, 52, 45, 370, 251, 94, 544, 147, 457, 389, 445, 582, 405, 225, 316, 542, 105, 386, 377, 99, 260, 0, 506, 5]"
228,26,1971,562,9575,0,1519,452,"[117, 93, 33, 65, 73, 93, 69, 78, 5, 54, 15, 118, 53, 10, 72, 60, 29, 143, 11, 114, 83, 9, 16, 110, 0, 107, 21]"
229,26,1588,5629,5534,0,882,706,"[169, 156, 108, 57, 145, 123, 12, 51, 2, 200, 56, 203, 215, 134, 82, 120, 171, 189, 229, 56, 51, 175, 6, 162, 0, 76, 99]"
230,26,1905,957,6482,0,1824,81,"[2, 13, 2, 12, 3, 15, 6, 5, 20, 21, 1, 17, 14, 15, 24, 20, 26, 7, 1, 25, 27, 11, 14, 20, 0, 25, 22]"
231,26,2030,121,8391,0,1828,202,"[66, 16, 12, 48, 16, 29, 4, 5, 63, 55, 61, 31, 22, 60, 1, 18, 47, 19, 20, 67, 38, 25, 61, 21, 0, 25, 59]"
232,26,1796,1058,9129,0,966,830,"[100, 41, 5, 241, 207, 84, 45, 154, 250, 171, 117, 201, 88, 189, 73, 24, 136, 39, 218, 32, 52, 107, 29, 108, 0, 117, 151]"
233,26,1998,6400,4727,0,190,1808,"[420, 279, 189, 45, 248, 586, 140, 583, 90, 512, 245, 482, 591, 134, 218, 224, 277, 350, 257, 86, 18, 372, 352, 138, 0, 120, 257]"
234,26,1448,1304,4871,0,48,1400,"[209, 414, 62, 106, 265, 39, 193, 428, 97, 38, 69, 121, 160, 81, 4, 212, 221, 82, 214, 126, 246, 272, 280, 417, 0, 434, 410]"
235,26,1123,555,5439,0,800,323,"[31, 33, 9, 30, 100, 44, 86, 4, 28, 24, 45, 37, 34, 105, 46, 101, 15, 60, 82, 73, 100, 91, 68, 24, 0, 59, 92]"
236,26,1792,724,6507,0,842,950,"[312, 96, 39, 223, 100, 23, 189, 205, 129, 140, 163, 261, 311, 49, 1, 232, 198, 145, 186, 211, 48, 177, 296, 78, 0, 200, 199]"
237,26,2786,1177,8116,0,1279,1507,"[402, 268, 343, 342, 407, 31, 343, 249, 447, 280, 433, 84, 352, 270, 360, 392, 221, 479, 142, 480, 359, 127, 46, 456, 0, 327, 321]"
238,26,2786,2482,8420,0,1053,1733,"[128, 117, 364, 226, 64, 552, 145, 469, 82, 330, 236, 385, 12, 17, 526, 372, 572, 91, 449, 285, 465, 416, 512, 121, 0, 483, 11]"
239,26,2506,2224,8702,0,2192,314,"[18, 32, 89, 66, 66, 102, 65, 102, 101, 72, 6, 39, 7, 74, 65, 98, 49, 40, 24, 44, 60, 35, 101, 86, 0, 88, 3]"
240,26,2915,5538,6079,0,2146,769,"[33, 129, 60, 111, 189, 174, 74, 163, 7, 234, 20, 157, 222, 21, 78, 244, 95, 66, 53, 70, 14, 173, 82, 222, 0, 144, 134]"
241,26,1293,205,7167,0,30,1263,"[355, 55, 191, 21, 61, 95, 270, 382, 241, 38, 228, 23, 86, 269, 194, 327, 99, 125, 241, 123, 121, 31, 216, 82, 0, 300, 165]"
242,26,1687,1542,7312,0,1532,155,"[5, 45, 33, 46, 51, 5, 25, 7, 30, 14, 17, 8, 50, 8, 50, 32, 32, 36, 38, 14, 33, 10, 31, 2, 0, 48, 25]"
243,26,2350,125,9537,0,1329,1021,"[230, 208, 213, 59, 5, 89, 229, 156, 163, 198, 203, 64, 335, 8, 48, 105, 307, 280, 45, 50, 17, 44, 279, 211, 0, 21, 63]"
244,26,1100,1036,9601,0,642,458,"[141, 19, 53, 20, 99, 73, 46, 91, 91, 45, 116, 63, 41, 0, 91, 67, 83, 113, 124, 7, 101, 21, 54, 121, 0, 52, 115]"
245,26,1257,1138,9720,0,964,293,"[97, 24, 60, 44, 33, 28, 24, 51, 20, 42, 20, 28, 9, 23, 92, 1, 33, 74, 76, 10, 12, 56, 19, 7, 0, 7, 55]"
246,26,2135,5963,5892,0,354,1781,"[432, 294, 588, 327, 495, 419, 563, 238, 353, 274, 313, 206, 584, 149, 527, 427, 247, 40, 333, 413, 522, 195, 426, 394, 0, 277, 243]"
247,26,2000,1311,6581,0,1930,70,"[4, 16, 12, 7, 16, 19, 2, 21, 8, 17, 9, 5, 3, 21, 5, 6, 7, 14, 2, 22, 16, 12, 1, 7, 0, 7, 19]"
248,26,2146,1888,6839,0,371,1775,"[197, 292, 408, 261, 85, 513, 471, 417, 489, 253, 533, 155, 249, 369, 200, 563, 394, 488, 318, 507, 486, 215, 397, 63, 0, 27, 109]"
249,26,2768,112,9495,0,196,2572,"[259, 457, 291, 507, 386, 271, 50, 565, 382, 766, 143, 236, 112, 319, 371, 277, 211, 274, 21, 840, 357, 636, 265, 443, 0, 693, 216]"
250,26,2145,5267,6373,0,1484,661,"[182, 218, 131, 131, 147, 46, 119, 27, 108, 182, 92, 44, 43, 213, 185, 208, 157, 167, 136, 161, 160, 213, 205, 9, 0, 171, 18]"
251,26,2252,1207,7418,0,674,1578,"[237, 447, 374, 363, 308, 420, 227, 364, 365, 174, 277, 157, 279, 503, 396, 306, 165, 83, 97, 297, 138, 264, 305, 396, 0, 508, 101]"
252,26,2148,1750,7816,0,1827,321,"[68, 54, 24, 71, 99, 76, 9, 76, 33, 80, 45, 34, 25, 37, 2, 72, 25, 30, 11, 40, 31, 23, 37, 46, 0, 107, 88]"
253,26,1387,861,8342,0,1229,158,"[15, 38, 35, 30, 44, 0, 34, 52, 30, 9, 28, 28, 1, 38, 32, 25, 20, 19, 24, 40, 44, 26, 1, 8, 0, 4, 30]"
254,26,2755,6404,4693,0,794,1961,"[171, 653, 547, 434, 100, 12, 575, 36, 619, 27, 130, 115, 197, 323, 115, 527, 342, 281, 352, 161, 199, 279, 385, 234, 0, 466, 466]"
255,26,2975,1430,6238,0,1587,1388,"[319, 420, 287, 92, 115, 144, 108, 408, 84, 440, 460, 197, 271, 155, 237, 108, 256, 387, 71, 362, 51, 70, 330, 280, 0, 122, 277]"
256,26,1150,806,6582,0,573,577,"[12, 59, 1, 118, 160, 72, 167, 91, 10, 76, 76, 68, 77, 99, 144, 31, 63, 149, 170, 75, 141, 75, 152, 113, 0, 28, 107]"
257,26,1470,598,7454,0,622,848,"[195, 148, 232, 137, 230, 158, 105, 152, 89, 137, 34, 151, 106, 171, 143, 124, 147, 116, 194, 100, 35, 113, 124, 6, 0, 28, 177]"
258,26,1202,505,8151,0,165,1037,"[207, 27, 54, 61, 37, 282, 320, 191, 199, 82, 153, 180, 54, 308, 192, 185, 186, 170, 277, 152, 130, 299, 191, 311, 0, 109, 288]"
259,26,2025,771,9405,0,308,1717,"[211, 281, 94, 373, 393, 146, 299, 37, 376, 523, 175, 1, 88, 512, 329, 163, 136, 177, 246, 107, 395, 526, 336, 294, 0, 455, 246]"
260,26,2337,6810,4932,0,598,1739,"[437, 551, 333, 165, 514, 220, 550, 523, 192, 551, 362, 208, 388, 39, 268, 21, 76, 510, 250, 187, 201, 526, 195, 319, 0, 445, 370]"
261,26,1696,910,5718,0,975,721,"[85, 95, 121, 73, 10, 83, 5, 189, 44, 61, 113, 185, 23, 124, 62, 1, 198, 96, 78, 147, 163, 200, 137, 186, 0, 21, 160]"
262,26,2650,845,7523,0,2000,650,"[135, 139, 110, 56, 92, 90, 97, 102, 50, 1, 140, 48, 8, 15, 46, 162, 196, 214, 83, 17, 175, 171, 102, 97, 0, 138, 103]"
263,26,2909,2446,7986,0,2409,500,"[87, 61, 59, 5, 133, 151, 45, 125, 0, 9, 98, 91, 101, 13, 85, 66, 106, 154, 87, 116, 112, 1, 105, 46, 0, 36, 57]"
264,26,2240,109,10000,117,1228,1012,"[80, 266, 88, 143, 30, 1, 245, 317, 113, 73, 252, 248, 180, 102, 336, 60, 282, 198, 17, 209, 83, 103, 236, 333, 0, 136, 206]"
265,26,2792,6812,5980,0,2636,156,"[43, 42, 48, 16, 22, 37, 37, 3, 14, 22, 27, 41, 1, 23, 21, 49, 8, 11, 11, 33, 28, 23, 51, 35, 0, 23, 25]"
266,26,1479,409,7050,0,1045,434,"[121, 109, 28, 3, 38, 57, 53, 3, 57, 93, 58, 77, 75, 37, 20, 116, 5, 47, 0, 99, 26, 24, 31, 11, 0, 118, 51]"
267,26,2022,1969,7103,0,1231,791,"[143, 175, 144, 174, 171, 158, 25, 94, 213, 223, 7, 30, 54, 42, 212, 142, 138, 104, 147, 85, 28, 18, 183, 185, 0, 115, 225]"
268,26,1613,620,8096,0,455,1158,"[68, 355, 317, 354, 99, 24, 92, 323, 48, 31, 337, 333, 372, 221, 287, 369, 124, 314, 70, 120, 46, 329, 347, 265, 0, 187, 264]"
269,26,1344,442,8998,0,571,773,"[156, 184, 247, 38, 252, 77, 213, 193, 40, 153, 139, 247, 229, 51, 2, 0, 154, 163, 38, 54, 244, 206, 147, 225, 0, 59, 35]"
270,26,2790,7360,4428,0,372,2418,"[49, 53, 92, 791, 424, 105, 505, 750, 747, 7, 100, 309, 183, 313, 734, 246, 424, 655, 396, 155, 615, 119, 728, 516, 0, 700, 574]"
271,26,2952,2113,5267,0,2158,794,"[37, 30, 93, 161, 26, 179, 256, 98, 175, 83, 50, 222, 210, 134, 226, 20, 161, 116, 34, 3, 169, 121, 181, 30, 0, 84, 221]"
272,26,1488,861,5894,0,42,1446,"[458, 193, 454, 86, 457, 252, 430, 81, 252, 51, 409, 466, 320, 252, 97, 424, 74, 231, 354, 140, 173, 64, 440, 132, 0, 165, 228]"
273,26,1750,453,7191,0,568,1182,"[209, 228, 341, 254, 218, 329, 217, 126, 373, 342, 3, 278, 340, 10, 391, 239, 240, 247, 360, 379, 214, 50, 308, 83, 0, 114, 37]"
274,26,2344,432,9103,0,1350,994,"[323, 324, 303, 218, 196, 254, 126, 73, 232, 235, 147, 208, 266, 173, 297, 209, 104, 267, 148, 229, 14, 90, 76, 286, 0, 75, 125]"
275,26,1137,742,9498,0,278,859,"[155, 73, 87, 204, 3, 150, 168, 120, 39, 239, 211, 172, 146, 256, 69, 133, 160, 56, 202, 85, 140, 115, 69, 75, 0, 169, 37]"
276,26,2529,6504,5523,0,1081,1448,"[384, 417, 276, 100, 254, 384, 271, 32, 328, 343, 205, 437, 177, 192, 320, 2, 76, 186, 274, 338, 329, 368, 56, 9, 0, 215, 432]"
277,26,2050,497,7076,0,1122,928,"[133, 272, 119, 184, 217, 179, 265, 234, 28, 201, 107, 213, 278, 71, 209, 81, 88, 178, 35, 244, 62, 124, 30, 25, 0, 271, 262]"
278,26,1855,974,7957,0,994,861,"[135, 224, 272, 66, 272, 74, 176, 87, 23, 158, 169, 178, 230, 85, 109, 231, 276, 262, 279, 198, 153, 8, 45, 171, 0, 200, 128]"
279,26,1358,61,9254,0,838,520,"[146, 102, 5, 125, 70, 83, 155, 108, 15, 32, 96, 94, 60, 48, 53, 95, 84, 35, 105, 165, 43, 75, 153, 65, 0, 158, 142]"
280,26,2154,6311,5097,0,1773,381,"[27, 85, 86, 72, 34, 51, 110, 103, 26, 56, 44, 48, 104, 121, 47, 6, 8, 24, 45, 89, 49, 0, 45, 63, 0, 1, 34]"
281,26,1110,445,5762,0,865,245,"[33, 15, 44, 36, 38, 11, 46, 79, 16, 38, 68, 76, 58, 56, 33, 71, 6, 33, 77, 58, 79, 69, 21, 57, 0, 45, 55]"
282,26,2256,1573,6445,0,686,1570,"[329, 70, 423, 449, 137, 72, 20, 501, 236, 154, 238, 202, 449, 277, 516, 274, 84, 419, 292, 379, 164, 320, 36, 244, 0, 208, 416]"
283,26,2172,1709,6908,0,63,2109,"[547, 94, 203, 699, 287, 178, 338, 415, 703, 333, 524, 209, 274, 416, 649, 203, 538, 696, 79, 136, 109, 564, 42, 33, 0, 510, 577]"
284,26,1634,38,8504,0,1022,612,"[78, 41, 171, 112, 102, 43, 7, 190, 58, 150, 25, 129, 82, 41, 77, 165, 25, 144, 28, 142, 28, 170, 27, 77, 0, 7, 187]"
285,26,2022,1052,9474,0,1304,718,"[78, 205, 124, 32, 60, 0, 123, 118, 153, 19, 175, 152, 129, 48, 193, 57, 15, 6, 108, 201, 10, 49, 239, 76, 0, 57, 122]"
286,26,1291,32,10000,733,391,900,"[71, 69, 284, 28, 163, 155, 288, 280, 195, 66, 71, 6, 223, 82, 51, 208, 297, 286, 15, 246, 34, 45, 29, 242, 0, 176, 91]"
287,26,2039,5139,6900,0,1774,265,"[85, 21, 69, 62, 73, 7, 48, 32, 66, 81, 20, 15, 55, 52, 84, 8, 5, 57, 12, 21, 70, 27, 71, 43, 0, 80, 36]"
288,26,2373,1294,7979,0,1316,1057,"[335, 128, 113, 96, 287, 83, 124, 200, 49, 243, 19, 93, 163, 276, 26, 132, 177, 206, 134, 305, 348, 129, 188, 123, 0, 33, 32]"
289,26,1162,953,8188,0,844,318,"[94, 7, 41, 72, 72, 95, 52, 61, 48, 99, 81, 34, 94, 32, 86, 30, 100, 5, 63, 21, 53, 57, 5, 2, 0, 37, 13]"
290,26,1189,197,9180,0,223,966,"[190, 322, 157, 169, 2, 284, 296, 174, 138, 198, 83, 214, 42, 64, 47, 114, 99, 8, 69, 215, 239, 284, 282, 110, 0, 44, 247]"
291,26,2027,7085,4122,0,1991,36,"[0, 1, 1, 9, 1, 7, 7, 6, 10, 4, 12, 0, 4, 10, 3, 2, 6, 8, 6, 6, 11, 6, 4, 7, 0, 6, 4]"
292,26,2776,2039,4859,0,839,1937,"[571, 395, 633, 118, 9, 260, 163, 355, 59, 24, 490, 578, 20, 357, 568, 98, 264, 503, 365, 555, 401, 14, 628, 490, 0, 264, 69]"
293,26,1593,1323,5129,0,524,1069,"[17, 313, 295, 161, 43, 280, 339, 354, 106, 305, 108, 270, 106, 64, 274, 337, 115, 75, 7, 254, 190, 182, 157, 26, 0, 83, 302]"
294,26,1195,85,6239,0,6,1189,"[378, 234, 266, 267, 215, 247, 278, 34, 351, 115, 173, 55, 145, 70, 15, 4, 84, 396, 192, 110, 224, 360, 395, 116, 0, 351, 388]"
295,26,2000,305,7934,0,60,1940,"[391, 318, 447, 597, 240, 237, 174, 194, 106, 356, 142, 637, 571, 403, 249, 150, 43, 637, 442, 455, 454, 7, 415, 254, 0, 262, 163]"
296,26,1246,77,9103,0,690,556,"[37, 35, 44, 59, 33, 25, 155, 36, 107, 124, 120, 146, 108, 23, 150, 34, 182, 36, 43, 18, 33, 123, 142, 134, 0, 72, 18]"
297,26,1024,596,9531,0,212,812,"[134, 92, 62, 206, 6, 25, 232, 133, 100, 86, 42, 204, 71, 51, 175, 212, 239, 240, 122, 206, 74, 95, 88, 41, 0, 17, 60]"
298,26,2844,6260,6115,0,1501,1343,"[51, 99, 415, 192, 38, 121, 121, 303, 273, 381, 282, 29, 160, 131, 108, 303, 398, 330, 386, 378, 78, 102, 81, 173, 0, 274, 92]"
299,26,2030,771,7374,0,1583,447,"[28, 13, 50, 101, 75, 98, 26, 70, 18, 123, 122, 35, 35, 101, 141, 136, 5, 41, 75, 54, 74, 132, 125, 78, 0, 20, 148]"
0,27,4930,0,4930,0,1984,2946,"[608, 500, 335, 745, 674, 209, 247, 898, 486, 171, 754, 246, 447, 661, 748, 142, 374, 617, 435, 552, 845, 732, 781, 284, 95, 0, 650]"
1,27,3763,1485,7208,0,1712,2051,"[127, 481, 8, 232, 261, 501, 21, 327, 116, 468, 322, 414, 330, 36, 182, 451, 116, 238, 601, 57, 353, 605, 346, 589, 375, 0, 645]"
2,27,3129,2912,7425,0,2124,1005,"[160, 40, 163, 16, 103, 197, 263, 208, 157, 131, 280, 77, 86, 147, 221, 247, 219, 283, 98, 31, 189, 6, 94, 302, 24, 0, 15]"
3,27,3186,344,10000,267,1861,1325,"[388, 347, 234, 370, 337, 53, 59, 133, 130, 42, 261, 104, 424, 423, 169, 363, 30, 279, 19, 217, 327, 58, 162, 253, 281, 0, 28]"
4,27,4706,6874,7832,0,2166,2540,"[800, 560, 127, 555, 221, 525, 315, 307, 307, 488, 65, 569, 106, 380, 319, 371, 63, 757, 223, 715, 825, 331, 138, 305, 827, 0, 636]"
5,27,4884,7307,5409,0,1459,3425,"[727, 839, 510, 763, 684, 707, 511, 546, 825, 782, 807, 620, 462, 252, 14, 357, 787, 18, 597, 1009, 559, 328, 588, 688, 206, 0, 1113]"
6,27,4431,1548,8292,0,2838,1593,"[426, 491, 10, 25, 466, 250, 329, 437, 338, 459, 239, 386, 259, 4, 108, 397, 486, 215, 407, 145, 314, 20, 126, 214, 458, 0, 456]"
7,27,4797,5559,7530,0,1197,3600,"[1191, 405, 290, 772, 505, 1003, 686, 956, 20, 836, 605, 142, 316, 723, 1112, 1124, 937, 1068, 18, 431, 19, 201, 621, 69, 1091, 0, 653]"
8,27,3478,5114,5894,0,3458,20,"[2, 1, 3, 6, 1, 3, 2, 2, 1, 4, 2, 5, 4, 1, 4, 3, 6, 1, 4, 3, 2, 6, 3, 0, 3, 0, 4]"
9,27,4256,3545,6605,0,130,4126,"[1315, 994, 513, 349, 747, 1225, 499, 1328, 771, 813, 1213, 1192, 213, 960, 1162, 1095, 499, 497, 684, 503, 391, 1267, 41, 619, 521, 0, 89]"
10,27,3002,2415,7192,0,376,2626,"[215, 74, 618, 224, 646, 373, 524, 451, 654, 556, 236, 465, 40, 337, 653, 433, 725, 134, 406, 739, 470, 469, 456, 862, 484, 0, 495]"
11,27,4974,6286,5880,0,243,4731,"[425, 1127, 1533, 1435, 42, 1331, 1296, 245, 604, 34, 117, 1285, 415, 1068, 1051, 61, 148, 903, 334, 1421, 854, 692, 1461, 867, 1145, 0, 73]"
12,27,4622,96,10000,406,1770,2852,"[246, 560, 278, 37, 243, 827, 693, 566, 271, 13, 205, 290, 785, 387, 595, 72, 630, 435, 397, 630, 848, 232, 465, 631, 106, 0, 627]"
13,27,3185,5669,7516,0,1,3184,"[82, 45, 980, 335, 728, 808, 656, 422, 188, 937, 587, 405, 681, 949, 323, 647, 637, 8, 1057, 903, 321, 914, 572, 874, 399, 0, 404]"
14,27,4559,5264,6811,0,2160,2399,"[444, 96, 604, 53, 86, 23, 790, 51, 776, 304, 73, 123, 335, 305, 731, 577, 193, 8, 427, 552, 574, 215, 717, 448, 75, 0, 523]"
15,27,4278,6457,4632,0,155,4123,"[432, 445, 1358, 240, 1099, 1349, 672, 575, 1004, 1012, 33, 399, 871, 932, 174, 552, 397, 575, 132, 428, 120, 1287, 597, 413, 1370, 0, 670]"
16,27,3691,1123,7200,0,2834,857,"[29, 255, 121, 180, 65, 202, 31, 224, 183, 117, 230, 53, 164, 109, 133, 237, 95, 166, 256, 108, 236, 83, 22, 145, 278, 0, 188]"
17,27,4623,6567,5256,0,274,4349,"[634, 547, 1304, 1056, 22, 528, 560, 1224, 1208, 547, 1135, 1391, 969, 129, 148, 121, 819, 693, 1439, 1282, 428, 295, 728, 169, 588, 0, 355]"
18,27,3330,715,7871,0,509,2821,"[518, 56, 179, 444, 11, 562, 102, 601, 618, 639, 285, 560, 856, 70, 860, 269, 494, 459, 815, 201, 409, 371, 828, 726, 384, 0, 124]"
19,27,4812,5720,6963,0,2041,2771,"[408, 726, 241, 688, 380, 703, 187, 350, 467, 235, 662, 90, 554, 676, 392, 272, 816, 109, 259, 894, 590, 72, 113, 548, 410, 0, 260]"
20,27,4417,5470,5910,0,4271,146,"[2, 1, 8, 33, 35, 12, 39, 48, 6, 28, 47, 14, 16, 38, 0, 36, 33, 20, 46, 26, 24, 33, 8, 2, 40, 0, 24]"
21,27,4346,3977,6279,0,1346,3000,"[650, 245, 108, 662, 162, 944, 701, 748, 755, 840, 562, 873, 275, 110, 301, 749, 479, 985, 479, 15, 990, 401, 71, 827, 571, 0, 558]"
22,27,4341,691,9929,0,2897,1444,"[67, 73, 6, 87, 169, 429, 194, 217, 243, 76, 323, 0, 137, 140, 355, 301, 41, 363, 470, 363, 440, 267, 313, 251, 350, 0, 126]"
23,27,3232,6149,7012,0,1030,2202,"[128, 115, 179, 445, 198, 310, 610, 198, 614, 281, 313, 467, 590, 19, 557, 492, 386, 197, 559, 171, 624, 131, 396, 661, 137, 0, 406]"
24,27,3018,138,9892,0,2909,109,"[21, 25, 15, 34, 32, 29, 25, 9, 21, 11, 32, 0, 0, 17, 34, 30, 33, 31, 2, 5, 23, 10, 30, 18, 7, 0, 4]"
25,27,4682,7460,7114,0,1975,2707,"[274, 861, 488, 238, 631, 350, 761, 216, 749, 294, 159, 599, 617, 259, 886, 582, 691, 656, 798, 826, 222, 863, 874, 273, 493, 0, 37]"
26,27,3566,994,9686,0,185,3381,"[416, 277, 329, 375, 864, 846, 324, 991, 198, 1065, 968, 956, 371, 270, 1036, 921, 236, 995, 58, 993, 930, 252, 896, 254, 42, 0, 958]"
27,27,4477,5057,9106,0,1349,3128,"[702, 919, 903, 499, 253, 467, 516, 1026, 687, 852, 938, 427, 580, 83, 578, 787, 525, 903, 410, 516, 803, 985, 552, 213, 280, 0, 667]"
28,27,3895,6378,6623,0,456,3439,"[784, 90, 16, 347, 157, 713, 320, 227, 491, 975, 597, 869, 1122, 197, 28, 83, 864, 182, 1028, 533, 457, 892, 69, 1101, 827, 0, 832]"
29,27,4039,237,10000,425,484,3555,"[50, 991, 31, 1133, 1060, 116, 649, 861, 762, 67, 278, 724, 786, 824, 1038, 359, 352, 1021, 96, 372, 346, 785, 609, 151, 1084, 0, 724]"
30,27,4881,6914,7967,0,2375,2506,"[775, 0, 776, 161, 538, 130, 759, 247, 739, 402, 434, 642, 260, 281, 43, 179, 86, 802, 467, 379, 232, 811, 167, 137, 403, 0, 698]"
31,27,4230,6455,5742,0,1410,2820,"[683, 278, 39, 38, 741, 658, 688, 571, 641, 891, 218, 733, 299, 872, 434, 479, 183, 136, 660, 918, 333, 862, 316, 383, 13, 0, 815]"
32,27,4986,4565,6163,0,3091,1895,"[352, 234, 93, 440, 42, 375, 76, 260, 607, 257, 297, 471, 465, 323, 587, 571, 52, 542, 368, 539, 483, 150, 131, 179, 59, 0, 611]"
33,27,4637,1056,9744,0,1258,3379,"[620, 339, 622, 754, 790, 41, 420, 1029, 579, 973, 827, 403, 248, 557, 1008, 519, 963, 326, 1001, 300, 986, 476, 17, 830, 230, 0, 709]"
34,27,3592,6122,7214,0,1287,2305,"[529, 475, 49, 202, 88, 420, 14, 643, 763, 122, 28, 569, 93, 704, 121, 160, 567, 9, 268, 583, 729, 733, 738, 151, 452, 0, 539]"
35,27,4401,6814,4801,0,1540,2861,"[505, 74, 920, 697, 513, 917, 235, 71, 554, 561, 98, 662, 640, 880, 341, 170, 143, 381, 61, 289, 350, 157, 251, 414, 856, 0, 797]"
36,27,3630,438,7993,0,681,2949,"[512, 904, 277, 0, 815, 150, 578, 142, 659, 350, 705, 203, 111, 323, 624, 500, 577, 134, 953, 830, 788, 873, 674, 272, 954, 0, 212]"
37,27,4369,5318,7044,0,455,3914,"[272, 922, 821, 980, 688, 1195, 676, 803, 6, 836, 1216, 591, 9, 738, 164, 617, 652, 850, 433, 379, 575, 389, 16, 92, 262, 0, 1017]"
38,27,3439,2081,8402,0,1910,1529,"[89, 404, 446, 179, 473, 462, 462, 163, 264, 426, 328, 211, 31, 477, 108, 437, 255, 418, 393, 375, 129, 223, 444, 72, 51, 0, 335]"
39,27,4043,5808,6637,0,1534,2509,"[294, 367, 248, 487, 395, 415, 380, 521, 538, 556, 21, 325, 509, 639, 18, 699, 118, 820, 475, 164, 591, 789, 154, 513, 554, 0, 760]"
40,27,3403,3223,6817,0,2557,846,"[270, 105, 250, 178, 183, 28, 223, 215, 261, 41, 216, 48, 252, 96, 149, 208, 27, 207, 225, 180, 272, 193, 152, 275, 112, 0, 157]"
41,27,3361,1588,8590,0,9,3352,"[292, 12, 1035, 392, 334, 186, 314, 210, 561, 505, 955, 1017, 620, 812, 379, 537, 209, 384, 630, 691, 784, 583, 289, 55, 289, 0, 1025]"
42,27,3517,6646,5461,0,2730,787,"[67, 170, 122, 117, 110, 2, 56, 155, 46, 189, 75, 206, 68, 46, 239, 21, 153, 42, 135, 55, 243, 226, 95, 54, 154, 0, 102]"
43,27,4490,3089,6862,0,543,3947,"[801, 257, 887, 1199, 822, 741, 784, 121, 1099, 1246, 1169, 555, 260, 394, 1017, 1204, 475, 796, 1306, 240, 1028, 514, 105, 265, 964, 0, 1107]"
44,27,4809,7257,4414,0,3063,1746,"[271, 362, 96, 441, 300, 419, 198, 343, 383, 505, 281, 311, 531, 163, 220, 318, 240, 456, 367, 308, 146, 355, 139, 393, 319, 0, 526]"
45,27,3522,2817,5119,0,2890,632,"[156, 40, 101, 84, 172, 90, 198, 87, 94, 4, 51, 121, 49, 176, 206, 168, 159, 206, 104, 157, 134, 57, 141, 207, 40, 0, 25]"
46,27,4961,2762,7318,0,314,4647,"[779, 1020, 630, 213, 1409, 1454, 473, 1252, 1139, 1118, 1054, 647, 1216, 947, 181, 1261, 1274, 666, 419, 273, 1406, 807, 266, 1026, 1107, 0, 222]"
47,27,3213,1585,8946,0,732,2481,"[120, 496, 814, 761, 727, 373, 377, 407, 536, 641, 180, 255, 11, 182, 131, 725, 733, 499, 71, 281, 599, 566, 457, 464, 114, 0, 275]"
48,27,4336,6422,6860,0,3871,465,"[61, 40, 137, 118, 11, 109, 90, 69, 60, 19, 123, 28, 28, 104, 7, 63, 23, 126, 46, 35, 102, 13, 135, 109, 20, 0, 56]"
49,27,3244,1604,8500,0,2403,841,"[139, 11, 116, 218, 126, 113, 109, 98, 88, 193, 14, 140, 276, 203, 48, 50, 211, 111, 235, 1, 93, 132, 148, 195, 147, 0, 208]"
50,27,3389,5636,6253,0,698,2691,"[660, 554, 757, 788, 619, 685, 671, 766, 16, 464, 140, 34, 351, 502, 684, 340, 188, 140, 221, 397, 291, 119, 485, 46, 516, 0, 434]"
51,27,4478,2573,8158,0,151,4327,"[437, 1002, 676, 1229, 1010, 983, 1219, 1117, 245, 485, 812, 48, 1162, 32, 572, 961, 360, 494, 1222, 1117, 1214, 338, 207, 1377, 422, 0, 1025]"
52,27,4593,6101,6650,0,4381,212,"[2, 28, 61, 0, 62, 66, 3, 37, 69, 2, 51, 35, 40, 17, 0, 44, 49, 50, 8, 62, 25, 37, 58, 4, 52, 0, 43]"
53,27,3129,1497,8282,0,2408,721,"[232, 114, 164, 63, 170, 67, 76, 129, 167, 121, 118, 168, 4, 83, 3, 8, 76, 194, 180, 183, 140, 2, 146, 37, 143, 0, 69]"
54,27,3573,7093,4762,0,179,3394,"[847, 584, 251, 639, 1003, 86, 989, 1130, 46, 816, 161, 750, 1083, 416, 546, 677, 409, 190, 390, 1065, 529, 291, 367, 139, 738, 0, 34]"
55,27,4044,89,8717,0,42,4002,"[543, 1132, 3, 267, 670, 1011, 615, 1227, 747, 214, 672, 18, 1253, 486, 1176, 1241, 603, 1117, 1038, 469, 435, 919, 555, 197, 201, 0, 298]"
56,27,3300,6362,5655,0,265,3035,"[114, 932, 867, 895, 337, 436, 129, 198, 837, 530, 545, 849, 148, 659, 676, 511, 195, 891, 34, 687, 40, 516, 979, 706, 441, 0, 161]"
57,27,3926,1532,8049,0,233,3693,"[56, 224, 1173, 865, 236, 203, 526, 524, 168, 509, 885, 360, 850, 588, 593, 552, 385, 1165, 224, 228, 208, 432, 1186, 426, 934, 0, 701]"
58,27,4276,5474,6851,0,3981,295,"[73, 20, 26, 32, 0, 6, 21, 38, 23, 63, 92, 26, 47, 43, 52, 9, 41, 23, 97, 3, 65, 89, 66, 91, 85, 0, 37]"
59,27,4912,6032,5731,0,1590,3322,"[580, 710, 771, 272, 1032, 1045, 1057, 874, 829, 95, 845, 1102, 126, 522, 684, 934, 261, 1069, 999, 275, 144, 546, 356, 332, 781, 0, 1089]"
60,27,3615,349,8997,0,3358,257,"[7, 3, 5, 36, 85, 13, 20, 83, 62, 1, 60, 85, 84, 11, 39, 51, 1, 7, 56, 83, 56, 25, 26, 70, 12, 0, 71]"
61,27,4060,6861,6196,0,3051,1009,"[77, 139, 268, 282, 101, 224, 286, 16, 154, 253, 58, 286, 31, 222, 64, 223, 58, 119, 185, 222, 150, 199, 150, 302, 128, 0, 142]"
62,27,3759,338,9617,0,771,2988,"[91, 642, 696, 461, 258, 138, 586, 222, 39, 970, 591, 87, 743, 246, 815, 725, 516, 392, 446, 602, 397, 615, 535, 39, 430, 0, 514]"
63,27,4377,6722,7272,0,3239,1138,"[375, 321, 44, 97, 259, 50, 10, 58, 145, 216, 248, 204, 32, 78, 8, 244, 338, 364, 248, 59, 303, 231, 239, 169, 351, 0, 69]"
64,27,3956,7143,4085,0,2711,1245,"[18, 262, 314, 126, 274, 6, 330, 376, 368, 401, 332, 370, 319, 324, 403, 169, 244, 25, 154, 230, 385, 230, 206, 236, 56, 0, 353]"
65,27,4580,2197,6468,0,1707,2873,"[344, 437, 707, 877, 685, 193, 745, 144, 119, 398, 15, 466, 893, 35, 649, 13, 472, 635, 604, 643, 769, 293, 901, 201, 308, 0, 524]"
66,27,4518,2249,8737,0,2682,1836,"[221, 91, 96, 479, 216, 260, 271, 196, 392, 137, 346, 494, 563, 578, 187, 262, 117, 92, 385, 460, 400, 310, 159, 513, 396, 0, 381]"
67,27,4549,5572,7714,0,1501,3048,"[481, 1002, 425, 1000, 489, 907, 335, 992, 172, 1014, 469, 925, 341, 285, 372, 208, 704, 43, 358, 855, 690, 869, 561, 876, 183, 0, 196]"
68,27,4527,6294,5947,0,420,4107,"[616, 229, 91, 1075, 582, 1318, 457, 1005, 1292, 690, 61, 1118, 963, 884, 849, 670, 393, 990, 1056, 1284, 723, 823, 1209, 1338, 664, 0, 873]"
69,27,4694,3906,6735,0,369,4325,"[1244, 1373, 252, 469, 398, 462, 1102, 1020, 426, 481, 172, 1016, 305, 96, 701, 206, 917, 1406, 465, 1164, 644, 95, 365, 360, 308, 0, 1420]"
70,27,4706,5755,5686,0,839,3867,"[67, 9, 465, 597, 568, 140, 1253, 703, 1012, 198, 311, 309, 1226, 528, 987, 204, 772, 46, 380, 1240, 266, 1273, 978, 978, 22, 0, 1088]"
71,27,4284,4186,5784,0,296,3988,"[1231, 162, 329, 1069, 862, 329, 496, 94, 927, 96, 126, 1092, 534, 1260, 48, 556, 543, 575, 844, 419, 1279, 125, 1175, 658, 440, 0, 418]"
72,27,3028,1016,7796,0,2932,96,"[9, 29, 26, 12, 10, 7, 14, 6, 21, 22, 31, 15, 29, 24, 23, 26, 13, 9, 4, 19, 6, 27, 28, 28, 5, 0, 9]"
73,27,4209,6694,5311,0,2595,1614,"[174, 486, 402, 209, 208, 343, 178, 316, 98, 121, 57, 502, 467, 47, 184, 132, 327, 471, 432, 15, 178, 303, 65, 327, 536, 0, 296]"
74,27,4847,175,9983,0,4668,179,"[4, 9, 3, 7, 30, 4, 37, 27, 1, 41, 35, 22, 3, 1, 18, 16, 51, 1, 59, 18, 26, 41, 23, 11, 19, 0, 43]"
75,27,3083,5642,7424,0,918,2165,"[690, 715, 367, 51, 633, 442, 128, 328, 57, 573, 180, 564, 264, 565, 354, 53, 42, 643, 688, 283, 449, 450, 695, 528, 136, 0, 578]"
76,27,4131,6404,5151,0,1012,3119,"[197, 112, 85, 826, 874, 234, 794, 1011, 266, 543, 852, 245, 609, 342, 173, 513, 705, 765, 756, 134, 489, 851, 731, 32, 413, 0, 158]"
77,27,3850,1972,7029,0,2757,1093,"[234, 46, 343, 93, 187, 268, 260, 11, 276, 245, 25, 344, 180, 77, 6, 249, 211, 335, 116, 264, 274, 290, 195, 358, 264, 0, 151]"
78,27,4257,6781,4505,0,3827,430,"[78, 65, 118, 137, 62, 79, 120, 0, 84, 44, 96, 129, 31, 97, 98, 101, 23, 112, 78, 8, 81, 17, 50, 32, 33, 0, 109]"
79,27,3655,2043,6117,0,1988,1667,"[99, 133, 547, 318, 219, 401, 41, 255, 288, 458, 393, 11, 206, 524, 438, 250, 89, 196, 277, 555, 249, 101, 370, 511, 313, 0, 391]"
80,27,4543,3348,7312,0,1652,2891,"[584, 734, 382, 826, 28, 889, 593, 730, 458, 439, 349, 35, 108, 859, 881, 233, 545, 54, 143, 525, 680, 896, 916, 121, 618, 0, 377]"
81,27,3054,55,10000,311,1740,1314,"[304, 434, 10, 35, 120, 56, 30, 197, 82, 69, 273, 398, 66, 22, 253, 23, 343, 421, 277, 381, 289, 330, 260, 386, 195, 0, 194]"
82,27,4979,5587,9392,0,1151,3828,"[180, 624, 561, 1274, 423, 164, 299, 632, 121, 1120, 950, 879, 1102, 863, 76, 2, 334, 218, 439, 866, 1186, 1047, 999, 202, 237, 0, 685]"
83,27,3600,5416,7576,0,110,3490,"[598, 175, 271, 272, 647, 247, 590, 250, 711, 981, 827, 47, 533, 58, 1040, 444, 885, 920, 16, 495, 254, 271, 386, 58, 646, 0, 331]"
84,27,4584,6963,5197,0,824,3760,"[556, 1223, 892, 209, 254, 887, 50, 1042, 1101, 16, 964, 1017, 402, 553, 899, 655, 696, 7, 591, 261, 721, 843, 397, 980, 938, 0, 250]"
85,27,4671,2381,7487,0,556,4115,"[759, 363, 964, 800, 1111, 627, 672, 301, 465, 891, 850, 1082, 408, 578, 695, 114, 1190, 114, 53, 120, 946, 675, 788, 753, 1183, 0, 761]"
86,27,4364,5007,6844,0,2378,1986,"[271, 532, 409, 303, 366, 297, 289, 1, 61, 509, 587, 14, 622, 569, 108, 381, 575, 36, 68, 409, 424, 511, 5, 475, 350, 0, 346]"
87,27,3205,2504,7545,0,2991,214,"[47, 70, 55, 26, 15, 19, 46, 59, 22, 61, 50, 13, 60, 37, 48, 70, 38, 23, 31, 32, 23, 70, 9, 1, 28, 0, 16]"
88,27,3579,5080,6044,0,3424,155,"[31, 4, 4, 4, 31, 42, 42, 47, 41, 21, 30, 29, 3, 5, 3, 37, 32, 7, 15, 36, 44, 27, 50, 46, 40, 0, 9]"
89,27,4908,3715,7237,0,2227,2681,"[722, 806, 294, 493, 347, 666, 543, 560, 95, 320, 229, 20, 128, 140, 477, 882, 862, 42, 406, 694, 88, 879, 836, 35, 182, 0, 660]"
90,27,4877,5008,7106,0,3707,1170,"[246, 270, 91, 324, 163, 174, 152, 16, 274, 110, 29, 88, 99, 112, 85, 28, 300, 80, 94, 103, 374, 193, 117, 260, 165, 0, 17]"
91,27,4959,6325,5740,0,1051,3908,"[336, 1209, 298, 95, 689, 808, 346, 688, 745, 924, 1093, 342, 556, 484, 1211, 1104, 915, 869, 221, 69, 595, 1234, 249, 957, 868, 0, 232]"
92,27,4610,1255,9095,0,2213,2397,"[564, 553, 574, 674, 682, 623, 588, 279, 357, 46, 182, 506, 35, 488, 66, 590, 571, 426, 275, 145, 181, 376, 508, 165, 718, 0, 166]"
93,27,3691,6649,6137,0,2626,1065,"[67, 132, 278, 47, 177, 291, 318, 347, 266, 234, 289, 219, 264, 34, 154, 75, 34, 70, 13, 179, 35, 207, 307, 158, 63, 0, 349]"
94,27,4717,631,10000,223,227,4490,"[1121, 744, 1003, 1373, 1152, 441, 316, 1471, 329, 195, 211, 295, 1472, 500, 760, 783, 78, 659, 704, 1431, 300, 1381, 771, 600, 182, 0, 1411]"
95,27,3809,6941,6868,0,1775,2034,"[647, 29, 51, 219, 478, 575, 177, 332, 387, 611, 221, 426, 512, 436, 222, 579, 670, 401, 112, 192, 452, 60, 56, 572, 482, 0, 664]"
96,27,4400,6279,4989,0,238,4162,"[891, 359, 890, 384, 1187, 1147, 616, 232, 850, 341, 662, 760, 336, 1121, 823, 1121, 165, 430, 580, 33, 420, 892, 1378, 1083, 1325, 0, 343]"
97,27,4420,915,8494,0,2998,1422,"[64, 218, 354, 237, 204, 46, 63, 377, 348, 240, 466, 381, 222, 383, 414, 203, 287, 331, 81, 359, 23, 443, 246, 414, 66, 0, 166]"
98,27,4692,5568,7618,0,4081,611,"[50, 16, 83, 53, 69, 149, 7, 26, 161, 115, 191, 6, 87, 48, 59, 50, 175, 186, 8, 14, 48, 7, 159, 90, 162, 0, 116]"
99,27,4130,6470,5278,0,3232,898,"[70, 87, 142, 169, 286, 217, 3, 209, 38, 189, 208, 194, 150, 50, 236, 263, 198, 31, 178, 279, 100, 39, 266, 141, 209, 0, 245]"
100,27,4923,698,9503,0,2018,2905,"[907, 104, 916, 884, 99, 605, 401, 562, 42, 414, 852, 599, 885, 194, 350, 52, 372, 255, 750, 70, 959, 781, 273, 394, 910, 0, 780]"
101,27,4872,6519,7856,0,3413,1459,"[153, 55, 436, 391, 189, 272, 418, 438, 104, 242, 465, 367, 407, 346, 349, 54, 192, 291, 315, 101, 90, 281, 304, 13, 247, 0, 129]"
102,27,4604,6705,5755,0,4174,430,"[17, 1, 35, 105, 1, 104, 16, 119, 14, 48, 95, 131, 17, 100, 142, 35, 108, 63, 96, 71, 36, 88, 105, 41, 123, 0, 121]"
103,27,3236,1265,7726,0,2840,396,"[95, 78, 49, 13, 122, 83, 68, 126, 102, 127, 79, 12, 65, 53, 73, 43, 111, 26, 9, 59, 98, 1, 97, 113, 74, 0, 28]"
104,27,3375,5128,5973,0,2202,1173,"[12, 239, 309, 15, 317, 342, 164, 263, 12, 277, 70, 43, 368, 267, 321, 308, 170, 288, 245, 227, 343, 173, 159, 302, 353, 0, 301]"
105,27,3341,2579,6735,0,2854,487,"[71, 162, 96, 61, 34, 145, 68, 77, 117, 159, 119, 161, 143, 25, 15, 144, 59, 118, 152, 74, 45, 23, 162, 6, 51, 0, 43]"
106,27,3957,3724,6968,0,3919,38,"[8, 1, 10, 8, 9, 4, 11, 3, 11, 8, 12, 8, 8, 12, 7, 7, 6, 11, 7, 9, 11, 1, 11, 9, 0, 0, 6]"
107,27,3762,3711,7019,0,1939,1823,"[304, 83, 332, 90, 464, 543, 400, 0, 533, 414, 491, 162, 277, 599, 395, 307, 555, 103, 41, 11, 117, 317, 160, 391, 564, 0, 274]"
108,27,4704,5467,6256,0,472,4232,"[963, 450, 289, 1122, 563, 92, 1338, 900, 1124, 1392, 686, 837, 172, 855, 498, 1162, 457, 1243, 473, 5, 1384, 138, 1086, 805, 367, 0, 990]"
109,27,4606,3503,7359,0,1453,3153,"[224, 797, 432, 76, 935, 703, 330, 767, 804, 953, 6, 320, 179, 510, 838, 816, 522, 353, 837, 281, 133, 769, 924, 469, 496, 0, 342]"
110,27,4323,6592,5090,0,3234,1089,"[280, 16, 194, 182, 348, 135, 73, 316, 351, 127, 81, 153, 154, 283, 117, 253, 37, 222, 271, 256, 317, 175, 342, 44, 336, 0, 50]"
111,27,3690,1172,7608,0,2370,1320,"[201, 117, 169, 36, 155, 350, 6, 285, 164, 324, 9, 86, 246, 137, 181, 36, 397, 183, 230, 119, 252, 436, 338, 264, 159, 0, 146]"
112,27,3482,6562,4528,0,2363,1119,"[73, 3, 229, 68, 370, 46, 297, 373, 84, 117, 121, 68, 15, 235, 77, 242, 208, 351, 362, 296, 125, 152, 73, 290, 172, 0, 8]"
113,27,3952,650,7830,0,941,3011,"[256, 907, 356, 337, 843, 801, 224, 958, 359, 217, 395, 104, 273, 703, 508, 327, 78, 569, 249, 11, 883, 443, 816, 124, 709, 0, 864]"
114,27,3889,6642,5077,0,755,3134,"[496, 837, 278, 237, 585, 565, 685, 365, 123, 531, 855, 825, 221, 546, 797, 770, 735, 855, 134, 191, 699, 855, 480, 165, 494, 0, 326]"
115,27,4985,3838,6224,0,4445,540,"[66, 37, 114, 17, 42, 128, 79, 140, 76, 8, 175, 1, 31, 104, 118, 67, 117, 12, 52, 134, 70, 95, 99, 115, 167, 0, 119]"
116,27,4688,1680,9232,0,343,4345,"[971, 557, 720, 986, 437, 432, 792, 1279, 1239, 578, 860, 1136, 110, 569, 963, 119, 1244, 934, 1111, 899, 826, 310, 374, 477, 401, 0, 486]"
117,27,4621,7500,6353,0,4532,89,"[17, 29, 13, 23, 13, 25, 22, 28, 16, 10, 3, 4, 22, 16, 27, 17, 26, 7, 25, 16, 20, 18, 13, 2, 14, 0, 12]"
118,27,4937,6644,4646,0,4180,757,"[145, 99, 33, 70, 123, 126, 46, 209, 143, 108, 187, 239, 2, 189, 25, 146, 3, 137, 121, 155, 146, 5, 35, 100, 187, 0, 17]"
119,27,3920,2158,6408,0,2687,1233,"[209, 186, 154, 291, 152, 224, 393, 186, 236, 243, 153, 96, 143, 235, 242, 190, 3, 374, 175, 167, 335, 25, 263, 361, 208, 0, 69]"
120,27,4198,2729,7877,0,3429,769,"[85, 219, 1, 211, 213, 234, 107, 82, 171, 218, 163, 256, 23, 38, 65, 199, 191, 244, 108, 205, 241, 154, 74, 53, 170, 0, 244]"
121,27,4064,6916,5025,0,2940,1124,"[13, 242, 73, 352, 135, 23, 298, 45, 194, 28, 64, 162, 49, 351, 358, 24, 73, 3, 340, 224, 137, 42, 203, 132, 220, 0, 27]"
122,27,3488,2426,6087,0,332,3156,"[183, 115, 46, 1028, 557, 727, 303, 747, 817, 120, 332, 85, 464, 412, 243, 952, 650, 719, 639, 266, 950, 406, 819, 132, 892, 0, 703]"
123,27,3362,1369,8080,0,2746,616,"[55, 172, 53, 137, 145, 15, 93, 136, 90, 51, 55, 138, 45, 152, 62, 173, 197, 158, 130, 108, 70, 108, 175, 167, 100, 0, 136]"
124,27,3983,5897,6166,0,2795,1188,"[128, 255, 115, 70, 309, 186, 99, 323, 108, 161, 356, 2, 148, 380, 240, 311, 164, 95, 356, 23, 242, 231, 274, 267, 314, 0, 385]"
125,27,4294,644,9816,0,2159,2135,"[434, 310, 574, 515, 5, 387, 321, 411, 155, 38, 598, 407, 501, 506, 272, 559, 402, 42, 227, 117, 326, 212, 527, 14, 574, 0, 514]"
126,27,4627,7453,6990,0,3474,1153,"[130, 284, 126, 199, 356, 101, 19, 384, 284, 305, 39, 365, 100, 11, 279, 225, 51, 159, 177, 336, 337, 274, 280, 328, 377, 0, 292]"
127,27,3905,688,10000,207,1025,2880,"[345, 355, 371, 566, 875, 937, 955, 38, 208, 550, 956, 86, 847, 693, 116, 84, 180, 285, 17, 246, 519, 870, 696, 839, 837, 0, 567]"
128,27,4709,5376,9333,0,1726,2983,"[848, 310, 35, 604, 984, 69, 767, 253, 205, 180, 910, 670, 373, 340, 278, 335, 455, 811, 92, 706, 585, 963, 421, 130, 989, 0, 662]"
129,27,3007,6677,5663,0,1049,1958,"[190, 567, 223, 196, 227, 635, 124, 183, 510, 20, 586, 109, 484, 203, 561, 428, 219, 409, 478, 477, 604, 388, 276, 554, 291, 0, 56]"
130,27,3192,2731,6124,0,2732,460,"[52, 0, 71, 41, 17, 150, 125, 132, 39, 37, 106, 58, 52, 102, 64, 149, 113, 36, 23, 90, 47, 116, 96, 2, 100, 0, 9]"
131,27,3529,2990,6663,0,566,2963,"[985, 862, 72, 483, 368, 9, 279, 339, 306, 524, 239, 800, 131, 906, 203, 856, 928, 763, 861, 268, 779, 195, 275, 919, 888, 0, 880]"
132,27,3389,2120,7932,0,1030,2359,"[691, 421, 191, 437, 690, 613, 365, 579, 198, 554, 387, 310, 542, 78, 192, 468, 473, 449, 333, 626, 464, 673, 103, 40, 118, 0, 167]"
133,27,3314,6477,4769,0,3038,276,"[3, 70, 43, 49, 25, 78, 58, 24, 69, 45, 18, 69, 13, 11, 73, 69, 86, 64, 40, 22, 76, 5, 64, 6, 62, 0, 52]"
134,27,3455,1531,6693,0,1410,2045,"[524, 336, 427, 467, 169, 76, 386, 230, 435, 43, 187, 159, 19, 137, 456, 338, 91, 97, 557, 292, 634, 165, 227, 303, 370, 0, 647]"
135,27,4569,7201,4061,0,1124,3445,"[548, 46, 1102, 6, 489, 949, 25, 199, 832, 443, 504, 149, 66, 101, 499, 1129, 1024, 281, 642, 1074, 627, 516, 1066, 164, 580, 0, 458]"
136,27,4593,4165,4489,0,433,4160,"[188, 397, 1225, 813, 100, 1378, 79, 985, 1283, 503, 147, 198, 1265, 398, 1128, 588, 1295, 1317, 266, 582, 1016, 889, 1351, 330, 715, 0, 1367]"
137,27,3412,2735,5166,0,397,3015,"[692, 13, 749, 732, 79, 579, 376, 350, 690, 717, 270, 902, 579, 303, 163, 253, 452, 288, 819, 408, 974, 335, 837, 801, 369, 0, 686]"
138,27,3493,600,8059,0,1781,1712,"[277, 219, 186, 129, 162, 188, 123, 566, 278, 233, 369, 402, 64, 442, 362, 50, 369, 552, 241, 525, 475, 456, 171, 497, 550, 0, 30]"
139,27,3987,5509,6537,0,1734,2253,"[716, 717, 287, 664, 639, 274, 234, 236, 9, 107, 215, 490, 378, 728, 734, 373, 610, 420, 440, 260, 192, 130, 60, 47, 517, 0, 574]"
140,27,3926,1791,8672,0,995,2931,"[696, 436, 861, 776, 627, 493, 950, 581, 400, 929, 930, 769, 67, 74, 297, 964, 378, 271, 811, 344, 5, 884, 556, 356, 37, 0, 175]"
141,27,4659,6138,7193,0,997,3662,"[402, 488, 532, 1104, 883, 836, 218, 804, 9, 355, 1092, 902, 570, 112, 1163, 96, 874, 548, 1040, 1192, 1052, 273, 612, 1068, 301, 0, 839]"
142,27,4569,6109,5653,0,2848,1721,"[17, 221, 14, 174, 175, 116, 567, 439, 445, 246, 504, 419, 87, 305, 395, 231, 357, 386, 69, 496, 15, 83, 473, 288, 199, 0, 309]"
143,27,3452,841,8264,0,588,2864,"[178, 515, 124, 780, 561, 237, 647, 319, 255, 502, 915, 464, 275, 579, 685, 863, 641, 652, 704, 879, 192, 605, 342, 868, 733, 0, 593]"
144,27,3160,6307,5117,0,1491,1669,"[451, 255, 110, 299, 441, 486, 251, 243, 517, 391, 76, 89, 83, 204, 141, 535, 193, 323, 139, 524, 436, 325, 456, 89, 473, 0, 556]"
145,27,4455,1468,8104,0,2854,1601,"[526, 79, 207, 313, 459, 174, 137, 269, 381, 339, 61, 117, 94, 99, 121, 101, 114, 455, 524, 114, 406, 420, 45, 433, 214, 0, 221]"
146,27,3371,6516,4959,0,495,2876,"[347, 676, 188, 441, 100, 251, 415, 654, 497, 801, 117, 507, 36, 355, 839, 173, 657, 455, 874, 795, 349, 276, 787, 668, 109, 0, 237]"
147,27,4739,2677,7021,0,465,4274,"[204, 104, 1258, 524, 545, 1338, 146, 878, 237, 322, 905, 1392, 1228, 393, 156, 1375, 380, 685, 670, 746, 954, 1105, 1226, 1251, 87, 0, 325]"
148,27,3681,1372,9330,0,1761,1920,"[127, 114, 457, 147, 104, 382, 364, 443, 587, 164, 119, 110, 540, 603, 528, 78, 199, 219, 148, 539, 515, 77, 119, 45, 312, 0, 570]"
149,27,4591,7335,6586,0,3913,678,"[184, 123, 67, 97, 204, 125, 213, 191, 134, 153, 184, 65, 88, 112, 185, 106, 82, 2, 109, 42, 177, 131, 58, 85, 146, 0, 110]"
150,27,4806,5178,6214,0,2379,2427,"[447, 278, 689, 71, 84, 450, 435, 376, 220, 471, 482, 699, 400, 104, 264, 351, 606, 637, 419, 39, 599, 55, 154, 80, 323, 0, 580]"
151,27,4529,3388,7355,0,367,4162,"[1364, 423, 229, 489, 556, 1088, 409, 817, 383, 1095, 1363, 811, 464, 1240, 910, 513, 412, 892, 336, 63, 521, 1204, 1031, 22, 1084, 0, 1372]"
152,27,3187,2727,7815,0,940,2247,"[135, 475, 44, 150, 449, 699, 698, 543, 231, 270, 736, 581, 640, 142, 393, 744, 227, 469, 672, 139, 21, 127, 676, 262, 429, 0, 565]"
153,27,4669,5673,6811,0,4268,401,"[17, 84, 71, 24, 125, 60, 66, 105, 1, 39, 102, 8, 52, 10, 36, 69, 46, 36, 12, 2, 33, 112, 109, 100, 109, 0, 74]"
154,27,4123,717,10000,217,1456,2667,"[731, 312, 85, 811, 853, 176, 784, 491, 1, 30, 370, 290, 120, 371, 366, 107, 112, 595, 456, 546, 739, 93, 532, 489, 210, 0, 619]"
155,27,4432,6819,7613,0,2466,1966,"[391, 340, 27, 53, 448, 108, 397, 289, 304, 131, 360, 525, 1, 377, 135, 210, 585, 445, 363, 415, 240, 518, 630, 74, 19, 0, 170]"
156,27,3845,7209,4249,0,835,3010,"[211, 826, 450, 898, 409, 26, 72, 851, 316, 736, 807, 213, 57, 699, 242, 367, 114, 35, 653, 537, 969, 862, 854, 110, 654, 0, 254]"
157,27,4580,1514,7315,0,4259,321,"[52, 23, 91, 60, 106, 97, 90, 60, 51, 73, 90, 70, 37, 17, 97, 23, 86, 88, 28, 42, 103, 68, 29, 60, 5, 0, 83]"
158,27,3069,1191,9193,0,2790,279,"[52, 27, 8, 82, 28, 68, 29, 16, 66, 54, 20, 90, 21, 19, 86, 17, 86, 31, 73, 61, 0, 27, 39, 88, 67, 0, 29]"
159,27,3868,6600,6461,0,2739,1129,"[94, 316, 11, 257, 64, 47, 300, 172, 242, 262, 305, 319, 193, 215, 120, 71, 350, 245, 281, 135, 68, 133, 351, 271, 102, 0, 288]"
160,27,4529,2002,8988,0,4424,105,"[23, 1, 28, 27, 0, 22, 21, 20, 35, 14, 22, 26, 35, 19, 12, 5, 33, 7, 24, 30, 7, 23, 23, 32, 24, 0, 7]"
161,27,4026,6510,6504,0,3451,575,"[64, 5, 172, 155, 69, 135, 18, 21, 87, 144, 126, 49, 44, 9, 54, 90, 70, 64, 119, 30, 132, 185, 48, 100, 186, 0, 166]"
162,27,3237,999,8742,0,2684,553,"[68, 21, 55, 162, 108, 75, 168, 42, 100, 55, 125, 120, 183, 117, 45, 10, 132, 43, 118, 124, 37, 162, 36, 54, 152, 0, 109]"
163,27,3880,7382,5240,0,172,3708,"[373, 1087, 1106, 109, 928, 12, 815, 81, 1099, 648, 1120, 742, 333, 217, 460, 1233, 746, 350, 74, 108, 379, 453, 253, 793, 352, 0, 796]"
164,27,3437,1657,7020,0,2343,1094,"[246, 331, 331, 33, 247, 119, 298, 227, 80, 292, 37, 195, 243, 279, 72, 151, 159, 238, 306, 120, 221, 128, 3, 158, 227, 0, 55]"
165,27,4800,5965,5855,0,3646,1154,"[227, 32, 101, 280, 265, 187, 368, 376, 89, 46, 206, 314, 244, 271, 200, 25, 151, 141, 80, 121, 122, 366, 350, 81, 42, 0, 215]"
166,27,4578,3068,7365,0,3708,870,"[225, 98, 230, 269, 270, 157, 237, 247, 108, 264, 126, 287, 161, 168, 114, 12, 231, 130, 96, 3, 173, 87, 259, 192, 70, 0, 131]"
167,27,3397,1284,9478,0,2397,1000,"[200, 142, 98, 80, 187, 179, 204, 144, 138, 216, 235, 57, 306, 112, 212, 271, 50, 223, 206, 181, 80, 56, 94, 200, 234, 0, 89]"
168,27,4202,5925,7755,0,3497,705,"[207, 153, 86, 137, 136, 153, 43, 45, 233, 230, 101, 108, 133, 167, 55, 9, 115, 82, 28, 89, 177, 47, 152, 41, 102, 0, 106]"
169,27,4839,6599,5995,0,2793,2046,"[3, 148, 303, 210, 342, 517, 369, 526, 674, 518, 66, 414, 57, 631, 251, 92, 429, 392, 513, 543, 466, 507, 464, 561, 260, 0, 321]"
170,27,4141,1860,8276,0,514,3627,"[553, 887, 88, 238, 73, 701, 489, 633, 853, 638, 1054, 539, 275, 443, 558, 810, 527, 352, 661, 462, 496, 450, 292, 779, 561, 0, 82]"
171,27,3988,6821,5443,0,3910,78,"[20, 8, 3, 11, 17, 12, 25, 26, 19, 7, 25, 14, 7, 7, 12, 6, 15, 19, 11, 3, 4, 7, 6, 24, 7, 0, 14]"
172,27,3348,2602,6189,0,1793,1555,"[407, 322, 364, 419, 418, 308, 148, 516, 335, 80, 79, 460, 104, 31, 162, 470, 79, 158, 256, 499, 483, 292, 210, 146, 378, 0, 161]"
173,27,3031,1942,7278,0,139,2892,"[585, 425, 883, 764, 789, 485, 535, 150, 875, 588, 899, 227, 745, 229, 239, 664, 29, 505, 692, 737, 804, 939, 625, 113, 238, 0, 435]"
174,27,3043,34,10000,287,186,2857,"[2, 510, 344, 371, 544, 322, 864, 638, 315, 684, 135, 149, 198, 217, 845, 277, 938, 358, 808, 527, 47, 202, 272, 500, 60, 0, 504]"
175,27,3661,5863,7798,0,595,3066,"[157, 706, 634, 262, 212, 272, 33, 714, 2, 72, 710, 644, 1014, 134, 283, 516, 404, 522, 507, 137, 351, 231, 969, 884, 613, 0, 663]"
176,27,4243,5714,6327,0,4110,133,"[12, 17, 4, 0, 12, 32, 26, 17, 40, 21, 26, 32, 15, 15, 5, 36, 31, 27, 7, 27, 24, 40, 40, 12, 24, 0, 24]"
177,27,3579,222,9684,0,2042,1537,"[447, 55, 202, 320, 470, 408, 430, 362, 34, 409, 44, 490, 163, 110, 294, 19, 79, 165, 362, 457, 224, 419, 76, 68, 169, 0, 490]"
178,27,4316,5792,8208,0,253,4063,"[1034, 319, 683, 237, 301, 180, 1062, 937, 1251, 1305, 1348, 1262, 348, 567, 548, 652, 549, 638, 211, 573, 255, 846, 464, 583, 54, 0, 110]"
179,27,4955,6481,6682,0,2798,2157,"[532, 342, 647, 39, 598, 497, 158, 116, 638, 564, 464, 331, 111, 547, 389, 141, 208, 614, 425, 505, 243, 411, 471, 575, 512, 0, 315]"
180,27,4566,6131,5117,0,1281,3285,"[449, 466, 30, 826, 573, 221, 263, 339, 768, 631, 54, 933, 1069, 820, 36, 1039, 752, 707, 289, 45, 273, 758, 205, 576, 130, 0, 242]"
181,27,3539,2927,5729,0,1281,2258,"[437, 456, 742, 10, 351, 310, 307, 287, 657, 734, 678, 526, 37, 574, 455, 152, 69, 598, 664, 228, 85, 644, 503, 59, 573, 0, 12]"
182,27,4699,1537,8891,0,3117,1582,"[271, 486, 346, 25, 2, 422, 398, 504, 366, 375, 76, 371, 62, 328, 220, 273, 223, 378, 31, 479, 152, 147, 204, 87, 213, 0, 222]"
183,27,4961,7420,6432,0,3628,1333,"[38, 443, 423, 204, 235, 371, 352, 429, 355, 214, 235, 148, 147, 107, 359, 280, 376, 336, 29, 284, 147, 104, 360, 415, 224, 0, 402]"
184,27,3621,3130,6923,0,2401,1220,"[217, 217, 16, 72, 241, 187, 51, 220, 294, 223, 345, 153, 151, 184, 130, 398, 86, 117, 120, 167, 0, 275, 20, 27, 306, 0, 276]"
185,27,4328,6667,4584,0,58,4270,"[680, 321, 104, 890, 823, 505, 1345, 1236, 858, 843, 710, 140, 430, 1189, 983, 1285, 915, 61, 685, 828, 252, 540, 107, 1367, 692, 0, 753]"
186,27,3066,162,7488,0,2476,590,"[132, 93, 125, 82, 25, 187, 42, 106, 15, 180, 23, 91, 62, 142, 94, 128, 63, 61, 93, 157, 98, 126, 13, 95, 141, 0, 68]"
187,27,3270,2891,7867,0,3009,261,"[86, 17, 74, 70, 85, 70, 70, 40, 34, 28, 12, 46, 41, 82, 58, 70, 21, 27, 60, 65, 50, 34, 27, 77, 9, 0, 63]"
188,27,3780,5751,5896,0,2756,1024,"[285, 341, 230, 101, 330, 104, 160, 218, 230, 247, 44, 107, 149, 271, 68, 298, 85, 55, 62, 164, 70, 278, 78, 182, 168, 0, 266]"
189,27,4227,1668,8455,0,3632,595,"[52, 179, 118, 170, 178, 185, 45, 33, 184, 58, 196, 164, 121, 116, 64, 149, 51, 152, 12, 70, 164, 24, 117, 156, 70, 0, 118]"
190,27,4604,5546,7513,0,1314,3290,"[320, 431, 288, 1026, 363, 360, 691, 135, 774, 964, 584, 64, 817, 21, 96, 345, 1040, 345, 560, 326, 780, 1094, 806, 723, 652, 0, 370]"
191,27,3083,1477,9119,0,146,2937,"[161, 873, 487, 687, 354, 507, 800, 291, 895, 968, 229, 652, 90, 874, 949, 871, 584, 248, 767, 841, 69, 340, 748, 15, 485, 0, 388]"
192,27,3407,6833,5693,0,804,2603,"[539, 757, 207, 773, 798, 503, 520, 642, 813, 26, 748, 694, 583, 759, 323, 369, 151, 90, 478, 370, 653, 57, 233, 367, 531, 0, 226]"
193,27,4655,4428,5920,0,1408,3247,"[430, 444, 988, 637, 1064, 210, 1081, 249, 380, 175, 8, 879, 12, 186, 456, 124, 146, 153, 12, 487, 1070, 683, 491, 797, 606, 0, 801]"
194,27,4369,80,10000,209,3410,959,"[29, 256, 177, 77, 68, 162, 82, 83, 3, 108, 276, 138, 51, 51, 92, 77, 306, 2, 316, 171, 216, 29, 296, 193, 116, 0, 167]"
195,27,3885,5179,8706,0,2971,914,"[229, 289, 116, 73, 45, 298, 192, 122, 17, 108, 259, 5, 6, 59, 20, 270, 129, 144, 59, 179, 225, 169, 116, 92, 284, 0, 78]"
196,27,3880,7382,5204,0,2621,1259,"[90, 220, 193, 221, 285, 73, 264, 212, 141, 259, 268, 133, 57, 5, 176, 155, 186, 136, 106, 366, 163, 325, 160, 385, 139, 0, 277]"
197,27,4032,377,8859,0,2902,1130,"[51, 325, 25, 244, 169, 2, 362, 367, 365, 338, 335, 256, 362, 26, 160, 371, 12, 38, 256, 354, 153, 140, 315, 298, 268, 0, 331]"
198,27,3287,7233,4913,0,897,2390,"[679, 129, 79, 774, 90, 645, 525, 209, 123, 98, 276, 684, 649, 201, 450, 705, 123, 277, 685, 660, 647, 436, 98, 771, 150, 0, 80]"
199,27,4198,702,8409,0,3296,902,"[272, 256, 169, 90, 177, 112, 129, 156, 236, 123, 289, 59, 205, 135, 293, 255, 115, 252, 152, 127, 153, 119, 238, 219, 124, 0, 188]"
200,27,4848,5140,8117,0,295,4553,"[987, 939, 754, 772, 428, 1477, 1423, 494, 1124, 194, 747, 392, 13, 672, 1392, 345, 520, 1326, 1280, 1102, 390, 1386, 298, 119, 1366, 0, 1444]"
201,27,3421,5134,6404,0,288,3133,"[978, 51, 911, 590, 227, 870, 237, 2, 133, 733, 177, 790, 72, 444, 414, 909, 1035, 347, 709, 125, 296, 879, 57, 369, 730, 0, 256]"
202,27,4118,706,9816,0,2033,2085,"[243, 195, 603, 202, 481, 12, 561, 574, 574, 314, 295, 601, 666, 122, 358, 404, 691, 270, 48, 363, 565, 157, 574, 595, 595, 0, 555]"
203,27,3764,5194,8386,0,3061,703,"[206, 218, 21, 207, 76, 177, 144, 147, 15, 92, 123, 20, 40, 153, 147, 85, 225, 205, 206, 76, 202, 34, 106, 0, 45, 0, 18]"
204,27,3849,7076,5159,0,594,3255,"[720, 220, 3, 687, 561, 767, 841, 896, 777, 554, 1076, 11, 114, 258, 583, 993, 799, 249, 367, 956, 223, 317, 35, 443, 796, 0, 959]"
205,27,4088,1604,7643,0,2833,1255,"[345, 403, 380, 352, 161, 369, 7, 363, 58, 370, 181, 391, 279, 394, 152, 162, 309, 358, 194, 73, 310, 244, 222, 88, 319, 0, 315]"
206,27,3176,2482,8337,0,1892,1284,"[322, 197, 185, 236, 207, 346, 160, 368, 379, 102, 126, 263, 312, 365, 211, 103, 53, 165, 380, 19, 374, 377, 59, 112, 98, 0, 56]"
207,27,3071,7206,4202,0,1099,1972,"[123, 105, 581, 265, 480, 154, 183, 596, 614, 243, 45, 626, 114, 306, 467, 253, 536, 651, 34, 495, 56, 226, 146, 307, 381, 0, 556]"
208,27,3604,1578,6228,0,1902,1702,"[460, 215, 285, 132, 23, 332, 206, 208, 288, 351, 281, 112, 89, 434, 544, 183, 236, 6, 263, 129, 333, 402, 490, 439, 483, 0, 237]"
209,27,3454,2945,6737,0,1240,2214,"[24, 48, 530, 393, 153, 3, 630, 407, 378, 609, 268, 707, 251, 586, 720, 647, 41, 94, 630, 209, 717, 76, 711, 515, 380, 0, 396]"
210,27,4547,7084,4200,0,2483,2064,"[58, 166, 573, 623, 516, 367, 63, 0, 258, 322, 86, 610, 403, 138, 231, 433, 559, 64, 401, 446, 432, 43, 556, 530, 103, 0, 214]"
211,27,4601,1558,7243,0,2973,1628,"[68, 62, 183, 167, 403, 489, 349, 284, 380, 508, 523, 347, 246, 104, 37, 135, 313, 187, 187, 33, 315, 452, 363, 516, 220, 0, 33]"
212,27,3629,2836,8036,0,187,3442,"[472, 855, 1049, 445, 187, 193, 376, 698, 862, 45, 921, 575, 460, 129, 1117, 594, 627, 442, 341, 250, 619, 622, 686, 1057, 594, 0, 797]"
213,27,4939,7101,5874,0,3574,1365,"[272, 62, 124, 101, 107, 113, 446, 7, 156, 303, 168, 27, 253, 273, 390, 370, 53, 397, 400, 422, 345, 200, 426, 5, 452, 0, 323]"
214,27,3906,3833,5947,0,1986,1920,"[219, 186, 590, 155, 492, 472, 35, 362, 49, 489, 309, 505, 135, 120, 340, 328, 147, 106, 528, 472, 413, 624, 401, 27, 525, 0, 454]"
215,27,4104,3162,6889,0,1112,2992,"[953, 343, 422, 403, 766, 560, 498, 202, 261, 357, 715, 55, 386, 324, 350, 86, 16, 427, 889, 817, 376, 903, 467, 550, 975, 0, 556]"
216,27,3512,925,9476,0,3189,323,"[24, 27, 64, 48, 107, 83, 63, 39, 51, 7, 43, 72, 105, 56, 102, 10, 28, 50, 0, 105, 72, 51, 98, 22, 39, 0, 87]"
217,27,3469,5942,7003,0,2074,1395,"[239, 241, 371, 307, 417, 40, 462, 264, 105, 197, 452, 270, 102, 414, 87, 61, 17, 214, 437, 332, 348, 87, 293, 272, 389, 0, 434]"
218,27,3181,2193,7991,0,2110,1071,"[356, 234, 58, 104, 7, 125, 341, 345, 147, 163, 279, 211, 180, 219, 118, 1, 45, 207, 190, 60, 27, 134, 166, 82, 37, 0, 207]"
219,27,4195,6659,5527,0,143,4052,"[555, 832, 443, 51, 745, 547, 1201, 121, 644, 285, 412, 1050, 280, 548, 468, 670, 881, 614, 678, 170, 877, 273, 92, 276, 723, 0, 27]"
220,27,4068,2581,7014,0,832,3236,"[661, 598, 46, 999, 1058, 720, 117, 217, 893, 210, 942, 29, 290, 967, 830, 729, 544, 78, 46, 545, 972, 146, 744, 284, 391, 0, 125]"
221,27,4900,7333,4581,0,429,4471,"[1167, 11, 770, 310, 104, 604, 643, 1424, 1366, 565, 1272, 13, 1227, 1235, 185, 71, 799, 1110, 1362, 738, 802, 973, 686, 1099, 1018, 0, 1468]"
222,27,3524,2472,5633,0,347,3177,"[631, 231, 680, 301, 15, 457, 762, 251, 899, 158, 590, 624, 661, 97, 411, 313, 35, 531, 537, 844, 160, 828, 811, 519, 694, 0, 703]"
223,27,3604,1802,7435,0,827,2777,"[48, 475, 206, 284, 56, 269, 404, 445, 738, 157, 390, 359, 144, 832, 44, 723, 727, 376, 846, 822, 381, 675, 574, 487, 516, 0, 772]"
224,27,3301,3097,7639,0,233,3068,"[181, 830, 641, 460, 369, 231, 913, 219, 212, 699, 912, 287, 625, 170, 362, 267, 344, 794, 375, 321, 576, 879, 664, 801, 10, 0, 633]"
225,27,4890,7397,5132,0,1162,3728,"[638, 951, 533, 1079, 1072, 1006, 945, 791, 565, 43, 999, 922, 755, 253, 326, 559, 1120, 302, 818, 967, 881, 753, 53, 266, 348, 0, 835]"
226,27,4583,3415,6300,0,774,3809,"[1006, 447, 907, 579, 1034, 224, 1230, 24, 418, 31, 121, 605, 985, 480, 60, 1090, 422, 523, 171, 731, 334, 1004, 554, 1094, 762, 0, 1269]"
227,27,4114,1949,8465,0,1030,3084,"[293, 360, 99, 598, 581, 209, 358, 823, 185, 609, 327, 149, 136, 935, 849, 509, 10, 532, 913, 293, 117, 791, 623, 751, 809, 0, 702]"
228,27,3631,6061,6035,0,2368,1263,"[231, 406, 369, 180, 175, 94, 83, 241, 300, 169, 290, 57, 327, 238, 264, 12, 222, 214, 74, 141, 321, 341, 242, 242, 25, 0, 129]"
229,27,3537,3437,6135,0,183,3354,"[354, 688, 0, 632, 180, 794, 788, 860, 283, 215, 381, 922, 290, 653, 580, 729, 875, 727, 282, 706, 870, 905, 1078, 983, 275, 0, 577]"
230,27,3001,1647,7489,0,1965,1036,"[4, 160, 212, 62, 162, 101, 26, 215, 254, 196, 264, 58, 291, 295, 140, 190, 345, 271, 270, 273, 129, 10, 213, 197, 304, 0, 50]"
231,27,4125,5803,5811,0,42,4083,"[204, 45, 531, 112, 983, 1030, 1153, 75, 256, 983, 1064, 918, 52, 965, 367, 527, 378, 1280, 975, 1127, 656, 998, 661, 1083, 819, 0, 915]"
232,27,4993,391,10000,413,4075,918,"[162, 207, 180, 214, 23, 157, 214, 170, 177, 70, 33, 98, 253, 55, 292, 60, 71, 281, 97, 178, 14, 268, 193, 228, 83, 0, 303]"
233,27,4276,6959,7317,0,390,3886,"[1054, 1190, 1163, 1064, 508, 149, 52, 631, 659, 28, 903, 921, 413, 949, 831, 1201, 673, 787, 1103, 898, 406, 210, 26, 298, 209, 0, 211]"
234,27,3879,7087,4109,0,1840,2039,"[389, 349, 31, 391, 221, 498, 663, 438, 376, 404, 400, 607, 121, 39, 530, 84, 610, 557, 394, 70, 510, 453, 64, 103, 623, 0, 265]"
235,27,4749,1776,7082,0,2034,2715,"[550, 717, 320, 122, 245, 372, 572, 226, 380, 365, 502, 45, 870, 655, 343, 17, 811, 445, 405, 263, 863, 397, 266, 654, 704, 0, 618]"
236,27,4286,7483,3885,0,2327,1959,"[393, 627, 77, 476, 267, 642, 493, 519, 646, 286, 56, 318, 94, 226, 103, 650, 620, 548, 420, 254, 199, 131, 398, 8, 526, 0, 177]"
237,27,4039,955,6969,0,3847,192,"[10, 43, 24, 33, 17, 56, 40, 58, 36, 50, 19, 15, 27, 46, 12, 62, 50, 30, 34, 63, 20, 40, 34, 51, 43, 0, 24]"
238,27,4163,6630,4502,0,3435,728,"[21, 233, 163, 172, 135, 116, 93, 47, 176, 86, 199, 187, 93, 159, 172, 51, 61, 15, 102, 65, 19, 84, 164, 175, 121, 0, 111]"
239,27,4579,1616,7465,0,720,3859,"[1177, 630, 257, 607, 1142, 1169, 25, 831, 187, 610, 1167, 619, 460, 19, 274, 1028, 918, 556, 768, 443, 926, 502, 366, 1117, 182, 0, 873]"
240,27,3253,883,9835,0,3,3250,"[726, 853, 741, 275, 517, 392, 965, 613, 1007, 345, 935, 251, 835, 642, 512, 74, 882, 890, 317, 406, 790, 871, 603, 446, 163, 0, 971]"
241,27,3032,5715,7152,0,2095,937,"[60, 47, 86, 262, 252, 19, 89, 7, 187, 20, 213, 104, 152, 76, 127, 129, 183, 287, 23, 300, 55, 27, 229, 188, 309, 0, 163]"
242,27,4076,6511,4717,0,3225,851,"[154, 259, 215, 212, 237, 188, 207, 153, 120, 122, 166, 53, 255, 83, 229, 23, 202, 259, 149, 58, 115, 249, 31, 144, 126, 0, 276]"
243,27,4465,806,8376,0,3833,632,"[51, 21, 152, 147, 99, 108, 162, 49, 43, 157, 59, 36, 48, 110, 17, 37, 144, 62, 143, 130, 51, 78, 25, 16, 160, 0, 51]"
244,27,3250,6481,5145,0,1427,1823,"[536, 183, 564, 141, 532, 329, 364, 228, 579, 486, 13, 256, 253, 319, 70, 188, 259, 516, 535, 135, 382, 286, 530, 319, 598, 0, 420]"
245,27,3946,2190,6901,0,2863,1083,"[121, 337, 101, 89, 134, 132, 106, 333, 289, 227, 245, 124, 175, 255, 300, 259, 111, 306, 51, 47, 38, 252, 186, 168, 242, 0, 351]"
246,27,4380,5004,6277,0,2718,1662,"[259, 332, 502, 512, 486, 533, 148, 488, 426, 265, 162, 382, 144, 363, 268, 153, 264, 319, 287, 33, 480, 507, 69, 379, 535, 0, 145]"
247,27,4872,5245,5904,0,3997,875,"[132, 178, 220, 182, 276, 50, 265, 229, 283, 74, 289, 201, 155, 268, 111, 198, 158, 257, 211, 62, 98, 286, 220, 193, 258, 0, 239]"
248,27,4693,3128,7469,0,65,4628,"[738, 516, 1404, 649, 567, 1198, 103, 65, 66, 868, 1127, 1232, 1381, 1310, 1115, 763, 468, 1245, 156, 335, 985, 1031, 1509, 1003, 1041, 0, 1282]"
249,27,4839,5688,6620,0,3098,1741,"[369, 432, 355, 551, 383, 266, 190, 316, 439, 253, 370, 124, 516, 18, 277, 100, 109, 479, 297, 391, 162, 239, 535, 128, 295, 0, 6]"
250,27,3099,100,9619,0,1747,1352,"[163, 57, 23, 295, 50, 233, 431, 270, 85, 203, 113, 28, 198, 341, 285, 179, 316, 441, 95, 365, 86, 392, 167, 210, 24, 0, 121]"
251,27,3489,6936,6172,0,930,2559,"[283, 82, 650, 365, 702, 731, 105, 549, 446, 640, 368, 805, 313, 17, 534, 280, 440, 712, 178, 566, 765, 189, 551, 119, 770, 0, 580]"
252,27,3348,2830,6690,0,3050,298,"[22, 71, 32, 71, 51, 5, 86, 88, 67, 19, 0, 96, 78, 72, 49, 67, 6, 55, 14, 61, 93, 56, 59, 7, 88, 0, 52]"
253,27,3900,392,10000,198,3292,608,"[10, 52, 31, 17, 198, 149, 48, 54, 145, 14, 193, 148, 46, 116, 16, 168, 130, 170, 178, 124, 184, 40, 107, 134, 112, 0, 138]"
254,27,3299,7156,6143,0,2846,453,"[131, 33, 91, 97, 44, 84, 8, 73, 72, 127, 113, 13, 11, 44, 7, 64, 142, 134, 102, 61, 38, 144, 5, 80, 68, 0, 111]"
255,27,4620,3970,6793,0,120,4500,"[1248, 1146, 158, 901, 77, 607, 342, 676, 135, 120, 360, 951, 805, 1167, 306, 226, 1175, 605, 548, 504, 236, 1181, 780, 277, 520, 0, 41]"
256,27,4987,6990,4790,0,4043,944,"[8, 7, 130, 246, 151, 23, 182, 148, 1, 89, 259, 204, 231, 249, 146, 204, 283, 110, 285, 138, 293, 115, 188, 259, 56, 0, 269]"
257,27,3547,1837,6500,0,3492,55,"[2, 15, 18, 16, 10, 6, 6, 8, 4, 2, 2, 5, 18, 13, 9, 1, 16, 16, 5, 7, 5, 0, 15, 17, 16, 0, 17]"
258,27,4491,1674,9317,0,3345,1146,"[235, 149, 266, 183, 171, 270, 232, 208, 168, 17, 184, 214, 183, 55, 249, 309, 65, 231, 243, 140, 364, 207, 183, 33, 272, 0, 194]"
259,27,4115,5961,7471,0,2221,1894,"[329, 382, 115, 45, 183, 579, 233, 412, 84, 29, 593, 339, 616, 557, 554, 298, 142, 449, 34, 554, 565, 155, 397, 127, 427, 0, 14]"
260,27,4621,5072,7020,0,2086,2535,"[376, 250, 402, 112, 454, 248, 663, 51, 720, 751, 843, 118, 524, 621, 301, 442, 508, 232, 465, 259, 486, 420, 619, 445, 648, 0, 234]"
261,27,3721,2499,8242,0,211,3510,"[123, 993, 91, 385, 675, 9, 989, 584, 30, 360, 27, 710, 548, 101, 1071, 510, 734, 21, 511, 826, 270, 529, 926, 825, 432, 0, 880]"
262,27,3370,6781,4831,0,771,2599,"[198, 766, 413, 180, 649, 620, 331, 132, 5, 674, 345, 636, 643, 543, 831, 414, 34, 718, 383, 484, 36, 642, 114, 125, 455, 0, 322]"
263,27,4626,2835,6622,0,1911,2715,"[241, 87, 703, 100, 472, 202, 649, 573, 717, 63, 799, 84, 661, 191, 16, 296, 31, 800, 298, 100, 363, 326, 464, 706, 612, 0, 762]"
264,27,3993,2469,8146,0,1471,2522,"[832, 176, 227, 823, 512, 749, 770, 339, 833, 57, 41, 280, 348, 230, 808, 342, 837, 682, 503, 493, 791, 699, 209, 55, 829, 0, 304]"
265,27,3598,6289,5455,0,2080,1518,"[130, 64, 418, 487, 273, 389, 59, 498, 401, 345, 211, 60, 88, 58, 307, 95, 164, 45, 500, 504, 128, 391, 445, 105, 13, 0, 57]"
266,27,3225,3024,5656,0,2869,356,"[96, 107, 94, 88, 8, 99, 13, 104, 78, 69, 2, 39, 13, 56, 61, 47, 44, 30, 81, 19, 28, 73, 8, 109, 9, 0, 84]"
267,27,3432,1214,7874,0,145,3287,"[883, 1086, 282, 1006, 824, 739, 216, 1010, 848, 452, 238, 973, 1011, 455, 221, 600, 119, 208, 504, 817, 895, 360, 601, 722, 95, 0, 461]"
268,27,4313,5616,6571,0,1037,3276,"[395, 663, 1021, 378, 499, 708, 660, 857, 179, 896, 255, 949, 481, 960, 52, 1060, 174, 157, 1033, 1003, 619, 672, 729, 213, 625, 0, 833]"
269,27,3065,1184,8452,0,1757,1308,"[47, 394, 61, 22, 77, 292, 55, 212, 226, 104, 412, 147, 132, 428, 11, 32, 353, 107, 334, 176, 353, 372, 326, 368, 304, 0, 132]"
270,27,4513,5250,7715,0,232,4281,"[245, 1199, 565, 917, 131, 176, 857, 591, 883, 1416, 1117, 1307, 869, 76, 616, 360, 466, 262, 243, 826, 184, 453, 472, 681, 1113, 0, 212]"
271,27,3012,589,10000,138,663,2349,"[20, 493, 458, 671, 762, 284, 150, 46, 377, 65, 180, 433, 341, 135, 374, 71, 89, 503, 296, 59, 610, 206, 344, 440, 199, 0, 466]"
272,27,4448,5990,8458,0,880,3568,"[302, 48, 1004, 250, 1022, 435, 85, 184, 487, 509, 207, 1169, 1055, 618, 140, 422, 836, 550, 677, 292, 734, 843, 360, 1127, 44, 0, 217]"
273,27,3596,5025,7029,0,3000,596,"[24, 101, 4, 167, 158, 29, 11, 45, 66, 49, 108, 74, 130, 16, 63, 169, 53, 14, 86, 103, 43, 33, 104, 95, 149, 0, 171]"
274,27,3614,1275,9368,0,2037,1577,"[213, 428, 299, 258, 216, 25, 408, 232, 87, 524, 54, 276, 16, 277, 423, 187, 11, 235, 209, 310, 29, 46, 24, 209, 516, 0, 213]"
275,27,3867,6526,6709,0,697,3170,"[507, 200, 533, 813, 500, 429, 200, 977, 863, 490, 250, 212, 50, 160, 648, 928, 76, 837, 288, 810, 881, 430, 431, 301, 895, 0, 945]"
276,27,4684,7164,4229,0,499,4185,"[1168, 60, 1378, 473, 88, 1197, 310, 554, 1182, 1186, 624, 906, 148, 1013, 703, 1049, 513, 357, 643, 1276, 729, 523, 668, 1008, 999, 0, 635]"
277,27,4314,1206,7337,0,24,4290,"[545, 573, 984, 402, 1360, 254, 403, 1251, 1146, 1224, 1098, 1066, 1035, 1155, 611, 874, 1362, 572, 672, 189, 162, 864, 1000, 721, 820, 0, 1287]"
278,27,4158,6101,5394,0,1494,2664,"[380, 174, 267, 39, 729, 490, 786, 346, 829, 511, 828, 489, 730, 485, 887, 784, 580, 878, 799, 768, 385, 735, 477, 559, 18, 0, 850]"
279,27,3734,3478,5650,0,1414,2320,"[131, 158, 532, 575, 757, 329, 234, 290, 410, 272, 329, 366, 684, 173, 242, 2, 549, 441, 72, 38, 67, 370, 748, 71, 654, 0, 354]"
280,27,4306,435,9521,0,556,3750,"[44, 1181, 834, 964, 381, 262, 235, 398, 784, 910, 735, 752, 356, 478, 512, 824, 905, 1192, 393, 111, 707, 1172, 801, 666, 1193, 0, 991]"
281,27,3527,6320,6728,0,1976,1551,"[332, 387, 333, 91, 176, 365, 19, 425, 253, 281, 298, 258, 487, 74, 305, 322, 69, 229, 398, 364, 502, 506, 514, 224, 503, 0, 381]"
282,27,3008,35,9701,0,2587,421,"[82, 119, 0, 37, 53, 106, 44, 29, 68, 138, 86, 102, 113, 37, 110, 12, 57, 53, 115, 28, 84, 44, 115, 69, 132, 0, 62]"
283,27,3307,6055,6953,0,1816,1491,"[110, 277, 290, 483, 393, 83, 35, 299, 369, 303, 124, 175, 49, 324, 212, 130, 221, 318, 450, 96, 490, 399, 63, 100, 23, 0, 398]"
284,27,3583,2279,8257,0,2583,1000,"[138, 140, 330, 178, 16, 270, 88, 247, 91, 157, 69, 279, 114, 175, 177, 160, 128, 262, 63, 48, 241, 216, 258, 38, 38, 0, 315]"
285,27,4276,6962,5571,0,4216,60,"[11, 11, 0, 1, 7, 3, 5, 14, 7, 18, 12, 16, 14, 2, 1, 13, 13, 1, 13, 13, 14, 17, 13, 17, 13, 0, 1]"
286,27,4537,2930,7178,0,4253,284,"[0, 50, 64, 30, 42, 69, 88, 5, 74, 79, 78, 56, 6, 90, 91, 43, 67, 47, 23, 39, 7, 36, 74, 91, 12, 0, 61]"
287,27,4737,6309,5606,0,1679,3058,"[280, 709, 533, 818, 905, 615, 692, 542, 756, 566, 965, 460, 979, 775, 522, 1003, 37, 406, 19, 341, 848, 941, 30, 874, 834, 0, 4]"
288,27,4985,2936,7655,0,3393,1592,"[241, 199, 270, 450, 104, 324, 206, 49, 384, 114, 140, 304, 129, 275, 511, 346, 523, 64, 448, 105, 66, 227, 245, 235, 138, 0, 509]"
289,27,4492,6941,5206,0,565,3927,"[1053, 1085, 263, 644, 820, 1068, 833, 165, 155, 307, 88, 65, 1297, 915, 218, 672, 1085, 1097, 301, 1192, 1271, 151, 997, 791, 491, 0, 990]"
290,27,4014,2829,6391,0,158,3856,"[25, 492, 537, 889, 218, 1029, 174, 615, 763, 499, 954, 218, 2, 673, 283, 571, 694, 707, 933, 662, 949, 644, 753, 541, 950, 0, 77]"
291,27,4361,623,10000,129,2265,2096,"[480, 14, 301, 249, 202, 547, 281, 207, 541, 591, 271, 634, 101, 112, 688, 628, 507, 538, 206, 480, 506, 611, 38, 461, 185, 0, 35]"
292,27,4130,6689,7441,0,1190,2940,"[160, 360, 305, 315, 675, 276, 940, 43, 115, 825, 809, 439, 732, 836, 296, 595, 753, 299, 912, 789, 724, 815, 99, 357, 590, 0, 164]"
293,27,4448,5632,6257,0,2027,2421,"[763, 6, 707, 784, 387, 374, 529, 528, 654, 394, 565, 752, 628, 698, 378, 270, 60, 667, 23, 559, 752, 329, 170, 182, 314, 0, 515]"
294,27,3922,3109,7070,0,2206,1716,"[418, 231, 3, 40, 278, 537, 228, 62, 105, 68, 201, 269, 310, 51, 449, 12, 94, 521, 52, 144, 262, 423, 472, 22, 441, 0, 73]"
295,27,3410,1154,9326,0,3183,227,"[13, 10, 0, 49, 23, 47, 68, 22, 3, 67, 56, 60, 57, 39, 25, 34, 28, 16, 15, 16, 11, 5, 16, 12, 70, 0, 13]"
296,27,4486,6796,7016,0,1574,2912,"[236, 671, 730, 411, 278, 63, 695, 961, 47, 414, 270, 578, 659, 235, 689, 263, 200, 208, 471, 685, 735, 20, 537, 804, 954, 0, 89]"
297,27,3190,3081,7125,0,3083,107,"[21, 9, 3, 2, 11, 2, 27, 32, 11, 8, 20, 21, 8, 2, 11, 2, 33, 3, 26, 13, 30, 30, 15, 20, 5, 0, 18]"
298,27,3995,5309,5811,0,1339,2656,"[218, 784, 308, 98, 400, 44, 63, 597, 26, 444, 170, 528, 836, 724, 482, 353, 555, 787, 262, 339, 59, 248, 188, 432, 254, 0, 110]"
299,27,4672,716,9767,0,4261,411,"[92, 61, 134, 1, 101, 105, 40, 102, 75, 21, 107, 37, 115, 131, 124, 13, 114, 74, 103, 29, 60, 104, 135, 79, 21, 0, 97]"
0,28,3294,0,3294,0,2632,662,"[136, 200, 29, 6, 63, 134, 82, 47, 183, 59, 71, 10, 142, 207, 4, 141, 94, 101, 29, 214, 0, 66, 163, 68, 74, 207, 0]"
1,28,4451,1310,6435,0,2845,1606,"[487, 101, 201, 174, 30, 353, 2, 4, 509, 239, 117, 141, 76, 394, 410, 71, 14, 378, 10, 49, 78, 0, 393, 289, 461, 87, 0]"
2,28,4275,802,9908,0,2313,1962,"[581, 561, 68, 96, 72, 415, 508, 519, 548, 350, 322, 499, 173, 628, 146, 333, 556, 356, 222, 331, 341, 449, 232, 104, 304, 153, 0]"
3,28,4541,6478,7971,0,1816,2725,"[815, 395, 562, 394, 48, 868, 691, 430, 41, 232, 641, 415, 738, 674, 886, 377, 81, 621, 598, 415, 87, 528, 257, 225, 558, 196, 0]"
4,28,4042,5555,6458,0,3125,917,"[155, 55, 42, 36, 135, 92, 48, 230, 252, 235, 224, 168, 137, 39, 137, 24, 226, 173, 300, 165, 181, 130, 235, 183, 285, 236, 0]"
5,28,3127,572,9013,0,3126,1,"[0, 0, 0, 0, 0, 0, 0, 0, 0, 0, 0, 0, 0, 0, 0, 0, 0, 0, 0, 0, 0, 0, 0, 0, 0, 0, 0]"
6,28,3143,6809,5347,0,518,2625,"[385, 290, 659, 652, 383, 707, 840, 841, 721, 624, 262, 638, 497, 559, 87, 462, 717, 532, 447, 790, 227, 441, 628, 496, 675, 637, 0]"
7,28,3575,2340,6582,0,2156,1419,"[370, 394, 233, 213, 243, 120, 45, 183, 405, 314, 399, 235, 165, 183, 414, 337, 16, 228, 88, 62, 251, 299, 213, 173, 177, 356, 0]"
8,28,4456,5400,5638,0,4059,397,"[12, 77, 0, 132, 39, 86, 75, 85, 92, 89, 105, 117, 62, 10, 33, 12, 131, 74, 69, 7, 91, 1, 110, 21, 55, 53, 0]"
9,28,3394,1655,7377,0,946,2448,"[672, 484, 684, 492, 409, 108, 483, 731, 187, 340, 804, 800, 234, 735, 91, 664, 303, 185, 645, 272, 223, 281, 288, 56, 806, 806, 0]"
10,28,4224,6023,5578,0,893,3331,"[319, 605, 1076, 418, 977, 826, 165, 44, 805, 342, 436, 437, 1052, 957, 739, 623, 675, 404, 525, 952, 889, 822, 352, 181, 1062, 523, 0]"
11,28,3890,3171,6297,0,2865,1025,"[61, 169, 285, 27, 37, 215, 315, 81, 187, 112, 167, 107, 67, 190, 101, 262, 16, 272, 283, 251, 204, 248, 182, 294, 132, 190, 0]"
12,28,4743,5678,5362,0,1782,2961,"[499, 799, 949, 326, 169, 776, 891, 259, 860, 313, 170, 353, 630, 511, 875, 606, 211, 184, 424, 646, 592, 3, 816, 326, 860, 735, 0]"
13,28,3421,1817,6966,0,617,2804,"[645, 398, 116, 21, 71, 649, 634, 794, 792, 115, 448, 525, 473, 701, 625, 284, 434, 563, 430, 539, 581, 874, 740, 879, 161, 619, 0]"
14,28,3994,851,10000,109,2821,1173,"[372, 235, 333, 197, 344, 40, 17, 319, 281, 210, 253, 283, 315, 280, 28, 0, 31, 29, 209, 137, 328, 163, 158, 11, 179, 255, 0]"
15,28,3804,5092,8712,0,3704,100,"[6, 14, 13, 6, 8, 25, 25, 32, 23, 17, 23, 11, 29, 7, 10, 19, 24, 27, 5, 18, 4, 27, 4, 31, 6, 18, 0]"
16,28,3578,6320,5970,0,1981,1597,"[9, 506, 225, 32, 60, 480, 110, 414, 228, 45, 121, 367, 495, 274, 87, 528, 298, 519, 505, 458, 419, 69, 92, 68, 29, 445, 0]"
17,28,3790,3283,6477,0,241,3549,"[899, 634, 51, 243, 716, 663, 1059, 644, 524, 724, 109, 238, 130, 792, 383, 1036, 504, 59, 869, 958, 49, 672, 1076, 660, 897, 967, 0]"
18,28,4278,3120,7635,0,1664,2614,"[356, 433, 746, 53, 855, 190, 580, 629, 864, 417, 510, 341, 169, 214, 798, 120, 180, 613, 37, 301, 55, 181, 178, 221, 689, 317, 0]"
19,28,3210,2357,8488,0,1267,1943,"[81, 46, 89, 360, 639, 507, 346, 483, 403, 207, 261, 165, 188, 378, 77, 61, 594, 571, 291, 173, 134, 604, 561, 208, 48, 362, 0]"
20,28,4070,6719,5839,0,284,3786,"[463, 697, 885, 1174, 1100, 630, 478, 315, 1125, 734, 599, 1125, 214, 369, 535, 107, 52, 82, 1145, 742, 1113, 358, 303, 790, 564, 973, 0]"
21,28,3775,2726,6888,0,2163,1612,"[135, 524, 385, 525, 110, 51, 415, 503, 140, 493, 111, 298, 452, 471, 504, 304, 51, 256, 187, 517, 207, 63, 223, 419, 109, 400, 0]"
22,28,3279,2033,8134,0,2874,405,"[59, 114, 127, 12, 28, 64, 121, 33, 38, 55, 134, 82, 127, 5, 91, 108, 63, 55, 118, 105, 77, 94, 46, 103, 15, 56, 0]"
23,28,4370,6989,5515,0,3206,1164,"[97, 78, 227, 386, 294, 265, 100, 102, 171, 166, 334, 186, 275, 231, 123, 232, 246, 32, 112, 18, 322, 166, 96, 160, 239, 122, 0]"
24,28,4286,1056,8745,0,2140,2146,"[61, 532, 198, 484, 80, 280, 117, 435, 444, 278, 517, 559, 54, 346, 225, 106, 12, 5, 487, 308, 196, 471, 470, 302, 298, 542, 0]"
25,28,3722,7213,5254,0,2199,1523,"[393, 130, 307, 82, 250, 402, 299, 341, 283, 81, 294, 393, 79, 181, 238, 75, 370, 89, 38, 326, 505, 50, 365, 441, 93, 91, 0]"
26,28,3137,1756,6635,0,407,2730,"[655, 260, 634, 653, 718, 396, 71, 49, 222, 734, 379, 849, 713, 609, 213, 802, 290, 518, 626, 789, 642, 649, 652, 164, 179, 788, 0]"
27,28,4392,5822,5205,0,4007,385,"[16, 53, 125, 127, 86, 37, 70, 12, 84, 94, 69, 105, 78, 68, 62, 87, 57, 118, 87, 64, 71, 79, 120, 106, 67, 52, 0]"
28,28,3253,448,8010,0,85,3168,"[321, 246, 336, 981, 797, 721, 743, 130, 772, 544, 626, 968, 762, 415, 179, 370, 277, 626, 319, 369, 629, 805, 178, 452, 560, 878, 0]"
29,28,3196,6784,4422,0,102,3094,"[755, 17, 50, 331, 771, 212, 830, 601, 787, 124, 849, 513, 1019, 211, 125, 530, 369, 885, 895, 808, 482, 492, 452, 288, 650, 504, 0]"
30,28,3464,2223,5663,0,1374,2090,"[138, 294, 500, 23, 511, 183, 201, 5, 338, 82, 507, 97, 647, 604, 156, 78, 119, 378, 107, 149, 673, 178, 632, 337, 182, 304, 0]"
31,28,3723,582,8804,0,3376,347,"[40, 84, 44, 98, 80, 2, 103, 1, 51, 77, 92, 28, 43, 66, 15, 82, 9, 18, 49, 14, 43, 64, 39, 79, 4, 34, 0]"
32,28,3017,5748,6073,0,2287,730,"[208, 237, 167, 131, 172, 27, 200, 70, 194, 180, 40, 25, 147, 101, 2, 146, 5, 78, 24, 132, 213, 41, 93, 134, 215, 137, 0]"
33,28,3775,1391,8457,0,123,3652,"[966, 734, 671, 977, 1103, 300, 555, 1160, 377, 318, 549, 1206, 1065, 91, 1088, 940, 73, 546, 273, 479, 227, 211, 588, 400, 1035, 732, 0]"
34,28,3949,7257,5149,0,83,3866,"[889, 601, 744, 381, 1044, 521, 1189, 1183, 217, 1257, 1088, 227, 34, 1153, 983, 1131, 781, 661, 406, 880, 234, 655, 22, 268, 1103, 446, 0]"
35,28,3463,2705,5907,0,1866,1597,"[282, 219, 281, 457, 255, 492, 69, 418, 46, 38, 71, 206, 388, 198, 212, 428, 378, 522, 519, 251, 161, 341, 357, 277, 514, 111, 0]"
36,28,4631,1395,9143,0,3612,1019,"[43, 193, 23, 25, 119, 160, 169, 182, 336, 338, 293, 22, 232, 307, 67, 68, 147, 255, 318, 24, 278, 99, 186, 298, 250, 203, 0]"
37,28,4994,5766,8371,0,4608,386,"[67, 121, 15, 92, 39, 13, 69, 85, 43, 64, 11, 74, 119, 59, 18, 72, 105, 1, 23, 50, 120, 72, 124, 2, 97, 53, 0]"
38,28,3662,6652,5381,0,959,2703,"[762, 481, 194, 830, 357, 250, 250, 484, 165, 50, 26, 249, 20, 109, 88, 739, 901, 761, 871, 250, 397, 719, 732, 883, 300, 225, 0]"
39,28,3726,2450,6657,0,897,2829,"[505, 638, 215, 941, 12, 600, 705, 590, 466, 113, 184, 101, 318, 326, 481, 5, 464, 499, 634, 9, 117, 675, 726, 17, 15, 905, 0]"
40,28,3561,2879,7339,0,2148,1413,"[449, 373, 294, 266, 134, 332, 133, 360, 405, 396, 262, 145, 157, 426, 36, 315, 249, 371, 418, 140, 19, 400, 142, 203, 70, 263, 0]"
41,28,4468,5598,6209,0,702,3766,"[1219, 562, 158, 251, 767, 1198, 27, 423, 159, 237, 424, 1010, 547, 213, 1243, 1135, 151, 833, 1214, 1115, 1239, 692, 400, 313, 8, 451, 0]"
42,28,3237,3030,6416,0,2168,1069,"[190, 308, 65, 259, 236, 290, 98, 152, 154, 29, 35, 136, 6, 185, 194, 218, 342, 327, 187, 60, 112, 188, 299, 348, 99, 328, 0]"
43,28,4094,2960,7550,0,3684,410,"[100, 21, 67, 27, 15, 119, 57, 12, 106, 9, 35, 65, 97, 123, 109, 40, 107, 87, 58, 80, 20, 63, 82, 20, 13, 75, 0]"
44,28,3787,5281,6056,0,3134,653,"[100, 196, 7, 54, 138, 184, 37, 110, 197, 143, 19, 199, 135, 53, 150, 134, 105, 59, 178, 151, 62, 10, 106, 90, 51, 136, 0]"
45,28,4610,4328,6338,0,1034,3576,"[501, 763, 239, 802, 1080, 548, 547, 990, 738, 53, 659, 617, 698, 741, 288, 390, 998, 970, 763, 832, 194, 615, 747, 701, 234, 714, 0]"
46,28,3780,2523,7595,0,2586,1194,"[47, 12, 304, 111, 385, 140, 379, 109, 365, 68, 317, 86, 265, 184, 166, 321, 15, 234, 26, 380, 310, 339, 156, 38, 249, 381, 0]"
47,28,3788,7310,4073,0,2670,1118,"[288, 192, 342, 20, 53, 274, 304, 306, 279, 173, 59, 70, 110, 113, 210, 273, 157, 59, 166, 214, 345, 291, 229, 102, 121, 38, 0]"
48,28,4858,2123,6808,0,3726,1132,"[233, 39, 152, 276, 365, 283, 147, 263, 207, 91, 56, 131, 219, 335, 285, 79, 112, 12, 132, 236, 323, 305, 140, 106, 63, 361, 0]"
49,28,3834,128,10000,514,2476,1358,"[225, 117, 447, 309, 182, 207, 395, 432, 401, 202, 21, 184, 162, 54, 333, 174, 13, 240, 208, 361, 378, 145, 219, 184, 51, 161, 0]"
50,28,4820,5563,9257,0,1800,3020,"[81, 339, 458, 617, 392, 295, 959, 703, 961, 638, 122, 673, 110, 910, 371, 500, 810, 382, 747, 180, 750, 986, 259, 743, 358, 349, 0]"
51,28,3020,6802,5475,0,1525,1495,"[233, 436, 406, 415, 144, 426, 380, 201, 483, 410, 63, 17, 89, 315, 35, 91, 405, 372, 413, 287, 53, 10, 267, 338, 371, 326, 0]"
52,28,3156,492,8139,0,2328,828,"[244, 243, 133, 164, 55, 267, 55, 43, 162, 109, 109, 195, 78, 133, 167, 85, 70, 91, 143, 29, 121, 150, 242, 2, 63, 201, 0]"
53,28,4091,7134,5096,0,3474,617,"[31, 40, 77, 178, 118, 16, 45, 15, 34, 110, 0, 172, 104, 10, 129, 184, 49, 4, 3, 49, 54, 159, 107, 146, 166, 39, 0]"
54,28,3321,784,7633,0,1273,2048,"[4, 660, 244, 124, 323, 381, 433, 335, 160, 236, 498, 562, 470, 75, 449, 624, 225, 320, 161, 221, 320, 640, 455, 410, 77, 382, 0]"
55,28,3649,5422,5860,0,2416,1233,"[108, 282, 352, 243, 386, 380, 150, 281, 199, 167, 144, 139, 129, 131, 264, 50, 157, 199, 62, 100, 293, 172, 400, 68, 288, 119, 0]"
56,28,3691,188,9363,0,1996,1695,"[308, 536, 519, 518, 489, 462, 549, 458, 298, 556, 150, 12, 70, 320, 317, 190, 501, 297, 428, 527, 380, 177, 342, 210, 221, 51, 0]"
57,28,3407,7217,5553,0,2949,458,"[91, 146, 2, 6, 9, 32, 56, 26, 151, 149, 48, 67, 39, 133, 77, 125, 122, 75, 35, 74, 118, 51, 54, 53, 1, 45, 0]"
58,28,4550,4263,5840,0,2127,2423,"[91, 797, 639, 545, 126, 427, 115, 96, 773, 266, 566, 466, 225, 658, 763, 390, 753, 16, 279, 556, 183, 114, 276, 391, 487, 727, 0]"
59,28,3596,2557,6879,0,503,3093,"[483, 361, 873, 726, 448, 796, 126, 28, 863, 693, 616, 727, 769, 616, 536, 170, 76, 928, 638, 161, 483, 12, 271, 345, 440, 151, 0]"
60,28,4454,7124,4209,0,1911,2543,"[184, 756, 162, 29, 227, 833, 76, 100, 738, 528, 395, 437, 605, 338, 403, 276, 659, 725, 351, 5, 369, 494, 341, 116, 721, 502, 0]"
61,28,3938,447,7700,0,936,3002,"[304, 487, 379, 101, 477, 613, 141, 407, 182, 456, 644, 288, 50, 126, 988, 218, 810, 860, 235, 739, 141, 303, 676, 628, 777, 490, 0]"
62,28,4573,5993,6280,0,3102,1471,"[44, 407, 223, 111, 82, 367, 20, 144, 335, 92, 367, 34, 445, 439, 381, 453, 227, 21, 74, 420, 268, 446, 215, 196, 425, 144, 0]"
63,28,4143,3341,7082,0,3629,514,"[132, 35, 168, 131, 158, 27, 144, 1, 21, 127, 93, 22, 16, 166, 36, 27, 24, 45, 91, 8, 99, 3, 11, 122, 117, 19, 0]"
64,28,4958,6195,5845,0,4515,443,"[142, 68, 135, 41, 75, 101, 19, 37, 79, 80, 72, 80, 19, 50, 2, 54, 92, 123, 25, 3, 32, 101, 66, 129, 47, 137, 0]"
65,28,3343,2999,6189,0,2492,851,"[78, 188, 218, 197, 115, 128, 146, 20, 110, 164, 203, 189, 111, 279, 230, 135, 282, 133, 37, 146, 84, 192, 11, 6, 214, 78, 0]"
66,28,4995,6804,4380,0,4633,362,"[14, 107, 91, 9, 91, 76, 45, 13, 100, 37, 10, 29, 75, 39, 7, 108, 60, 16, 69, 47, 101, 2, 23, 86, 108, 26, 0]"
67,28,4777,2837,6320,0,950,3827,"[954, 525, 855, 777, 614, 109, 706, 431, 544, 635, 114, 1217, 752, 462, 893, 1076, 547, 952, 196, 591, 634, 521, 1156, 358, 668, 437, 0]"
68,28,4768,5193,5895,0,273,4495,"[25, 947, 757, 1453, 384, 70, 81, 487, 581, 692, 358, 425, 15, 489, 1152, 1167, 744, 1327, 882, 362, 962, 1391, 961, 738, 716, 585, 0]"
69,28,3297,103,9089,0,341,2956,"[735, 419, 236, 967, 126, 228, 871, 438, 838, 852, 575, 76, 970, 135, 971, 758, 381, 306, 516, 532, 927, 120, 587, 423, 492, 329, 0]"
70,28,4353,6273,7169,0,2976,1377,"[224, 250, 320, 431, 28, 257, 164, 276, 109, 43, 212, 326, 174, 57, 222, 141, 252, 417, 280, 46, 284, 28, 280, 237, 412, 215, 0]"
71,28,3346,1975,8540,0,1856,1490,"[255, 292, 219, 482, 467, 131, 432, 445, 322, 376, 166, 441, 253, 482, 23, 35, 189, 337, 332, 0, 333, 67, 437, 260, 67, 213, 0]"
72,28,3587,5624,6503,0,515,3072,"[253, 327, 326, 454, 83, 352, 877, 223, 551, 469, 534, 267, 743, 127, 977, 228, 997, 361, 59, 589, 644, 534, 26, 699, 446, 868, 0]"
73,28,3223,496,9230,0,1703,1520,"[355, 74, 57, 283, 131, 156, 350, 242, 441, 429, 157, 253, 130, 232, 477, 347, 300, 174, 191, 355, 331, 13, 439, 295, 259, 156, 0]"
74,28,4888,5530,8588,0,822,4066,"[763, 467, 403, 1141, 1285, 590, 1112, 1245, 357, 1313, 102, 604, 555, 686, 1239, 624, 680, 1235, 530, 856, 1062, 636, 980, 458, 1080, 882, 0]"
75,28,3294,5534,6348,0,2945,349,"[41, 51, 91, 115, 91, 110, 95, 76, 32, 98, 85, 89, 54, 45, 104, 18, 41, 79, 105, 23, 14, 83, 91, 107, 7, 74, 0]"
76,28,3728,2311,7765,0,3603,125,"[32, 5, 10, 29, 26, 13, 22, 8, 16, 38, 18, 6, 12, 41, 26, 29, 1, 29, 20, 7, 19, 11, 41, 21, 4, 0, 0]"
77,28,4062,6834,4993,0,3199,863,"[272, 46, 282, 220, 54, 71, 113, 266, 279, 212, 209, 276, 120, 231, 165, 82, 24, 103, 118, 222, 228, 86, 274, 211, 3, 36, 0]"
78,28,4230,3898,5325,0,1052,3178,"[86, 242, 929, 1036, 376, 907, 842, 731, 591, 918, 762, 825, 904, 1048, 255, 916, 794, 943, 1059, 961, 796, 361, 556, 714, 461, 990, 0]"
79,28,4471,3172,6624,0,3496,975,"[83, 166, 39, 142, 167, 189, 245, 188, 254, 294, 111, 124, 324, 223, 32, 242, 287, 192, 320, 59, 164, 304, 24, 81, 95, 235, 0]"
80,28,3094,502,9216,0,2561,533,"[55, 43, 78, 48, 29, 88, 137, 36, 72, 54, 59, 131, 116, 66, 13, 76, 7, 16, 27, 51, 37, 44, 49, 139, 103, 73, 0]"
81,28,4830,7380,6666,0,3479,1351,"[439, 236, 343, 448, 152, 367, 301, 156, 43, 311, 309, 351, 352, 405, 51, 52, 250, 263, 0, 388, 416, 164, 70, 427, 115, 389, 0]"
82,28,4263,2728,8201,0,2017,2246,"[634, 730, 182, 283, 95, 213, 595, 197, 384, 279, 439, 124, 358, 406, 260, 533, 577, 74, 551, 559, 605, 100, 202, 143, 69, 322, 0]"
83,28,3594,5772,6023,0,1745,1849,"[612, 487, 400, 156, 465, 503, 564, 483, 248, 383, 497, 199, 300, 459, 439, 129, 275, 439, 219, 250, 454, 356, 375, 190, 291, 565, 0]"
84,28,3423,3307,6139,0,648,2775,"[113, 870, 492, 231, 587, 754, 320, 90, 262, 487, 222, 32, 117, 236, 218, 94, 497, 727, 124, 660, 267, 12, 256, 309, 823, 280, 0]"
85,28,4536,1349,9326,0,518,4018,"[743, 536, 96, 1273, 578, 548, 219, 976, 549, 183, 429, 777, 706, 97, 1233, 1190, 1019, 448, 432, 22, 70, 746, 283, 156, 273, 43, 0]"
86,28,4742,6770,7298,0,1682,3060,"[338, 932, 993, 756, 509, 679, 748, 597, 550, 837, 852, 197, 197, 370, 722, 22, 447, 345, 448, 662, 904, 643, 448, 393, 641, 383, 0]"
87,28,4011,6351,4958,0,1371,2640,"[630, 689, 658, 766, 511, 104, 765, 52, 399, 561, 267, 43, 740, 830, 316, 184, 591, 187, 453, 243, 867, 421, 23, 469, 88, 330, 0]"
88,28,4403,2817,6544,0,2508,1895,"[394, 545, 541, 360, 76, 65, 317, 91, 67, 116, 196, 163, 231, 224, 628, 532, 618, 97, 423, 528, 74, 125, 324, 630, 584, 503, 0]"
89,28,4818,5681,5681,0,1310,3508,"[518, 1014, 75, 1095, 39, 505, 731, 1089, 661, 257, 872, 100, 344, 608, 395, 376, 364, 723, 821, 754, 489, 1072, 1143, 762, 719, 747, 0]"
90,28,3633,3147,6167,0,1655,1978,"[292, 199, 459, 498, 488, 583, 502, 8, 147, 119, 200, 406, 82, 393, 139, 517, 57, 28, 129, 420, 357, 455, 133, 567, 91, 184, 0]"
91,28,3267,1248,8186,0,2922,345,"[46, 16, 34, 70, 58, 62, 23, 66, 28, 74, 75, 67, 100, 27, 21, 54, 99, 24, 113, 85, 67, 108, 24, 111, 24, 1, 0]"
92,28,4053,5479,6760,0,2736,1317,"[186, 324, 371, 417, 300, 97, 341, 10, 141, 306, 270, 51, 398, 79, 184, 102, 229, 127, 349, 354, 203, 136, 129, 29, 16, 108, 0]"
93,28,4241,6415,4586,0,3534,707,"[135, 7, 33, 8, 95, 77, 10, 199, 213, 118, 114, 148, 144, 167, 209, 203, 235, 10, 128, 8, 229, 44, 0, 20, 132, 73, 0]"
94,28,4352,2206,6732,0,3376,976,"[197, 144, 130, 151, 131, 170, 314, 310, 1, 43, 263, 133, 251, 230, 138, 177, 143, 268, 60, 204, 279, 152, 177, 218, 9, 83, 0]"
95,28,3444,1360,8816,0,863,2581,"[355, 475, 819, 832, 697, 269, 98, 727, 358, 401, 645, 692, 313, 284, 578, 518, 728, 629, 380, 168, 54, 128, 524, 276, 708, 823, 0]"
96,28,4960,5568,8208,0,3928,1032,"[129, 77, 118, 142, 47, 7, 343, 269, 12, 213, 182, 283, 36, 172, 116, 53, 41, 158, 71, 269, 1, 232, 116, 157, 103, 259, 0]"
97,28,3105,5995,5318,0,1380,1725,"[254, 67, 45, 290, 314, 212, 385, 210, 390, 410, 178, 347, 357, 256, 28, 69, 162, 127, 240, 339, 112, 507, 506, 185, 410, 171, 0]"
98,28,4452,3913,5857,0,2152,2300,"[376, 188, 90, 429, 97, 737, 661, 353, 53, 255, 32, 369, 76, 136, 569, 622, 330, 549, 580, 324, 571, 543, 109, 446, 123, 678, 0]"
99,28,3214,1363,7708,0,1710,1504,"[268, 198, 214, 289, 296, 97, 499, 335, 100, 92, 200, 139, 50, 182, 313, 175, 435, 58, 195, 155, 30, 82, 418, 237, 267, 10, 0]"
100,28,3886,7340,4254,0,696,3190,"[35, 73, 976, 337, 923, 836, 698, 117, 63, 979, 550, 296, 962, 130, 270, 446, 502, 113, 998, 533, 1031, 524, 130, 615, 7, 507, 0]"
101,28,4063,1798,6519,0,1238,2825,"[735, 431, 567, 191, 54, 724, 507, 494, 855, 45, 825, 477, 753, 912, 763, 912, 905, 25, 63, 118, 484, 521, 438, 53, 428, 536, 0]"
102,28,4316,1428,9407,0,3497,819,"[218, 49, 189, 190, 74, 184, 6, 144, 32, 37, 186, 243, 141, 50, 14, 82, 213, 190, 131, 189, 41, 262, 132, 3, 230, 68, 0]"
103,28,3732,7259,5880,0,1491,2241,"[536, 508, 569, 645, 176, 722, 366, 695, 235, 462, 317, 697, 111, 504, 511, 6, 527, 583, 451, 569, 577, 447, 547, 306, 649, 249, 0]"
104,28,3467,716,8631,0,46,3421,"[917, 505, 849, 525, 893, 1121, 383, 995, 636, 1104, 846, 501, 375, 425, 474, 666, 247, 1097, 213, 788, 574, 6, 43, 128, 604, 181, 0]"
105,28,3113,6534,5210,0,1648,1465,"[246, 132, 310, 336, 486, 179, 329, 389, 280, 121, 159, 419, 147, 204, 474, 477, 399, 13, 205, 319, 164, 233, 143, 145, 248, 201, 0]"
106,28,3037,1547,6700,0,2644,393,"[107, 78, 18, 83, 76, 5, 80, 64, 94, 35, 0, 63, 25, 55, 94, 71, 96, 61, 44, 63, 25, 3, 43, 21, 81, 38, 0]"
107,28,3461,250,9911,0,1586,1875,"[188, 181, 161, 253, 138, 481, 318, 421, 247, 194, 150, 245, 193, 584, 236, 135, 0, 133, 339, 534, 389, 53, 34, 328, 371, 211, 0]"
108,28,3331,6325,6917,0,387,2944,"[688, 18, 464, 450, 874, 412, 386, 384, 372, 915, 497, 452, 837, 697, 964, 67, 583, 572, 171, 450, 185, 451, 189, 586, 916, 455, 0]"
109,28,4587,5907,5597,0,467,4120,"[203, 1157, 757, 1129, 864, 1162, 117, 1031, 676, 921, 760, 1195, 581, 911, 318, 1211, 1227, 380, 423, 789, 646, 427, 888, 441, 42, 1106, 0]"
110,28,4634,2850,7381,0,3006,1628,"[250, 359, 250, 125, 227, 131, 346, 41, 492, 94, 345, 88, 177, 540, 336, 46, 49, 183, 317, 207, 500, 69, 180, 75, 144, 199, 0]"
111,28,4812,6616,5577,0,2084,2728,"[645, 586, 74, 145, 188, 640, 665, 380, 257, 155, 11, 563, 221, 66, 99, 420, 793, 72, 434, 153, 75, 811, 175, 90, 877, 42, 0]"
112,28,4808,3535,6850,0,383,4425,"[242, 508, 12, 277, 837, 1209, 117, 658, 1306, 1074, 660, 1450, 634, 1071, 31, 53, 984, 999, 502, 18, 847, 5, 1471, 630, 1087, 652, 0]"
113,28,4169,7386,3633,0,2083,2086,"[512, 560, 538, 428, 693, 512, 640, 518, 600, 389, 587, 601, 289, 650, 685, 201, 658, 95, 459, 213, 675, 599, 599, 220, 32, 617, 0]"
114,28,3504,896,6241,0,2729,775,"[106, 67, 164, 161, 103, 24, 254, 133, 168, 117, 137, 84, 190, 3, 194, 144, 116, 204, 255, 0, 23, 218, 175, 57, 109, 225, 0]"
115,28,4025,2246,8020,0,2024,2001,"[385, 14, 166, 8, 175, 518, 558, 574, 137, 127, 355, 524, 98, 253, 153, 539, 181, 344, 40, 371, 397, 149, 204, 564, 316, 398, 0]"
116,28,4603,7066,5557,0,2729,1874,"[247, 539, 27, 340, 485, 526, 36, 282, 34, 407, 189, 439, 315, 439, 50, 245, 234, 316, 583, 24, 474, 11, 458, 10, 391, 155, 0]"
117,28,4251,1198,8610,0,1167,3084,"[996, 342, 875, 161, 788, 370, 701, 853, 931, 435, 779, 478, 155, 837, 1027, 944, 147, 224, 808, 146, 283, 1019, 372, 715, 881, 105, 0]"
118,28,3433,6552,5491,0,644,2789,"[405, 275, 270, 521, 143, 677, 384, 262, 902, 545, 759, 93, 244, 890, 744, 666, 926, 829, 788, 216, 346, 616, 713, 309, 818, 228, 0]"
119,28,3304,154,8641,0,1732,1572,"[96, 390, 313, 451, 185, 369, 143, 83, 66, 170, 290, 481, 153, 50, 272, 89, 384, 357, 111, 403, 264, 36, 16, 365, 108, 386, 0]"
120,28,3769,5324,7086,0,2407,1362,"[218, 341, 425, 53, 431, 292, 220, 237, 96, 248, 377, 131, 286, 166, 247, 351, 404, 298, 453, 379, 377, 97, 188, 23, 12, 29, 0]"
121,28,4587,6474,5199,0,1378,3209,"[888, 783, 449, 27, 709, 717, 48, 829, 10, 930, 658, 183, 735, 812, 921, 125, 539, 30, 90, 838, 892, 1058, 385, 734, 992, 687, 0]"
122,28,4110,81,9228,0,2436,1674,"[408, 374, 129, 446, 512, 31, 390, 397, 57, 462, 93, 261, 461, 350, 366, 140, 365, 99, 346, 325, 334, 524, 552, 143, 121, 71, 0]"
123,28,3963,6953,6238,0,1977,1986,"[468, 33, 156, 219, 556, 336, 414, 457, 140, 512, 229, 240, 635, 331, 569, 392, 613, 219, 450, 377, 322, 92, 658, 265, 148, 493, 0]"
124,28,3560,1937,7861,0,1755,1805,"[412, 261, 566, 497, 465, 158, 375, 471, 406, 492, 137, 473, 85, 549, 593, 331, 249, 195, 146, 123, 41, 47, 143, 339, 50, 464, 0]"
125,28,4436,6291,6006,0,468,3968,"[184, 554, 574, 609, 273, 939, 634, 1269, 306, 412, 791, 380, 67, 144, 1045, 524, 111, 751, 414, 480, 720, 85, 1116, 427, 474, 1182, 0]"
126,28,3826,921,8911,0,250,3576,"[228, 1021, 387, 476, 734, 149, 1025, 292, 193, 367, 240, 523, 503, 775, 802, 56, 681, 602, 1046, 81, 336, 383, 667, 811, 514, 928, 0]"
127,28,3180,6518,5573,0,458,2722,"[348, 471, 515, 615, 171, 248, 326, 133, 136, 356, 413, 357, 338, 167, 451, 39, 397, 697, 661, 223, 288, 613, 3, 482, 100, 468, 0]"
128,28,3048,894,7727,0,1706,1342,"[116, 368, 166, 386, 373, 343, 384, 303, 35, 250, 406, 146, 112, 283, 210, 410, 273, 187, 159, 86, 11, 163, 57, 285, 439, 258, 0]"
129,28,3018,2744,8001,0,2915,103,"[5, 6, 28, 22, 28, 11, 24, 26, 34, 9, 10, 15, 7, 13, 30, 1, 7, 28, 13, 11, 1, 30, 17, 8, 30, 4, 0]"
130,28,4227,6479,5749,0,1807,2420,"[730, 608, 525, 717, 524, 245, 605, 681, 530, 597, 124, 245, 572, 45, 697, 80, 7, 469, 380, 575, 73, 693, 682, 29, 731, 313, 0]"
131,28,3366,1699,7416,0,866,2500,"[812, 366, 228, 374, 556, 209, 715, 421, 262, 832, 164, 541, 205, 604, 162, 17, 80, 2, 246, 1, 656, 510, 394, 777, 764, 727, 0]"
132,28,3265,10,10000,671,2217,1048,"[126, 234, 302, 195, 47, 168, 258, 239, 237, 163, 142, 113, 46, 51, 184, 224, 197, 315, 321, 315, 135, 69, 318, 79, 207, 270, 0]"
133,28,4978,5170,9808,0,4848,130,"[12, 12, 7, 39, 16, 11, 32, 20, 11, 12, 4, 17, 8, 41, 38, 3, 16, 23, 11, 29, 28, 22, 25, 34, 21, 0, 0]"
134,28,3673,6726,6755,0,1828,1845,"[31, 322, 182, 42, 494, 300, 311, 381, 63, 369, 310, 543, 537, 398, 62, 61, 145, 173, 317, 448, 601, 148, 285, 94, 259, 151, 0]"
135,28,3225,890,9090,0,2460,765,"[72, 12, 95, 90, 159, 203, 22, 17, 249, 19, 43, 30, 233, 252, 39, 33, 197, 200, 5, 132, 29, 89, 89, 255, 56, 23, 0]"
136,28,4234,7224,6100,0,444,3790,"[1053, 1106, 893, 951, 184, 452, 1015, 1075, 586, 518, 573, 411, 705, 877, 213, 190, 78, 378, 178, 1155, 1040, 300, 978, 871, 837, 454, 0]"
137,28,4975,6421,4654,0,4707,268,"[61, 63, 36, 28, 20, 78, 57, 40, 59, 63, 57, 48, 74, 69, 2, 38, 28, 45, 6, 16, 46, 0, 50, 16, 17, 41, 0]"
138,28,3809,3033,5430,0,3526,283,"[73, 39, 77, 27, 25, 71, 63, 60, 69, 63, 13, 6, 74, 80, 44, 44, 19, 58, 22, 70, 70, 53, 34, 32, 25, 79, 0]"
139,28,4975,1873,8532,0,555,4420,"[1247, 1376, 1341, 453, 1220, 159, 743, 99, 1443, 60, 1052, 912, 615, 437, 1101, 1103, 517, 1292, 1000, 1062, 747, 292, 212, 1030, 364, 342, 0]"
140,28,3678,5726,6484,0,1449,2229,"[484, 498, 301, 233, 479, 215, 217, 539, 151, 431, 37, 108, 118, 402, 60, 697, 709, 53, 485, 611, 14, 105, 277, 669, 270, 5, 0]"
141,28,3923,1128,9279,0,3065,858,"[141, 42, 152, 239, 239, 177, 157, 286, 248, 216, 45, 23, 252, 173, 88, 42, 16, 19, 244, 70, 144, 236, 234, 140, 167, 157, 0]"
142,28,3265,5895,6649,0,664,2601,"[142, 646, 378, 1, 415, 832, 239, 137, 784, 498, 489, 138, 803, 647, 219, 154, 628, 439, 5, 727, 732, 185, 65, 54, 851, 413, 0]"
143,28,4630,6166,5113,0,990,3640,"[719, 70, 529, 1173, 536, 789, 552, 1136, 458, 1065, 43, 911, 253, 254, 988, 474, 279, 989, 519, 764, 13, 268, 714, 823, 807, 243, 0]"
144,28,4598,1489,8222,0,1320,3278,"[441, 302, 543, 542, 626, 137, 237, 924, 175, 344, 715, 360, 638, 1047, 443, 598, 976, 66, 464, 63, 294, 309, 868, 756, 479, 1046, 0]"
145,28,3284,6794,4712,0,513,2771,"[851, 402, 508, 169, 704, 920, 796, 46, 113, 771, 305, 754, 489, 405, 614, 606, 473, 16, 113, 24, 309, 294, 661, 51, 348, 816, 0]"
146,28,3933,2967,5678,0,227,3706,"[412, 1141, 133, 343, 22, 701, 577, 1130, 141, 978, 1224, 688, 592, 772, 590, 568, 955, 534, 35, 350, 879, 273, 215, 740, 1128, 851, 0]"
147,28,4478,109,10000,47,2664,1814,"[486, 430, 84, 236, 391, 434, 508, 396, 510, 207, 247, 110, 557, 16, 416, 410, 207, 107, 500, 551, 517, 450, 203, 158, 313, 231, 0]"
148,28,4151,6268,7883,0,1053,3098,"[26, 723, 484, 360, 649, 494, 901, 650, 616, 688, 780, 614, 525, 196, 112, 89, 327, 750, 491, 67, 467, 865, 258, 664, 184, 834, 0]"
149,28,3855,7267,4471,0,872,2983,"[70, 982, 118, 771, 987, 123, 469, 902, 943, 654, 862, 107, 589, 553, 974, 292, 817, 55, 486, 851, 871, 130, 313, 66, 294, 920, 0]"
150,28,4148,2015,6604,0,1799,2349,"[758, 742, 315, 610, 536, 744, 72, 597, 217, 294, 33, 261, 125, 111, 452, 342, 719, 202, 330, 414, 11, 360, 274, 421, 564, 762, 0]"
151,28,4743,6681,4666,0,1800,2943,"[447, 420, 324, 702, 908, 103, 310, 13, 226, 960, 435, 734, 590, 431, 555, 515, 389, 237, 559, 313, 56, 856, 299, 693, 978, 435, 0]"
152,28,3457,366,7757,0,3131,326,"[46, 31, 54, 9, 53, 69, 27, 73, 46, 83, 15, 102, 41, 60, 103, 106, 22, 103, 67, 85, 5, 56, 90, 102, 3, 87, 0]"
153,28,3342,6471,4628,0,559,2783,"[264, 635, 48, 628, 591, 459, 613, 860, 667, 187, 140, 264, 671, 468, 349, 56, 485, 686, 52, 275, 87, 8, 154, 487, 817, 581, 0]"
154,28,4825,1834,7619,0,278,4547,"[50, 926, 117, 16, 419, 1271, 960, 572, 1445, 287, 1434, 110, 270, 1448, 696, 1395, 641, 607, 249, 810, 730, 1393, 267, 629, 1493, 648, 0]"
155,28,4368,7331,4656,0,1646,2722,"[731, 899, 526, 688, 317, 768, 695, 354, 91, 462, 795, 316, 297, 687, 585, 446, 664, 805, 91, 354, 537, 495, 553, 515, 771, 903, 0]"
156,28,4276,1844,7088,0,3482,794,"[99, 48, 94, 172, 64, 113, 119, 95, 46, 183, 88, 196, 179, 199, 109, 85, 169, 200, 184, 126, 1, 61, 85, 185, 37, 210, 0]"
157,28,3288,299,10000,77,452,2836,"[493, 345, 490, 815, 255, 452, 450, 915, 704, 912, 812, 853, 689, 629, 312, 522, 450, 906, 47, 791, 697, 285, 118, 17, 64, 783, 0]"
158,28,4849,7221,7628,0,4469,380,"[16, 28, 124, 94, 50, 65, 81, 53, 75, 56, 49, 32, 85, 103, 60, 102, 110, 94, 105, 15, 47, 111, 93, 88, 124, 68, 0]"
159,28,3353,1076,9905,0,2404,949,"[128, 254, 65, 32, 107, 23, 297, 250, 267, 31, 156, 91, 110, 299, 309, 17, 57, 12, 280, 230, 12, 145, 216, 20, 218, 98, 0]"
160,28,3996,6026,7875,0,170,3826,"[939, 894, 1196, 17, 293, 750, 312, 827, 443, 10, 719, 610, 812, 154, 880, 686, 11, 1025, 641, 806, 218, 1119, 1006, 511, 22, 604, 0]"
161,28,4765,6191,6449,0,2954,1811,"[469, 85, 551, 120, 512, 116, 263, 263, 568, 106, 338, 375, 60, 158, 293, 538, 501, 488, 287, 552, 351, 84, 550, 284, 314, 443, 0]"
162,28,3411,2344,7516,0,1208,2203,"[208, 351, 585, 569, 53, 491, 79, 122, 433, 337, 36, 483, 702, 145, 523, 492, 459, 308, 486, 70, 36, 711, 33, 496, 464, 717, 0]"
163,28,3426,209,10000,733,1549,1877,"[562, 320, 557, 288, 143, 199, 102, 363, 6, 47, 83, 80, 348, 338, 578, 559, 546, 489, 622, 64, 378, 342, 360, 544, 131, 308, 0]"
164,28,4546,5972,8574,0,3918,628,"[100, 193, 188, 175, 149, 27, 176, 53, 132, 128, 64, 51, 142, 141, 186, 95, 150, 8, 192, 86, 8, 110, 103, 171, 40, 104, 0]"
165,28,3400,5858,6116,0,2872,528,"[138, 114, 149, 6, 19, 12, 96, 21, 76, 153, 175, 148, 8, 29, 115, 75, 34, 110, 70, 156, 164, 144, 20, 11, 53, 170, 0]"
166,28,3188,102,9202,0,1002,2186,"[329, 110, 28, 519, 236, 627, 135, 464, 586, 725, 271, 529, 71, 709, 131, 193, 46, 543, 180, 424, 105, 354, 567, 301, 610, 305, 0]"
167,28,4326,6288,7240,0,4295,31,"[0, 2, 5, 6, 7, 4, 5, 0, 9, 7, 1, 5, 3, 10, 10, 1, 0, 7, 5, 8, 1, 7, 5, 4, 5, 10, 0]"
168,28,3101,2188,8153,0,1507,1594,"[504, 258, 224, 30, 319, 411, 502, 391, 516, 18, 245, 139, 282, 417, 58, 317, 364, 16, 357, 65, 8, 318, 279, 226, 404, 338, 0]"
169,28,3199,6930,4422,0,404,2795,"[605, 761, 516, 148, 352, 301, 76, 522, 24, 639, 430, 287, 764, 612, 453, 298, 720, 52, 655, 606, 122, 874, 362, 500, 402, 353, 0]"
170,28,4317,2475,6264,0,983,3334,"[339, 254, 1032, 708, 335, 112, 690, 997, 445, 260, 1054, 907, 115, 714, 455, 334, 584, 919, 192, 539, 842, 843, 278, 55, 718, 580, 0]"
171,28,4158,2277,8145,0,2649,1509,"[417, 408, 437, 363, 349, 373, 503, 253, 396, 222, 279, 499, 7, 74, 231, 63, 433, 473, 42, 35, 408, 289, 224, 148, 317, 69, 0]"
172,28,3461,6693,4913,0,631,2830,"[26, 78, 315, 42, 379, 743, 862, 496, 797, 123, 123, 286, 821, 606, 166, 734, 92, 334, 541, 48, 562, 852, 923, 577, 701, 844, 0]"
173,28,4589,2807,6695,0,190,4399,"[1343, 50, 342, 1219, 835, 254, 657, 826, 1324, 868, 740, 683, 709, 736, 1128, 829, 14, 349, 1184, 1162, 1417, 446, 1321, 596, 939, 527, 0]"
174,28,4396,5625,5466,0,82,4314,"[1245, 175, 1073, 1208, 465, 939, 270, 1255, 223, 799, 839, 1315, 800, 1358, 1381, 1049, 725, 1166, 797, 1414, 868, 833, 220, 1074, 1036, 270, 0]"
175,28,4674,849,9291,0,4365,309,"[43, 8, 57, 50, 82, 75, 87, 36, 101, 9, 30, 63, 59, 43, 95, 7, 68, 61, 79, 64, 32, 7, 8, 81, 92, 41, 0]"
176,28,4141,6057,7375,0,3820,321,"[73, 21, 37, 3, 85, 35, 11, 82, 26, 6, 64, 47, 61, 26, 29, 74, 88, 1, 27, 98, 20, 71, 6, 24, 61, 104, 0]"
177,28,4922,5795,6502,0,1357,3565,"[797, 683, 1188, 371, 303, 126, 412, 219, 57, 195, 525, 564, 1133, 649, 1179, 305, 1141, 184, 578, 817, 357, 1045, 1030, 331, 224, 622, 0]"
178,28,4204,3885,6821,0,2263,1941,"[94, 37, 297, 286, 387, 62, 107, 567, 343, 186, 114, 398, 399, 629, 65, 272, 641, 46, 569, 25, 93, 154, 39, 214, 63, 498, 0]"
179,28,4249,5350,5720,0,1515,2734,"[161, 903, 740, 330, 503, 368, 442, 373, 298, 750, 510, 427, 736, 265, 74, 391, 200, 554, 415, 701, 364, 520, 72, 501, 161, 552, 0]"
180,28,4214,2394,7540,0,1186,3028,"[673, 432, 129, 857, 423, 3, 769, 895, 491, 5, 198, 654, 643, 76, 345, 329, 202, 936, 25, 648, 972, 336, 781, 220, 82, 281, 0]"
181,28,3658,7452,3746,0,2418,1240,"[197, 91, 159, 119, 279, 80, 107, 215, 11, 396, 115, 25, 283, 33, 127, 102, 96, 205, 226, 396, 290, 121, 385, 351, 227, 353, 0]"
182,28,4255,557,7444,0,1977,2278,"[320, 676, 603, 614, 593, 542, 658, 695, 186, 209, 624, 584, 0, 117, 419, 70, 686, 622, 658, 357, 681, 229, 427, 689, 744, 485, 0]"
183,28,4533,5126,6851,0,3465,1068,"[152, 6, 297, 26, 335, 306, 338, 352, 128, 25, 246, 245, 118, 75, 307, 67, 31, 47, 97, 334, 299, 170, 80, 35, 137, 248, 0]"
184,28,4502,5493,5860,0,4194,308,"[94, 93, 60, 24, 11, 8, 74, 92, 36, 94, 99, 71, 49, 92, 39, 26, 19, 6, 48, 57, 52, 8, 52, 21, 79, 36, 0]"
185,28,4825,2090,8595,0,3692,1133,"[88, 179, 145, 282, 33, 245, 187, 247, 267, 154, 342, 12, 195, 194, 299, 318, 136, 356, 37, 187, 233, 314, 373, 243, 321, 125, 0]"
186,28,3348,5582,6361,0,55,3293,"[528, 583, 270, 402, 296, 760, 775, 151, 740, 236, 327, 768, 998, 451, 122, 876, 70, 721, 218, 147, 227, 166, 772, 117, 1006, 861, 0]"
187,28,4082,1874,8569,0,204,3878,"[260, 1241, 40, 1291, 419, 476, 593, 1122, 200, 786, 835, 950, 744, 66, 560, 878, 1180, 524, 170, 716, 1244, 519, 1075, 194, 1078, 867, 0]"
188,28,3403,5956,6016,0,2778,625,"[86, 65, 54, 132, 208, 187, 69, 113, 48, 186, 8, 10, 126, 145, 170, 197, 67, 150, 157, 61, 160, 193, 92, 75, 140, 31, 0]"
189,28,4084,3742,6358,0,3261,823,"[244, 92, 153, 105, 232, 155, 172, 210, 30, 12, 75, 192, 254, 143, 144, 258, 122, 266, 53, 152, 182, 232, 160, 98, 124, 243, 0]"
190,28,3829,1925,8262,0,2449,1380,"[106, 19, 47, 91, 181, 73, 423, 168, 322, 151, 193, 124, 48, 253, 69, 445, 432, 15, 98, 96, 415, 326, 209, 306, 319, 60, 0]"
191,28,3879,7384,4757,0,262,3617,"[377, 956, 647, 374, 369, 549, 322, 637, 1083, 880, 1146, 585, 548, 944, 705, 947, 905, 929, 787, 596, 208, 771, 311, 1055, 1122, 804, 0]"
192,28,3380,1391,6746,0,3114,266,"[44, 60, 17, 46, 48, 47, 20, 40, 45, 33, 83, 68, 49, 12, 55, 12, 58, 52, 78, 18, 20, 56, 72, 2, 9, 9, 0]"
193,28,3580,247,10000,79,1435,2145,"[89, 207, 162, 135, 592, 371, 352, 527, 518, 146, 265, 671, 363, 342, 296, 483, 621, 551, 629, 244, 287, 300, 87, 313, 214, 680, 0]"
194,28,4294,5870,8424,0,2274,2020,"[325, 583, 98, 276, 605, 149, 321, 196, 302, 113, 413, 226, 118, 297, 27, 608, 33, 237, 284, 455, 79, 0, 4, 45, 247, 366, 0]"
195,28,4542,7148,5818,0,138,4404,"[441, 724, 982, 890, 990, 1265, 244, 534, 661, 31, 1197, 362, 1359, 188, 231, 1007, 651, 777, 667, 1369, 1431, 800, 255, 1419, 506, 1183, 0]"
196,28,4562,1561,8819,0,3872,690,"[159, 223, 111, 117, 203, 80, 51, 166, 142, 156, 191, 46, 64, 20, 216, 29, 30, 166, 174, 155, 91, 145, 179, 209, 13, 35, 0]"
197,28,4157,6433,6543,0,1640,2517,"[33, 553, 619, 654, 211, 549, 510, 117, 415, 188, 461, 289, 728, 3, 817, 599, 121, 128, 223, 807, 265, 836, 40, 13, 493, 161, 0]"
198,28,4356,4284,6615,0,1267,3089,"[292, 920, 694, 6, 684, 916, 188, 614, 325, 456, 82, 41, 940, 441, 276, 814, 970, 574, 702, 134, 225, 364, 353, 292, 385, 523, 0]"
199,28,4446,7121,3940,0,2809,1637,"[504, 117, 23, 213, 156, 282, 351, 264, 85, 496, 288, 450, 333, 72, 89, 93, 275, 326, 191, 117, 380, 520, 203, 486, 452, 425, 0]"
200,28,3019,451,6508,0,2340,679,"[100, 154, 196, 17, 36, 66, 58, 132, 193, 159, 214, 158, 39, 149, 15, 149, 86, 130, 202, 140, 120, 155, 196, 205, 173, 21, 0]"
201,28,3076,2071,7513,0,808,2268,"[559, 218, 238, 636, 596, 634, 326, 360, 220, 473, 211, 572, 53, 170, 708, 162, 668, 145, 143, 500, 149, 329, 128, 626, 406, 120, 0]"
202,28,3171,1933,8751,0,220,2951,"[327, 301, 441, 579, 137, 738, 894, 541, 144, 513, 924, 853, 49, 758, 597, 258, 728, 100, 437, 48, 951, 303, 927, 297, 413, 322, 0]"
203,28,4974,5739,7986,0,2742,2232,"[16, 352, 365, 133, 395, 331, 339, 73, 104, 37, 451, 577, 654, 642, 29, 409, 706, 54, 315, 431, 423, 714, 511, 512, 626, 251, 0]"
204,28,4080,5826,6240,0,868,3212,"[13, 595, 758, 622, 654, 454, 687, 991, 1032, 317, 618, 858, 199, 43, 1011, 62, 643, 530, 62, 625, 84, 784, 696, 147, 747, 585, 0]"
205,28,4228,1677,8791,0,3068,1160,"[264, 266, 314, 187, 337, 360, 260, 367, 298, 41, 153, 289, 295, 8, 138, 324, 363, 187, 216, 362, 193, 149, 290, 171, 360, 147, 0]"
206,28,3182,6776,5197,0,1036,2146,"[259, 663, 194, 508, 459, 440, 481, 403, 628, 232, 75, 193, 17, 77, 603, 89, 404, 670, 604, 69, 142, 271, 228, 391, 277, 175, 0]"
207,28,4871,1313,8755,0,3868,1003,"[154, 79, 190, 79, 203, 274, 97, 146, 168, 226, 80, 319, 150, 26, 160, 103, 304, 229, 324, 271, 208, 225, 292, 11, 137, 249, 0]"
208,28,4414,5947,7222,0,1448,2966,"[584, 602, 531, 154, 933, 333, 81, 827, 405, 350, 196, 545, 959, 216, 60, 928, 457, 824, 525, 412, 604, 183, 318, 496, 516, 508, 0]"
209,28,3874,5816,5280,0,1047,2827,"[36, 601, 124, 425, 445, 458, 187, 229, 913, 30, 380, 56, 853, 413, 272, 356, 297, 779, 474, 616, 632, 362, 148, 94, 190, 463, 0]"
210,28,3671,2920,6031,0,2774,897,"[51, 7, 159, 273, 227, 272, 188, 277, 281, 298, 9, 224, 99, 189, 213, 138, 232, 238, 244, 299, 92, 253, 225, 105, 252, 282, 0]"
211,28,4053,1851,8233,0,2848,1205,"[195, 66, 385, 29, 136, 123, 166, 65, 217, 382, 397, 184, 133, 190, 44, 125, 367, 336, 161, 205, 49, 322, 273, 191, 54, 86, 0]"
212,28,4909,7259,5883,0,2750,2159,"[547, 283, 689, 133, 711, 204, 42, 271, 564, 56, 482, 52, 126, 24, 487, 261, 175, 268, 436, 589, 374, 661, 396, 251, 512, 644, 0]"
213,28,4103,3445,6541,0,3058,1045,"[91, 203, 299, 245, 249, 210, 281, 101, 36, 228, 326, 53, 111, 43, 248, 82, 149, 185, 152, 57, 8, 178, 22, 48, 133, 149, 0]"
214,28,3150,397,9294,0,2187,963,"[156, 138, 33, 233, 173, 123, 210, 40, 82, 123, 80, 314, 36, 231, 106, 110, 23, 299, 183, 216, 4, 13, 68, 151, 71, 320, 0]"
215,28,4940,6263,7971,0,2896,2044,"[69, 465, 51, 524, 124, 667, 419, 521, 420, 112, 293, 7, 297, 596, 102, 283, 524, 412, 198, 620, 572, 510, 368, 351, 285, 479, 0]"
216,28,3296,7410,3857,0,3257,39,"[13, 0, 1, 5, 6, 10, 0, 4, 10, 11, 10, 10, 0, 7, 3, 11, 4, 13, 1, 2, 1, 11, 3, 10, 4, 9, 0]"
217,28,3117,1210,5764,0,2529,588,"[110, 57, 97, 174, 0, 127, 66, 176, 55, 88, 82, 108, 23, 99, 83, 112, 59, 102, 97, 127, 193, 36, 162, 75, 183, 13, 0]"
218,28,4176,3909,6031,0,3013,1163,"[349, 49, 282, 26, 4, 239, 4, 330, 246, 177, 103, 2, 245, 12, 83, 384, 204, 285, 59, 4, 2, 77, 266, 355, 144, 385, 0]"
219,28,4974,5040,5965,0,3699,1275,"[386, 406, 188, 3, 366, 352, 84, 208, 34, 424, 149, 315, 372, 299, 170, 27, 400, 133, 400, 377, 396, 252, 356, 382, 252, 24, 0]"
220,28,3870,369,9466,0,2204,1666,"[236, 252, 134, 463, 493, 190, 501, 333, 450, 129, 194, 474, 101, 96, 305, 201, 75, 22, 331, 241, 374, 385, 179, 492, 214, 86, 0]"
221,28,3031,5113,7384,0,72,2959,"[270, 204, 981, 205, 930, 74, 804, 842, 531, 695, 386, 580, 890, 746, 694, 548, 837, 662, 114, 422, 125, 766, 984, 855, 976, 504, 0]"
222,28,4065,7000,4449,0,2960,1105,"[83, 204, 330, 100, 38, 206, 104, 197, 211, 241, 347, 319, 308, 207, 136, 204, 250, 223, 108, 36, 288, 126, 54, 297, 24, 329, 0]"
223,28,4772,678,8543,0,1942,2830,"[364, 590, 771, 931, 462, 890, 500, 439, 24, 575, 93, 2, 789, 781, 97, 17, 414, 547, 134, 775, 747, 706, 153, 137, 252, 181, 0]"
224,28,3866,6394,6015,0,2638,1228,"[169, 300, 30, 23, 322, 384, 386, 257, 189, 77, 326, 301, 274, 377, 227, 118, 329, 288, 5, 337, 204, 240, 293, 7, 282, 299, 0]"
225,28,3750,1234,8531,0,2612,1138,"[141, 236, 353, 153, 377, 115, 218, 242, 267, 79, 375, 177, 142, 222, 342, 187, 259, 256, 356, 183, 289, 227, 65, 313, 282, 362, 0]"
226,28,4362,5325,7568,0,3615,747,"[121, 215, 218, 42, 148, 229, 83, 123, 42, 164, 23, 122, 38, 96, 63, 200, 139, 61, 132, 178, 67, 18, 93, 175, 112, 130, 0]"
227,28,3358,2725,8201,0,2508,850,"[26, 61, 262, 260, 41, 53, 0, 280, 36, 74, 152, 115, 100, 146, 220, 83, 221, 61, 181, 67, 103, 224, 140, 25, 153, 191, 0]"
228,28,3053,5186,6068,0,3012,41,"[10, 9, 6, 13, 3, 6, 10, 6, 4, 2, 13, 0, 12, 3, 2, 2, 8, 9, 8, 0, 8, 7, 2, 2, 4, 13, 0]"
229,28,3889,207,9750,0,612,3277,"[641, 453, 881, 386, 421, 899, 957, 684, 654, 582, 207, 404, 816, 955, 94, 249, 602, 362, 892, 632, 173, 546, 820, 485, 194, 755, 0]"
230,28,4304,6484,7570,0,1657,2647,"[469, 534, 92, 279, 869, 304, 794, 399, 521, 421, 575, 445, 376, 121, 631, 184, 506, 524, 381, 428, 176, 411, 138, 130, 474, 304, 0]"
231,28,3913,6454,5029,0,3588,325,"[102, 22, 85, 31, 37, 78, 66, 13, 21, 8, 28, 30, 19, 108, 93, 53, 69, 89, 3, 22, 97, 84, 57, 6, 75, 53, 0]"
232,28,3775,2826,5978,0,511,3264,"[737, 551, 371, 444, 955, 535, 801, 633, 1005, 599, 533, 857, 735, 332, 516, 982, 595, 1007, 149, 803, 306, 291, 258, 655, 549, 152, 0]"
233,28,3250,2831,6397,0,668,2582,"[436, 341, 344, 244, 739, 469, 147, 849, 268, 559, 132, 347, 576, 633, 512, 22, 788, 819, 343, 71, 350, 701, 189, 284, 634, 205, 0]"
234,28,4121,1344,9174,0,3987,134,"[32, 19, 32, 5, 2, 39, 2, 40, 9, 28, 37, 28, 29, 9, 25, 30, 2, 19, 30, 40, 18, 34, 17, 17, 30, 36, 0]"
235,28,3132,5939,6367,0,1977,1155,"[334, 365, 117, 83, 236, 148, 176, 350, 17, 143, 45, 256, 205, 2, 82, 332, 265, 147, 61, 274, 71, 242, 368, 336, 217, 204, 0]"
236,28,4252,1705,8914,0,4212,40,"[10, 5, 2, 4, 2, 0, 1, 7, 10, 0, 3, 13, 9, 3, 4, 13, 3, 13, 12, 8, 9, 6, 10, 12, 10, 5, 0]"
237,28,4826,6667,7073,0,379,4447,"[1217, 1133, 883, 708, 1204, 146, 1093, 100, 405, 1160, 691, 1347, 1019, 1397, 1089, 620, 935, 669, 275, 195, 667, 496, 1320, 409, 393, 336, 0]"
238,28,4776,7197,4652,0,444,4332,"[1104, 1349, 1271, 1280, 286, 1280, 301, 258, 1023, 826, 1235, 863, 583, 694, 743, 44, 838, 989, 1248, 79, 747, 132, 1151, 1371, 565, 1314, 0]"
239,28,3542,3205,4989,0,3076,466,"[14, 21, 50, 114, 25, 114, 151, 140, 66, 31, 24, 84, 40, 49, 66, 113, 23, 29, 100, 128, 120, 129, 66, 149, 39, 148, 0]"
240,28,3013,1355,6647,0,1696,1317,"[386, 10, 47, 342, 19, 379, 175, 286, 67, 399, 134, 231, 247, 197, 221, 14, 30, 377, 241, 217, 439, 211, 193, 37, 209, 257, 0]"
241,28,4252,1738,9161,0,282,3970,"[56, 981, 960, 1044, 266, 1252, 154, 909, 28, 926, 590, 184, 213, 732, 1189, 577, 421, 1271, 720, 641, 173, 1307, 869, 1099, 1099, 608, 0]"
242,28,3425,6950,5636,0,331,3094,"[266, 739, 3, 549, 242, 456, 685, 136, 537, 142, 648, 844, 401, 235, 162, 645, 481, 624, 716, 1012, 43, 312, 631, 53, 299, 94, 0]"
243,28,3939,2354,7221,0,1764,2175,"[183, 360, 382, 416, 194, 660, 646, 7, 319, 643, 681, 308, 343, 457, 507, 228, 680, 164, 181, 570, 176, 367, 524, 12, 194, 270, 0]"
244,28,4052,6852,4421,0,1223,2829,"[213, 196, 246, 480, 831, 183, 288, 547, 558, 846, 733, 490, 336, 733, 359, 410, 733, 591, 465, 584, 546, 278, 774, 326, 266, 109, 0]"
245,28,4565,4187,4799,0,4306,259,"[79, 17, 78, 38, 8, 45, 60, 70, 20, 36, 65, 43, 31, 68, 17, 48, 47, 63, 59, 17, 23, 83, 10, 74, 65, 59, 0]"
246,28,4972,2819,6952,0,492,4480,"[1224, 1428, 844, 1251, 121, 501, 372, 399, 517, 629, 1213, 979, 277, 820, 1091, 881, 565, 374, 1173, 572, 151, 1098, 779, 378, 905, 1256, 0]"
247,28,4099,7214,3837,0,3224,875,"[152, 133, 138, 22, 131, 246, 87, 167, 258, 104, 72, 233, 246, 96, 279, 175, 5, 274, 155, 0, 56, 34, 8, 184, 131, 119, 0]"
248,28,4868,2386,6319,0,4027,841,"[98, 110, 167, 106, 219, 269, 64, 232, 51, 135, 96, 12, 15, 156, 103, 202, 225, 198, 185, 214, 21, 202, 218, 70, 131, 132, 0]"
249,28,3163,2419,7063,0,2671,492,"[111, 158, 49, 44, 9, 36, 142, 42, 49, 110, 31, 145, 36, 129, 49, 10, 108, 25, 42, 153, 7, 28, 47, 73, 153, 65, 0]"
250,28,4491,6064,5490,0,4402,89,"[13, 10, 14, 8, 26, 1, 8, 5, 1, 5, 12, 16, 2, 11, 18, 18, 14, 1, 5, 27, 19, 1, 26, 19, 19, 6, 0]"
251,28,4348,1380,8458,0,4111,237,"[61, 43, 22, 15, 16, 18, 51, 44, 22, 29, 39, 52, 37, 16, 3, 58, 75, 60, 17, 12, 46, 43, 63, 37, 73, 72, 0]"
252,28,4276,6265,6469,0,1171,3105,"[866, 643, 612, 691, 918, 625, 693, 349, 665, 460, 509, 131, 590, 456, 240, 32, 557, 713, 796, 317, 641, 475, 622, 590, 130, 650, 0]"
253,28,4113,1123,9459,0,3724,389,"[37, 6, 128, 115, 63, 128, 91, 123, 68, 53, 104, 52, 65, 98, 120, 31, 35, 15, 116, 24, 59, 58, 78, 113, 94, 54, 0]"
254,28,3851,7414,5896,0,2070,1781,"[156, 52, 425, 121, 52, 95, 111, 14, 551, 171, 550, 378, 378, 206, 91, 546, 132, 376, 573, 400, 331, 156, 261, 107, 58, 392, 0]"
255,28,4482,3459,6919,0,438,4044,"[41, 107, 679, 145, 808, 1175, 1320, 1088, 946, 1085, 320, 1123, 1291, 784, 435, 187, 1125, 40, 551, 960, 1242, 322, 861, 844, 536, 580, 0]"
256,28,3261,2263,7917,0,2804,457,"[36, 95, 144, 40, 25, 53, 100, 46, 87, 12, 136, 32, 45, 142, 28, 50, 118, 122, 48, 116, 124, 147, 57, 131, 131, 56, 0]"
257,28,3337,7393,3861,0,1834,1503,"[435, 414, 50, 492, 264, 221, 344, 450, 53, 123, 496, 486, 326, 66, 280, 371, 214, 54, 307, 327, 388, 18, 413, 401, 275, 319, 0]"
258,28,3744,3731,3874,0,1376,2368,"[519, 788, 538, 126, 377, 765, 686, 516, 698, 84, 35, 1, 599, 540, 675, 671, 474, 722, 631, 35, 683, 659, 239, 407, 718, 516, 0]"
259,28,3160,1258,5776,0,1153,2007,"[659, 61, 603, 114, 220, 358, 375, 312, 440, 345, 482, 338, 547, 257, 288, 615, 532, 34, 159, 186, 255, 588, 564, 398, 569, 661, 0]"
260,28,3264,568,8472,0,1147,2117,"[515, 404, 231, 270, 185, 268, 671, 98, 442, 449, 430, 317, 76, 302, 316, 283, 537, 507, 75, 18, 682, 372, 60, 185, 300, 209, 0]"
261,28,4121,7424,5169,0,4022,99,"[13, 0, 5, 28, 20, 13, 4, 0, 3, 4, 22, 26, 20, 27, 31, 25, 4, 9, 7, 16, 31, 33, 17, 12, 33, 22, 0]"
262,28,4807,1174,8802,0,562,4245,"[1308, 475, 742, 1103, 159, 820, 190, 174, 1165, 466, 253, 556, 14, 920, 754, 1226, 1077, 338, 405, 28, 916, 913, 1032, 44, 518, 1068, 0]"
263,28,4716,6164,7354,0,3554,1162,"[178, 323, 363, 198, 174, 71, 34, 309, 333, 228, 384, 40, 204, 199, 157, 268, 385, 162, 163, 136, 367, 45, 61, 195, 357, 174, 0]"
264,28,3890,6746,4498,0,1070,2820,"[205, 686, 639, 367, 555, 698, 469, 360, 523, 372, 410, 778, 134, 634, 419, 612, 58, 677, 706, 652, 107, 193, 919, 921, 290, 58, 0]"
265,28,4734,1692,7540,0,2579,2155,"[351, 503, 51, 16, 63, 322, 31, 239, 718, 139, 608, 214, 215, 1, 23, 370, 264, 641, 162, 633, 119, 177, 393, 325, 67, 186, 0]"
266,28,3013,2903,7650,0,415,2598,"[437, 451, 767, 699, 115, 515, 104, 57, 523, 771, 556, 520, 658, 314, 202, 744, 260, 749, 420, 439, 175, 430, 490, 785, 158, 235, 0]"
267,28,4725,6612,5763,0,4185,540,"[104, 166, 137, 13, 22, 32, 59, 58, 14, 112, 159, 113, 104, 75, 54, 114, 179, 32, 11, 160, 47, 114, 94, 81, 172, 39, 0]"
268,28,4715,975,9503,0,4403,312,"[53, 49, 99, 30, 82, 24, 22, 79, 64, 7, 21, 82, 75, 1, 25, 74, 26, 37, 66, 95, 54, 54, 27, 19, 54, 3, 0]"
269,28,3940,7021,6422,0,2380,1560,"[91, 408, 192, 377, 106, 494, 28, 150, 205, 220, 63, 118, 199, 399, 189, 117, 67, 152, 461, 155, 481, 116, 471, 250, 95, 124, 0]"
270,28,3878,2361,7939,0,2834,1044,"[340, 1, 172, 276, 118, 198, 174, 95, 28, 155, 258, 141, 89, 177, 79, 312, 130, 324, 222, 305, 114, 105, 310, 94, 49, 201, 0]"
271,28,3073,6518,4494,0,458,2615,"[197, 278, 857, 614, 164, 184, 69, 488, 90, 741, 45, 221, 228, 338, 4, 497, 722, 505, 341, 688, 771, 334, 472, 281, 349, 53, 0]"
272,28,4120,1737,6877,0,24,4096,"[778, 1263, 72, 837, 487, 178, 113, 845, 513, 409, 58, 991, 1225, 251, 763, 575, 770, 268, 99, 583, 1140, 478, 732, 1088, 1306, 318, 0]"
273,28,3066,1062,8881,0,901,2165,"[232, 381, 628, 406, 449, 345, 589, 227, 140, 222, 162, 2, 543, 525, 145, 68, 668, 270, 329, 438, 201, 625, 457, 623, 666, 442, 0]"
274,28,4775,6877,6779,0,3120,1655,"[207, 468, 211, 318, 223, 188, 294, 337, 249, 442, 149, 109, 512, 312, 490, 276, 149, 70, 0, 356, 188, 84, 476, 389, 209, 502, 0]"
275,28,4805,6929,4655,0,2346,2459,"[241, 497, 694, 732, 784, 191, 563, 63, 471, 369, 230, 143, 65, 566, 803, 669, 448, 376, 787, 564, 342, 44, 517, 78, 404, 493, 0]"
276,28,3620,2419,5856,0,2664,956,"[145, 125, 29, 112, 117, 168, 267, 173, 164, 203, 317, 106, 246, 200, 173, 135, 263, 147, 4, 50, 311, 162, 235, 188, 298, 7, 0]"
277,28,3880,2550,7186,0,2051,1829,"[453, 209, 540, 269, 502, 141, 289, 568, 155, 516, 201, 243, 131, 435, 355, 538, 529, 525, 168, 255, 86, 225, 513, 466, 15, 441, 0]"
278,28,4165,6681,4670,0,3438,727,"[167, 218, 141, 88, 73, 74, 60, 124, 237, 9, 86, 221, 28, 20, 216, 132, 34, 62, 18, 34, 209, 147, 224, 28, 198, 14, 0]"
279,28,3735,2709,5696,0,456,3279,"[682, 470, 1038, 243, 984, 661, 957, 1039, 484, 364, 288, 899, 938, 932, 463, 589, 469, 193, 1006, 723, 696, 941, 870, 927, 179, 52, 0]"
280,28,3537,699,8534,0,2315,1222,"[129, 345, 55, 138, 84, 108, 233, 373, 359, 148, 185, 121, 116, 338, 344, 85, 58, 179, 403, 267, 286, 231, 371, 240, 53, 59, 0]"
281,28,3699,5942,6291,0,2018,1681,"[62, 175, 36, 97, 40, 139, 549, 444, 335, 259, 391, 366, 31, 299, 345, 432, 153, 354, 238, 408, 14, 404, 483, 194, 62, 397, 0]"
282,28,4033,1184,9140,0,1043,2990,"[980, 397, 189, 21, 868, 607, 671, 805, 11, 917, 2, 594, 746, 0, 247, 286, 982, 573, 360, 343, 757, 461, 712, 362, 435, 810, 0]"
283,28,3124,5834,6430,0,2879,245,"[52, 73, 58, 58, 27, 27, 61, 24, 47, 26, 39, 11, 18, 5, 74, 24, 11, 37, 34, 13, 76, 3, 21, 48, 9, 42, 0]"
284,28,3170,2991,6609,0,1764,1406,"[233, 396, 406, 62, 318, 116, 68, 93, 237, 121, 198, 204, 136, 50, 260, 435, 274, 105, 134, 412, 406, 74, 344, 14, 181, 282, 0]"
285,28,3945,142,10000,412,2920,1025,"[113, 234, 252, 55, 191, 113, 205, 49, 181, 107, 229, 67, 327, 274, 251, 129, 329, 83, 104, 157, 322, 95, 160, 58, 306, 308, 0]"
286,28,3221,7041,6180,0,2619,602,"[165, 123, 125, 40, 173, 67, 137, 157, 153, 92, 31, 62, 187, 31, 159, 0, 116, 200, 151, 76, 118, 16, 117, 77, 148, 155, 0]"
287,28,3717,1387,8510,0,3382,335,"[74, 19, 71, 89, 4, 4, 53, 44, 52, 25, 100, 108, 33, 39, 26, 91, 54, 69, 65, 15, 67, 31, 94, 3, 57, 19, 0]"
288,28,3635,7200,4945,0,1419,2216,"[575, 18, 678, 502, 95, 273, 402, 253, 519, 292, 456, 706, 267, 24, 106, 211, 362, 130, 335, 366, 692, 327, 691, 367, 465, 49, 0]"
289,28,3603,1830,6718,0,2441,1162,"[189, 137, 208, 52, 34, 149, 89, 337, 12, 8, 185, 106, 270, 182, 245, 238, 274, 32, 36, 131, 333, 315, 110, 47, 227, 120, 0]"
290,28,4750,5580,5888,0,1750,3000,"[304, 849, 968, 423, 336, 291, 167, 452, 20, 243, 81, 929, 517, 578, 634, 902, 82, 914, 940, 753, 91, 711, 876, 529, 398, 268, 0]"
291,28,4601,2960,7529,0,1663,2938,"[750, 956, 167, 390, 542, 129, 276, 332, 823, 514, 64, 62, 692, 971, 281, 130, 614, 283, 334, 808, 182, 441, 786, 325, 594, 437, 0]"
292,28,4162,6067,5624,0,115,4047,"[168, 615, 1113, 595, 536, 988, 982, 923, 1106, 915, 1228, 290, 977, 447, 1261, 138, 428, 1105, 311, 1023, 1282, 1122, 865, 1147, 134, 122, 0]"
293,28,3052,2289,6387,0,1408,1644,"[399, 201, 50, 127, 215, 142, 480, 494, 449, 96, 27, 272, 11, 405, 296, 443, 338, 131, 249, 248, 75, 405, 504, 270, 256, 427, 0]"
294,28,3269,1215,8441,0,2914,355,"[55, 0, 78, 83, 60, 8, 100, 15, 2, 21, 83, 70, 47, 41, 109, 78, 41, 40, 18, 95, 56, 90, 33, 67, 41, 90, 0]"
295,28,4692,6108,7025,0,3086,1606,"[12, 194, 274, 471, 436, 196, 71, 413, 1, 282, 337, 266, 323, 436, 260, 429, 483, 322, 40, 521, 510, 421, 395, 65, 223, 356, 0]"
296,28,4247,5613,5659,0,2103,2144,"[515, 419, 385, 208, 10, 131, 513, 445, 16, 218, 398, 370, 20, 681, 145, 635, 442, 16, 432, 31, 448, 430, 8, 691, 463, 417, 0]"
297,28,4841,2255,8245,0,259,4582,"[825, 887, 900, 822, 729, 595, 1360, 304, 892, 1459, 201, 24, 238, 0, 185, 574, 1381, 1036, 370, 630, 878, 156, 1515, 1383, 968, 744, 0]"
298,28,4553,5595,7203,0,2357,2196,"[647, 648, 18, 187, 114, 688, 59, 266, 271, 418, 581, 462, 327, 619, 41, 32, 180, 134, 110, 278, 588, 332, 65, 652, 37, 464, 0]"
299,28,4439,5313,6329,0,2813,1626,"[223, 91, 139, 225, 439, 430, 152, 442, 95, 272, 383, 456, 452, 332, 267, 540, 369, 61, 97, 213, 379, 68, 365, 210, 126, 504, 0]"
